ID,Флаг дозвона,Флаг продажи,Расходы,PV,NPV
0,1,0,8,0,-8
1,0,0,44,0,-44
2,1,0,19,0,-19
3,0,0,68,0,-68
4,1,1,1492,1633,141
5,0,0,12,0,-12
6,1,1,48,1281,1233
7,1,1,37,1536,1499
8,1,0,12,0,-12
9,0,0,4,0,-4
10,0,0,57,0,-57
11,1,1,1482,1540,58
12,1,1,942,1315,373
13,1,0,156,0,-156
14,1,1,702,3433,2731
15,1,1,109,1296,1187
16,0,0,17,0,-17
17,1,1,64,1547,1483
18,1,0,4,0,-4
19,0,0,10,0,-10
20,1,1,1053,1886,833
21,1,1,383,2000,1617
22,0,0,26,0,-26
23,1,0,144,0,-144
24,1,0,34,0,-34
25,0,0,18,0,-18
26,1,0,116,0,-116
27,1,1,117,1756,1639
28,0,0,37,0,-37
29,0,0,11,0,-11
30,1,0,105,0,-105
31,1,1,86,2134,2048
32,1,1,97,1204,1107
33,1,1,1511,1519,8
34,1,0,176,0,-176
35,0,0,12,0,-12
36,1,1,251,1208,957
37,1,1,982,3394,2412
38,1,0,0,0,0
39,1,0,87,0,-87
40,1,0,42,0,-42
41,0,0,19,0,-19
42,0,0,7,0,-7
43,0,0,14,0,-14
44,0,0,77,0,-77
45,0,0,21,0,-21
46,1,0,52,0,-52
47,0,0,247,0,-247
48,1,0,111,0,-111
49,1,0,87,0,-87
50,1,0,83,0,-83
51,1,0,76,0,-76
52,1,0,16,0,-16
53,0,0,9,0,-9
54,1,1,184,1941,1757
55,0,0,36,0,-36
56,0,0,63,0,-63
57,1,0,108,0,-108
58,0,0,64,0,-64
59,0,0,164,0,-164
60,0,0,53,0,-53
61,0,0,3,0,-3
62,0,0,64,0,-64
63,0,0,17,0,-17
64,0,0,53,0,-53
65,1,1,87,1584,1497
66,1,0,12,0,-12
67,0,0,16,0,-16
68,0,0,55,0,-55
69,1,1,580,1298,718
70,1,1,631,2700,2069
71,0,0,36,0,-36
72,1,0,33,0,-33
73,1,0,12,0,-12
74,1,1,750,1213,463
75,0,0,5,0,-5
76,1,0,59,0,-59
77,1,1,1430,1411,-19
78,0,0,9,0,-9
79,1,0,11,0,-11
80,0,0,23,0,-23
81,1,1,32,1313,1281
82,1,1,1998,1438,-560
83,1,1,344,1362,1018
84,1,1,191,1332,1141
85,0,0,43,0,-43
86,1,1,874,1294,420
87,1,1,383,1946,1563
88,1,1,259,1222,963
89,0,0,121,0,-121
90,1,1,494,1637,1143
91,1,0,44,0,-44
92,1,0,2,0,-2
93,0,0,6,0,-6
94,1,1,313,1241,928
95,0,0,30,0,-30
96,1,0,58,0,-58
97,0,0,56,0,-56
98,1,1,260,1611,1351
99,1,0,64,0,-64
100,0,0,101,0,-101
101,0,0,76,0,-76
102,0,0,18,0,-18
103,0,0,6,0,-6
104,0,0,66,0,-66
105,0,0,124,0,-124
106,1,0,50,0,-50
107,1,1,138,1246,1108
108,0,0,48,0,-48
109,0,0,17,0,-17
110,0,0,90,0,-90
111,0,0,9,0,-9
112,1,0,120,0,-120
113,1,1,1715,1311,-404
114,1,0,76,0,-76
115,1,1,180,2261,2081
116,1,0,30,0,-30
117,0,0,277,0,-277
118,1,1,177,1576,1399
119,1,1,136,1304,1168
120,0,0,236,0,-236
121,1,1,170,1716,1546
122,0,0,50,0,-50
123,1,1,610,1283,673
124,0,0,19,0,-19
125,1,1,788,6875,6087
126,1,0,31,0,-31
127,0,0,307,0,-307
128,1,1,420,1723,1303
129,0,0,3,0,-3
130,1,1,27,1725,1698
131,0,0,40,0,-40
132,0,0,22,0,-22
133,1,1,811,1242,431
134,1,1,423,1363,940
135,1,1,606,1469,863
136,0,0,5,0,-5
137,1,1,1326,1256,-70
138,1,0,52,0,-52
139,0,0,2,0,-2
140,1,0,27,0,-27
141,1,0,75,0,-75
142,0,0,36,0,-36
143,1,1,174,1862,1688
144,0,0,6,0,-6
145,1,1,421,2636,2215
146,1,1,697,1355,658
147,0,0,2,0,-2
148,0,0,22,0,-22
149,0,0,70,0,-70
150,1,0,39,0,-39
151,0,0,38,0,-38
152,1,0,20,0,-20
153,1,1,379,1278,899
154,0,0,47,0,-47
155,1,1,895,1524,629
156,0,0,64,0,-64
157,1,0,12,0,-12
158,0,0,80,0,-80
159,1,0,36,0,-36
160,0,0,61,0,-61
161,1,1,499,1293,794
162,0,0,5,0,-5
163,0,0,83,0,-83
164,1,1,285,1502,1217
165,0,0,49,0,-49
166,1,1,160,1527,1367
167,1,1,1173,1342,169
168,1,1,167,1361,1194
169,1,1,115,1224,1109
170,1,1,208,1960,1752
171,0,0,90,0,-90
172,1,0,75,0,-75
173,1,1,50,1504,1454
174,1,1,613,1416,803
175,1,1,1303,3440,2137
176,1,1,434,1694,1260
177,0,0,33,0,-33
178,1,1,392,1350,958
179,1,0,13,0,-13
180,0,0,86,0,-86
181,1,0,17,0,-17
182,0,0,80,0,-80
183,0,0,4,0,-4
184,0,0,45,0,-45
185,1,0,110,0,-110
186,0,0,20,0,-20
187,1,1,369,1401,1032
188,0,0,55,0,-55
189,0,0,70,0,-70
190,0,0,88,0,-88
191,0,0,116,0,-116
192,0,0,38,0,-38
193,0,0,12,0,-12
194,1,1,2707,1954,-753
195,0,0,103,0,-103
196,1,1,544,1332,788
197,0,0,21,0,-21
198,1,0,38,0,-38
199,1,0,71,0,-71
200,1,0,21,0,-21
201,1,0,14,0,-14
202,0,0,42,0,-42
203,1,0,12,0,-12
204,0,0,74,0,-74
205,1,0,2,0,-2
206,1,0,8,0,-8
207,1,1,271,1846,1575
208,0,0,10,0,-10
209,1,0,12,0,-12
210,1,1,673,1230,557
211,0,0,2,0,-2
212,0,0,2,0,-2
213,1,1,1259,1231,-28
214,0,0,1,0,-1
215,0,0,41,0,-41
216,1,1,1673,1447,-226
217,0,0,27,0,-27
218,1,0,168,0,-168
219,1,0,40,0,-40
220,1,1,603,1328,725
221,1,0,1,0,-1
222,1,1,128,1318,1190
223,1,0,26,0,-26
224,0,0,84,0,-84
225,1,0,62,0,-62
226,0,0,44,0,-44
227,0,0,12,0,-12
228,1,0,14,0,-14
229,1,0,32,0,-32
230,1,0,39,0,-39
231,1,0,7,0,-7
232,1,1,102,1209,1107
233,0,0,13,0,-13
234,0,0,8,0,-8
235,1,1,27,1737,1710
236,0,0,19,0,-19
237,0,0,9,0,-9
238,0,0,27,0,-27
239,0,0,17,0,-17
240,0,0,4,0,-4
241,0,0,69,0,-69
242,0,0,88,0,-88
243,0,0,13,0,-13
244,0,0,14,0,-14
245,0,0,38,0,-38
246,0,0,174,0,-174
247,1,1,63,1354,1291
248,0,0,7,0,-7
249,0,0,52,0,-52
250,1,0,12,0,-12
251,1,0,42,0,-42
252,1,1,214,3490,3276
253,1,0,0,0,0
254,1,0,23,0,-23
255,1,1,231,1603,1372
256,1,0,27,0,-27
257,0,0,24,0,-24
258,0,0,134,0,-134
259,1,0,22,0,-22
260,1,1,100,1644,1544
261,1,0,92,0,-92
262,0,0,115,0,-115
263,0,0,9,0,-9
264,1,1,242,1375,1133
265,0,0,124,0,-124
266,1,1,1480,2015,535
267,0,0,9,0,-9
268,0,0,54,0,-54
269,0,0,9,0,-9
270,1,0,60,0,-60
271,1,1,1038,1441,403
272,0,0,51,0,-51
273,1,1,114,2350,2236
274,0,0,67,0,-67
275,0,0,54,0,-54
276,1,0,106,0,-106
277,0,0,1,0,-1
278,0,0,3,0,-3
279,0,0,23,0,-23
280,1,1,18,1221,1203
281,1,1,226,1492,1266
282,1,1,321,1319,998
283,1,1,125,1260,1135
284,0,0,189,0,-189
285,1,1,122,1244,1122
286,1,1,448,1230,782
287,1,0,130,0,-130
288,1,1,157,1831,1674
289,1,1,313,1350,1037
290,1,0,85,0,-85
291,0,0,258,0,-258
292,1,0,25,0,-25
293,0,0,20,0,-20
294,1,1,123,1285,1162
295,0,0,6,0,-6
296,0,0,77,0,-77
297,1,0,63,0,-63
298,1,0,31,0,-31
299,1,1,1012,1548,536
300,0,0,177,0,-177
301,1,0,54,0,-54
302,0,0,9,0,-9
303,1,1,144,1354,1210
304,1,1,426,1306,880
305,1,0,10,0,-10
306,1,1,508,1553,1045
307,1,0,0,0,0
308,1,0,59,0,-59
309,1,1,346,1206,860
310,1,0,20,0,-20
311,1,1,345,2334,1989
312,0,0,146,0,-146
313,0,0,18,0,-18
314,0,0,27,0,-27
315,1,0,27,0,-27
316,0,0,33,0,-33
317,1,1,59,1949,1890
318,0,0,50,0,-50
319,0,0,78,0,-78
320,1,1,84,1544,1460
321,1,0,78,0,-78
322,1,0,10,0,-10
323,0,0,22,0,-22
324,1,0,84,0,-84
325,0,0,4,0,-4
326,0,0,46,0,-46
327,1,1,185,1309,1124
328,1,1,216,1360,1144
329,1,1,375,1239,864
330,0,0,22,0,-22
331,1,1,83,1543,1460
332,1,1,248,1638,1390
333,0,0,12,0,-12
334,1,0,49,0,-49
335,1,1,114,1255,1141
336,0,0,104,0,-104
337,1,0,28,0,-28
338,0,0,36,0,-36
339,1,0,9,0,-9
340,0,0,19,0,-19
341,1,1,242,2084,1842
342,1,1,176,1315,1139
343,0,0,12,0,-12
344,0,0,26,0,-26
345,1,1,563,1334,771
346,1,1,419,2050,1631
347,1,1,64,1361,1297
348,1,1,412,1933,1521
349,1,0,96,0,-96
350,1,0,7,0,-7
351,1,0,87,0,-87
352,1,0,7,0,-7
353,0,0,0,0,0
354,0,0,81,0,-81
355,1,1,183,2501,2318
356,0,0,4,0,-4
357,1,0,8,0,-8
358,1,0,67,0,-67
359,1,1,388,1258,870
360,1,0,43,0,-43
361,1,1,613,1202,589
362,0,0,134,0,-134
363,1,0,114,0,-114
364,1,0,11,0,-11
365,0,0,79,0,-79
366,1,0,95,0,-95
367,1,1,298,1224,926
368,0,0,21,0,-21
369,1,1,570,1349,779
370,0,0,99,0,-99
371,1,1,158,1281,1123
372,0,0,65,0,-65
373,0,0,49,0,-49
374,1,1,77,1544,1467
375,0,0,93,0,-93
376,1,0,43,0,-43
377,1,0,40,0,-40
378,1,0,33,0,-33
379,0,0,32,0,-32
380,0,0,53,0,-53
381,1,1,558,1736,1178
382,1,0,7,0,-7
383,1,1,970,1440,470
384,1,1,787,1226,439
385,1,0,37,0,-37
386,1,0,11,0,-11
387,0,0,62,0,-62
388,1,0,57,0,-57
389,1,1,92,1623,1531
390,1,1,349,1542,1193
391,1,1,286,1286,1000
392,0,0,4,0,-4
393,1,1,445,2047,1602
394,1,1,725,1853,1128
395,1,0,25,0,-25
396,0,0,38,0,-38
397,1,0,33,0,-33
398,1,1,125,1322,1197
399,1,1,1129,1351,222
400,0,0,3,0,-3
401,0,0,10,0,-10
402,1,0,54,0,-54
403,1,1,543,1217,674
404,1,1,135,1607,1472
405,1,0,85,0,-85
406,1,1,319,1259,940
407,1,1,459,1794,1335
408,1,1,102,1278,1176
409,1,0,72,0,-72
410,0,0,77,0,-77
411,0,0,17,0,-17
412,0,0,51,0,-51
413,1,0,7,0,-7
414,1,1,647,1349,702
415,1,0,77,0,-77
416,1,0,4,0,-4
417,1,1,1248,1223,-25
418,1,0,6,0,-6
419,1,1,297,1273,976
420,1,1,1093,1358,265
421,1,0,10,0,-10
422,1,0,40,0,-40
423,0,0,31,0,-31
424,1,1,514,1927,1413
425,1,0,42,0,-42
426,0,0,1,0,-1
427,0,0,135,0,-135
428,1,1,138,1311,1173
429,1,1,194,1278,1084
430,0,0,33,0,-33
431,1,1,341,3039,2698
432,1,1,115,1220,1105
433,0,0,15,0,-15
434,0,0,57,0,-57
435,0,0,81,0,-81
436,1,1,1022,1258,236
437,1,0,40,0,-40
438,0,0,94,0,-94
439,1,0,72,0,-72
440,1,1,129,1239,1110
441,0,0,29,0,-29
442,0,0,60,0,-60
443,0,0,18,0,-18
444,1,0,63,0,-63
445,1,0,1,0,-1
446,1,1,1380,1231,-149
447,1,0,109,0,-109
448,1,1,1138,2077,939
449,1,1,215,1367,1152
450,1,1,102,2825,2723
451,1,0,34,0,-34
452,1,1,488,1293,805
453,1,1,586,1295,709
454,0,0,39,0,-39
455,0,0,17,0,-17
456,1,0,15,0,-15
457,1,0,38,0,-38
458,1,0,1,0,-1
459,0,0,147,0,-147
460,0,0,108,0,-108
461,1,0,96,0,-96
462,0,0,10,0,-10
463,1,0,40,0,-40
464,0,0,25,0,-25
465,0,0,17,0,-17
466,1,0,70,0,-70
467,1,1,374,1677,1303
468,1,0,16,0,-16
469,0,0,63,0,-63
470,1,0,50,0,-50
471,1,0,4,0,-4
472,0,0,42,0,-42
473,1,1,286,2988,2702
474,1,0,0,0,0
475,1,1,171,1315,1144
476,1,0,244,0,-244
477,1,1,147,1229,1082
478,1,1,64,1661,1597
479,0,0,117,0,-117
480,1,1,542,1254,712
481,0,0,39,0,-39
482,1,1,268,1475,1207
483,0,0,20,0,-20
484,0,0,64,0,-64
485,0,0,22,0,-22
486,1,1,170,1400,1230
487,0,0,27,0,-27
488,0,0,1,0,-1
489,1,0,72,0,-72
490,1,0,4,0,-4
491,1,1,630,1333,703
492,1,1,649,1657,1008
493,0,0,104,0,-104
494,1,1,468,1784,1316
495,1,1,754,1553,799
496,1,0,48,0,-48
497,0,0,6,0,-6
498,1,1,236,1262,1026
499,1,1,51,1391,1340
500,1,0,156,0,-156
501,1,0,15,0,-15
502,1,1,141,1379,1238
503,1,1,557,2276,1719
504,1,0,19,0,-19
505,1,1,2779,1491,-1288
506,0,0,101,0,-101
507,1,0,14,0,-14
508,1,0,6,0,-6
509,1,0,163,0,-163
510,1,0,8,0,-8
511,1,1,461,1370,909
512,1,1,244,1246,1002
513,0,0,78,0,-78
514,0,0,29,0,-29
515,0,0,4,0,-4
516,1,1,818,1249,431
517,1,1,407,1215,808
518,1,1,380,1956,1576
519,0,0,97,0,-97
520,1,1,346,1202,856
521,1,0,0,0,0
522,1,1,1685,2338,653
523,1,1,140,1422,1282
524,0,0,16,0,-16
525,1,0,69,0,-69
526,0,0,10,0,-10
527,0,0,2,0,-2
528,1,1,1113,1679,566
529,1,0,10,0,-10
530,1,1,1083,2116,1033
531,1,1,47,2617,2570
532,1,1,133,1325,1192
533,1,1,287,1260,973
534,0,0,40,0,-40
535,1,0,66,0,-66
536,1,1,354,1340,986
537,1,0,11,0,-11
538,1,1,774,1227,453
539,1,0,16,0,-16
540,1,1,1418,1707,289
541,0,0,77,0,-77
542,0,0,144,0,-144
543,1,0,3,0,-3
544,0,0,48,0,-48
545,1,0,17,0,-17
546,0,0,40,0,-40
547,1,0,39,0,-39
548,1,1,8,1839,1831
549,0,0,18,0,-18
550,1,0,3,0,-3
551,1,0,10,0,-10
552,0,0,50,0,-50
553,0,0,22,0,-22
554,1,1,694,1214,520
555,1,0,39,0,-39
556,1,0,22,0,-22
557,0,0,5,0,-5
558,1,1,691,1284,593
559,0,0,3,0,-3
560,1,1,702,1817,1115
561,0,0,9,0,-9
562,1,0,9,0,-9
563,1,1,148,1831,1683
564,0,0,30,0,-30
565,0,0,164,0,-164
566,0,0,8,0,-8
567,1,1,251,1323,1072
568,0,0,0,0,0
569,0,0,13,0,-13
570,0,0,12,0,-12
571,0,0,53,0,-53
572,1,1,2694,2090,-604
573,0,0,55,0,-55
574,1,1,415,1370,955
575,0,0,19,0,-19
576,0,0,86,0,-86
577,0,0,18,0,-18
578,1,0,24,0,-24
579,1,0,180,0,-180
580,1,1,1016,1238,222
581,1,1,664,1257,593
582,1,0,48,0,-48
583,1,1,281,1362,1081
584,1,1,911,1698,787
585,1,1,738,2804,2066
586,1,0,183,0,-183
587,0,0,84,0,-84
588,1,1,85,1252,1167
589,1,0,197,0,-197
590,1,0,82,0,-82
591,0,0,87,0,-87
592,0,0,115,0,-115
593,1,1,536,1608,1072
594,0,0,7,0,-7
595,0,0,43,0,-43
596,0,0,66,0,-66
597,0,0,16,0,-16
598,1,1,55,2063,2008
599,0,0,34,0,-34
600,1,1,69,1398,1329
601,0,0,5,0,-5
602,1,0,29,0,-29
603,1,1,780,1895,1115
604,0,0,118,0,-118
605,1,1,655,1268,613
606,1,1,511,1237,726
607,0,0,231,0,-231
608,0,0,63,0,-63
609,1,0,26,0,-26
610,1,1,181,1372,1191
611,1,1,95,1407,1312
612,0,0,43,0,-43
613,1,0,2,0,-2
614,0,0,57,0,-57
615,0,0,88,0,-88
616,1,1,1125,1401,276
617,1,0,27,0,-27
618,0,0,46,0,-46
619,1,0,103,0,-103
620,0,0,12,0,-12
621,0,0,114,0,-114
622,0,0,143,0,-143
623,1,0,13,0,-13
624,1,0,31,0,-31
625,1,1,224,1218,994
626,0,0,18,0,-18
627,1,0,85,0,-85
628,1,0,168,0,-168
629,1,1,1153,1853,700
630,1,1,199,1445,1246
631,0,0,85,0,-85
632,0,0,216,0,-216
633,0,0,28,0,-28
634,0,0,24,0,-24
635,0,0,16,0,-16
636,1,1,447,1374,927
637,0,0,37,0,-37
638,1,0,11,0,-11
639,1,1,524,1213,689
640,1,0,121,0,-121
641,0,0,29,0,-29
642,1,0,166,0,-166
643,0,0,56,0,-56
644,1,0,83,0,-83
645,0,0,38,0,-38
646,0,0,1,0,-1
647,0,0,35,0,-35
648,0,0,34,0,-34
649,0,0,55,0,-55
650,1,1,143,1359,1216
651,1,1,1540,1523,-17
652,0,0,35,0,-35
653,1,0,33,0,-33
654,1,0,13,0,-13
655,0,0,40,0,-40
656,0,0,5,0,-5
657,1,0,41,0,-41
658,0,0,7,0,-7
659,1,0,50,0,-50
660,1,1,729,1306,577
661,1,1,277,1777,1500
662,1,0,12,0,-12
663,0,0,58,0,-58
664,0,0,18,0,-18
665,1,1,433,1268,835
666,1,1,240,1319,1079
667,1,1,244,1420,1176
668,0,0,14,0,-14
669,0,0,4,0,-4
670,1,1,587,1423,836
671,1,1,471,1293,822
672,1,0,44,0,-44
673,1,0,10,0,-10
674,0,0,29,0,-29
675,0,0,19,0,-19
676,1,0,21,0,-21
677,1,0,6,0,-6
678,1,1,464,1283,819
679,1,1,1812,1388,-424
680,1,0,18,0,-18
681,1,0,13,0,-13
682,0,0,53,0,-53
683,1,1,155,1299,1144
684,1,1,433,1459,1026
685,1,0,17,0,-17
686,1,0,0,0,0
687,1,1,853,1375,522
688,0,0,55,0,-55
689,0,0,118,0,-118
690,1,0,16,0,-16
691,1,1,241,1661,1420
692,0,0,39,0,-39
693,1,1,876,1222,346
694,0,0,96,0,-96
695,0,0,80,0,-80
696,0,0,41,0,-41
697,1,0,101,0,-101
698,1,0,7,0,-7
699,1,0,5,0,-5
700,1,0,116,0,-116
701,0,0,226,0,-226
702,0,0,39,0,-39
703,0,0,90,0,-90
704,0,0,27,0,-27
705,1,1,274,1473,1199
706,0,0,19,0,-19
707,1,0,12,0,-12
708,0,0,44,0,-44
709,1,1,903,1214,311
710,0,0,56,0,-56
711,0,0,99,0,-99
712,0,0,46,0,-46
713,1,0,65,0,-65
714,1,0,33,0,-33
715,0,0,11,0,-11
716,1,0,88,0,-88
717,1,0,61,0,-61
718,1,1,146,1998,1852
719,1,0,79,0,-79
720,1,1,281,1449,1168
721,1,0,46,0,-46
722,0,0,1,0,-1
723,0,0,30,0,-30
724,1,0,9,0,-9
725,1,1,42,1519,1477
726,0,0,21,0,-21
727,1,0,37,0,-37
728,0,0,195,0,-195
729,1,0,101,0,-101
730,1,0,13,0,-13
731,1,0,8,0,-8
732,1,0,52,0,-52
733,0,0,1,0,-1
734,1,0,128,0,-128
735,1,1,2393,1251,-1142
736,0,0,3,0,-3
737,1,1,138,1227,1089
738,1,1,600,1500,900
739,1,1,140,1644,1504
740,1,0,19,0,-19
741,1,1,565,1201,636
742,0,0,31,0,-31
743,0,0,155,0,-155
744,1,1,1747,1361,-386
745,1,1,206,1488,1282
746,1,1,224,1889,1665
747,0,0,18,0,-18
748,1,1,63,1244,1181
749,1,1,588,1267,679
750,0,0,21,0,-21
751,0,0,68,0,-68
752,0,0,64,0,-64
753,1,0,94,0,-94
754,1,1,1346,1275,-71
755,0,0,47,0,-47
756,1,1,47,1801,1754
757,1,0,80,0,-80
758,0,0,18,0,-18
759,1,0,97,0,-97
760,1,1,354,1325,971
761,0,0,72,0,-72
762,1,1,786,1247,461
763,1,0,51,0,-51
764,1,0,67,0,-67
765,1,0,82,0,-82
766,1,0,41,0,-41
767,1,1,145,1582,1437
768,1,1,1041,1734,693
769,1,1,74,2190,2116
770,1,1,408,1406,998
771,1,1,753,1725,972
772,1,0,28,0,-28
773,1,1,315,1216,901
774,1,0,14,0,-14
775,1,0,1,0,-1
776,1,1,793,1280,487
777,1,1,897,1462,565
778,1,1,440,2142,1702
779,1,0,19,0,-19
780,1,1,345,1560,1215
781,1,1,2507,1248,-1259
782,1,0,17,0,-17
783,0,0,25,0,-25
784,1,1,665,1543,878
785,1,0,37,0,-37
786,1,1,202,1475,1273
787,1,1,38,1420,1382
788,0,0,92,0,-92
789,0,0,82,0,-82
790,0,0,5,0,-5
791,0,0,42,0,-42
792,1,1,307,1539,1232
793,1,1,279,1599,1320
794,0,0,48,0,-48
795,1,1,1000,1374,374
796,0,0,8,0,-8
797,0,0,11,0,-11
798,1,1,64,1293,1229
799,1,1,962,1607,645
800,1,0,30,0,-30
801,1,1,596,1212,616
802,0,0,61,0,-61
803,1,1,110,1837,1727
804,1,0,12,0,-12
805,0,0,17,0,-17
806,1,1,614,2179,1565
807,1,0,84,0,-84
808,1,0,32,0,-32
809,1,0,34,0,-34
810,1,0,84,0,-84
811,1,0,121,0,-121
812,1,1,38,2145,2107
813,1,1,33,3339,3306
814,1,1,1558,1872,314
815,1,0,72,0,-72
816,1,0,87,0,-87
817,0,0,70,0,-70
818,1,0,58,0,-58
819,1,0,75,0,-75
820,0,0,82,0,-82
821,1,0,23,0,-23
822,1,1,70,1620,1550
823,1,0,73,0,-73
824,1,0,29,0,-29
825,1,0,9,0,-9
826,1,0,127,0,-127
827,0,0,6,0,-6
828,0,0,17,0,-17
829,0,0,27,0,-27
830,1,1,109,1319,1210
831,1,0,2,0,-2
832,0,0,47,0,-47
833,1,0,25,0,-25
834,1,1,402,1216,814
835,1,1,560,1356,796
836,1,1,426,1473,1047
837,0,0,137,0,-137
838,0,0,62,0,-62
839,0,0,16,0,-16
840,0,0,13,0,-13
841,1,0,6,0,-6
842,0,0,50,0,-50
843,1,0,13,0,-13
844,1,1,373,1229,856
845,1,1,2304,1313,-991
846,0,0,19,0,-19
847,0,0,19,0,-19
848,1,0,73,0,-73
849,0,0,23,0,-23
850,1,0,27,0,-27
851,0,0,8,0,-8
852,0,0,103,0,-103
853,1,0,35,0,-35
854,1,0,35,0,-35
855,0,0,16,0,-16
856,0,0,18,0,-18
857,1,1,83,1208,1125
858,0,0,65,0,-65
859,0,0,13,0,-13
860,1,1,1643,1833,190
861,1,1,865,1218,353
862,0,0,26,0,-26
863,0,0,12,0,-12
864,0,0,75,0,-75
865,0,0,24,0,-24
866,1,1,777,1472,695
867,1,0,86,0,-86
868,0,0,59,0,-59
869,0,0,29,0,-29
870,1,1,495,1615,1120
871,1,1,177,2064,1887
872,0,0,40,0,-40
873,1,1,333,1366,1033
874,0,0,17,0,-17
875,0,0,2,0,-2
876,0,0,25,0,-25
877,0,0,153,0,-153
878,0,0,61,0,-61
879,1,1,239,1778,1539
880,1,0,38,0,-38
881,1,1,2101,1245,-856
882,1,0,25,0,-25
883,1,1,334,1712,1378
884,1,0,12,0,-12
885,0,0,10,0,-10
886,1,1,1574,1326,-248
887,1,1,124,1258,1134
888,0,0,29,0,-29
889,0,0,9,0,-9
890,1,0,39,0,-39
891,0,0,21,0,-21
892,0,0,125,0,-125
893,1,1,1777,1295,-482
894,0,0,6,0,-6
895,0,0,20,0,-20
896,1,0,127,0,-127
897,0,0,22,0,-22
898,1,1,232,1349,1117
899,0,0,6,0,-6
900,1,1,729,1409,680
901,0,0,14,0,-14
902,1,1,2529,1319,-1210
903,1,0,66,0,-66
904,0,0,11,0,-11
905,0,0,20,0,-20
906,1,0,103,0,-103
907,1,0,38,0,-38
908,1,0,19,0,-19
909,0,0,8,0,-8
910,1,1,580,3899,3319
911,1,1,546,1781,1235
912,1,0,50,0,-50
913,0,0,74,0,-74
914,1,0,15,0,-15
915,1,0,72,0,-72
916,0,0,42,0,-42
917,1,0,37,0,-37
918,0,0,121,0,-121
919,0,0,19,0,-19
920,0,0,37,0,-37
921,0,0,11,0,-11
922,1,0,11,0,-11
923,1,1,571,1478,907
924,0,0,37,0,-37
925,0,0,7,0,-7
926,1,1,383,1651,1268
927,1,1,2535,1363,-1172
928,1,1,618,1342,724
929,0,0,81,0,-81
930,1,1,148,1248,1100
931,1,1,422,2105,1683
932,1,0,24,0,-24
933,1,0,24,0,-24
934,1,1,218,2643,2425
935,1,0,36,0,-36
936,1,1,509,1429,920
937,1,0,17,0,-17
938,1,0,2,0,-2
939,1,0,179,0,-179
940,1,1,427,1234,807
941,1,0,24,0,-24
942,1,1,160,1941,1781
943,0,0,242,0,-242
944,1,0,2,0,-2
945,0,0,32,0,-32
946,0,0,19,0,-19
947,1,1,513,2045,1532
948,0,0,22,0,-22
949,1,0,34,0,-34
950,0,0,122,0,-122
951,1,1,2077,1605,-472
952,0,0,22,0,-22
953,1,0,24,0,-24
954,0,0,57,0,-57
955,0,0,8,0,-8
956,1,1,555,1359,804
957,0,0,28,0,-28
958,1,1,156,1290,1134
959,1,0,1,0,-1
960,1,1,1753,1609,-144
961,1,1,391,1253,862
962,0,0,71,0,-71
963,1,0,58,0,-58
964,0,0,73,0,-73
965,0,0,11,0,-11
966,1,0,26,0,-26
967,0,0,46,0,-46
968,1,1,546,1707,1161
969,0,0,126,0,-126
970,1,0,11,0,-11
971,1,1,720,2752,2032
972,0,0,35,0,-35
973,1,1,70,1209,1139
974,0,0,3,0,-3
975,0,0,22,0,-22
976,0,0,95,0,-95
977,0,0,27,0,-27
978,1,0,27,0,-27
979,0,0,101,0,-101
980,0,0,78,0,-78
981,1,1,1495,1951,456
982,1,1,422,1271,849
983,1,1,128,1671,1543
984,1,0,7,0,-7
985,1,1,194,1381,1187
986,0,0,20,0,-20
987,0,0,10,0,-10
988,0,0,0,0,0
989,0,0,37,0,-37
990,0,0,19,0,-19
991,1,0,19,0,-19
992,1,0,140,0,-140
993,0,0,25,0,-25
994,1,0,5,0,-5
995,1,0,38,0,-38
996,1,0,25,0,-25
997,0,0,67,0,-67
998,0,0,66,0,-66
999,1,0,37,0,-37
1000,1,1,261,1278,1017
1001,1,1,1560,1708,148
1002,1,1,2581,1414,-1167
1003,0,0,47,0,-47
1004,0,0,1,0,-1
1005,0,0,16,0,-16
1006,0,0,44,0,-44
1007,1,0,23,0,-23
1008,0,0,27,0,-27
1009,0,0,14,0,-14
1010,1,1,1430,2016,586
1011,0,0,1,0,-1
1012,0,0,94,0,-94
1013,1,1,445,1434,989
1014,1,1,213,1315,1102
1015,1,0,81,0,-81
1016,1,1,1119,1375,256
1017,1,0,18,0,-18
1018,1,1,113,1571,1458
1019,1,0,70,0,-70
1020,0,0,1,0,-1
1021,1,1,134,1259,1125
1022,0,0,36,0,-36
1023,0,0,0,0,0
1024,0,0,16,0,-16
1025,1,1,985,1451,466
1026,1,0,0,0,0
1027,1,0,142,0,-142
1028,0,0,49,0,-49
1029,0,0,5,0,-5
1030,1,0,59,0,-59
1031,0,0,79,0,-79
1032,0,0,39,0,-39
1033,0,0,122,0,-122
1034,0,0,21,0,-21
1035,0,0,57,0,-57
1036,1,1,210,1329,1119
1037,1,0,9,0,-9
1038,0,0,77,0,-77
1039,1,1,66,1758,1692
1040,0,0,32,0,-32
1041,0,0,26,0,-26
1042,0,0,0,0,0
1043,0,0,33,0,-33
1044,0,0,59,0,-59
1045,1,0,138,0,-138
1046,1,0,34,0,-34
1047,1,1,264,1338,1074
1048,1,1,81,1214,1133
1049,1,1,463,1305,842
1050,1,1,838,1259,421
1051,1,1,871,1217,346
1052,1,1,1071,1238,167
1053,0,0,4,0,-4
1054,1,1,361,1693,1332
1055,1,1,205,1942,1737
1056,0,0,83,0,-83
1057,1,0,9,0,-9
1058,1,1,1366,1401,35
1059,1,0,241,0,-241
1060,0,0,4,0,-4
1061,1,1,93,1709,1616
1062,1,0,55,0,-55
1063,1,1,327,1510,1183
1064,0,0,37,0,-37
1065,0,0,86,0,-86
1066,0,0,143,0,-143
1067,0,0,25,0,-25
1068,1,0,64,0,-64
1069,0,0,31,0,-31
1070,1,0,103,0,-103
1071,1,1,750,1654,904
1072,0,0,223,0,-223
1073,1,1,376,1416,1040
1074,1,0,66,0,-66
1075,0,0,5,0,-5
1076,1,1,655,1344,689
1077,1,1,748,1413,665
1078,1,1,181,1223,1042
1079,0,0,44,0,-44
1080,0,0,14,0,-14
1081,1,1,221,1574,1353
1082,1,1,900,1240,340
1083,1,1,232,1388,1156
1084,1,0,33,0,-33
1085,0,0,49,0,-49
1086,0,0,76,0,-76
1087,1,0,27,0,-27
1088,0,0,76,0,-76
1089,1,1,214,2089,1875
1090,1,1,241,1303,1062
1091,1,1,180,1221,1041
1092,0,0,63,0,-63
1093,1,1,567,1565,998
1094,0,0,17,0,-17
1095,1,1,612,1606,994
1096,0,0,49,0,-49
1097,0,0,6,0,-6
1098,1,1,570,1471,901
1099,1,1,398,1664,1266
1100,1,1,806,1847,1041
1101,0,0,9,0,-9
1102,0,0,4,0,-4
1103,1,1,166,1485,1319
1104,1,0,83,0,-83
1105,1,1,635,3177,2542
1106,0,0,100,0,-100
1107,1,1,1547,2158,611
1108,1,1,537,2163,1626
1109,0,0,4,0,-4
1110,0,0,29,0,-29
1111,1,1,184,1318,1134
1112,0,0,18,0,-18
1113,1,0,26,0,-26
1114,1,0,10,0,-10
1115,1,1,245,1284,1039
1116,1,0,11,0,-11
1117,1,1,196,1423,1227
1118,1,1,601,1624,1023
1119,0,0,10,0,-10
1120,0,0,61,0,-61
1121,0,0,4,0,-4
1122,0,0,1,0,-1
1123,0,0,11,0,-11
1124,0,0,41,0,-41
1125,1,1,365,1312,947
1126,1,1,482,1464,982
1127,1,0,111,0,-111
1128,0,0,13,0,-13
1129,1,1,71,1283,1212
1130,0,0,25,0,-25
1131,0,0,140,0,-140
1132,1,1,734,1448,714
1133,1,0,18,0,-18
1134,0,0,13,0,-13
1135,1,0,93,0,-93
1136,1,1,604,1483,879
1137,1,0,158,0,-158
1138,1,0,2,0,-2
1139,0,0,21,0,-21
1140,0,0,0,0,0
1141,1,0,65,0,-65
1142,1,1,2447,1287,-1160
1143,1,0,4,0,-4
1144,0,0,75,0,-75
1145,1,0,57,0,-57
1146,1,0,0,0,0
1147,1,1,426,1223,797
1148,0,0,75,0,-75
1149,0,0,36,0,-36
1150,0,0,1,0,-1
1151,0,0,107,0,-107
1152,1,1,209,1277,1068
1153,1,0,73,0,-73
1154,1,1,379,1226,847
1155,1,1,172,1200,1028
1156,1,1,49,1627,1578
1157,0,0,22,0,-22
1158,0,0,100,0,-100
1159,0,0,102,0,-102
1160,1,0,0,0,0
1161,0,0,65,0,-65
1162,1,0,35,0,-35
1163,1,1,436,1887,1451
1164,0,0,179,0,-179
1165,0,0,82,0,-82
1166,1,1,812,1278,466
1167,1,0,52,0,-52
1168,1,1,1519,2821,1302
1169,1,0,26,0,-26
1170,0,0,82,0,-82
1171,1,0,2,0,-2
1172,1,1,550,1332,782
1173,0,0,30,0,-30
1174,1,1,213,1398,1185
1175,0,0,21,0,-21
1176,1,0,37,0,-37
1177,1,0,1,0,-1
1178,0,0,86,0,-86
1179,0,0,79,0,-79
1180,0,0,18,0,-18
1181,1,1,496,1737,1241
1182,1,0,27,0,-27
1183,0,0,27,0,-27
1184,0,0,37,0,-37
1185,0,0,3,0,-3
1186,1,0,93,0,-93
1187,1,1,204,1480,1276
1188,0,0,16,0,-16
1189,1,0,66,0,-66
1190,1,0,164,0,-164
1191,1,0,62,0,-62
1192,0,0,29,0,-29
1193,0,0,43,0,-43
1194,0,0,57,0,-57
1195,0,0,28,0,-28
1196,1,1,113,1516,1403
1197,1,0,65,0,-65
1198,0,0,386,0,-386
1199,1,0,14,0,-14
1200,1,1,188,1220,1032
1201,1,0,2,0,-2
1202,1,1,898,1308,410
1203,1,1,1409,1334,-75
1204,1,1,950,1301,351
1205,1,1,450,1697,1247
1206,1,1,314,1208,894
1207,1,1,148,1602,1454
1208,1,1,80,1267,1187
1209,1,0,27,0,-27
1210,1,0,82,0,-82
1211,1,0,27,0,-27
1212,0,0,76,0,-76
1213,1,1,218,1283,1065
1214,0,0,60,0,-60
1215,1,0,11,0,-11
1216,1,0,78,0,-78
1217,1,0,42,0,-42
1218,1,0,32,0,-32
1219,0,0,24,0,-24
1220,1,1,1512,1631,119
1221,0,0,8,0,-8
1222,1,0,39,0,-39
1223,1,1,25,1373,1348
1224,0,0,45,0,-45
1225,1,0,280,0,-280
1226,0,0,2,0,-2
1227,0,0,18,0,-18
1228,0,0,26,0,-26
1229,0,0,1,0,-1
1230,1,1,836,1779,943
1231,0,0,51,0,-51
1232,1,0,76,0,-76
1233,0,0,227,0,-227
1234,1,1,195,1213,1018
1235,0,0,7,0,-7
1236,1,1,1304,1865,561
1237,0,0,79,0,-79
1238,1,0,38,0,-38
1239,1,0,5,0,-5
1240,0,0,61,0,-61
1241,0,0,9,0,-9
1242,1,0,83,0,-83
1243,1,1,560,1804,1244
1244,1,1,131,1314,1183
1245,1,1,106,1278,1172
1246,1,0,85,0,-85
1247,0,0,126,0,-126
1248,1,1,288,2364,2076
1249,0,0,86,0,-86
1250,1,0,51,0,-51
1251,1,1,1139,1661,522
1252,0,0,11,0,-11
1253,0,0,44,0,-44
1254,0,0,104,0,-104
1255,0,0,71,0,-71
1256,1,1,417,2275,1858
1257,1,0,11,0,-11
1258,1,1,456,1306,850
1259,0,0,86,0,-86
1260,0,0,108,0,-108
1261,1,0,20,0,-20
1262,1,0,14,0,-14
1263,1,0,0,0,0
1264,1,0,8,0,-8
1265,1,1,666,1204,538
1266,1,1,212,1218,1006
1267,0,0,8,0,-8
1268,1,1,278,1567,1289
1269,1,0,1,0,-1
1270,1,1,589,1576,987
1271,0,0,1,0,-1
1272,1,1,698,4741,4043
1273,1,1,89,2467,2378
1274,1,0,45,0,-45
1275,1,1,239,1429,1190
1276,1,1,577,1582,1005
1277,1,1,607,1214,607
1278,1,1,63,2147,2084
1279,1,0,69,0,-69
1280,0,0,9,0,-9
1281,1,1,76,1677,1601
1282,1,0,26,0,-26
1283,1,1,230,2523,2293
1284,1,1,414,1806,1392
1285,1,0,151,0,-151
1286,1,0,25,0,-25
1287,1,1,154,1228,1074
1288,0,0,89,0,-89
1289,1,0,17,0,-17
1290,1,0,127,0,-127
1291,1,0,23,0,-23
1292,1,1,631,1404,773
1293,1,1,765,1474,709
1294,0,0,12,0,-12
1295,0,0,10,0,-10
1296,0,0,33,0,-33
1297,1,1,367,1212,845
1298,1,1,567,1316,749
1299,1,1,136,1883,1747
1300,1,1,422,1589,1167
1301,0,0,133,0,-133
1302,1,1,1805,1998,193
1303,1,1,154,1889,1735
1304,1,1,955,1293,338
1305,1,0,262,0,-262
1306,1,1,32,1968,1936
1307,1,0,25,0,-25
1308,1,1,1298,1498,200
1309,0,0,44,0,-44
1310,1,1,97,1260,1163
1311,1,1,1205,3544,2339
1312,1,0,46,0,-46
1313,1,1,218,2226,2008
1314,0,0,28,0,-28
1315,1,0,60,0,-60
1316,0,0,44,0,-44
1317,1,1,615,1425,810
1318,1,0,9,0,-9
1319,1,1,595,1307,712
1320,0,0,14,0,-14
1321,0,0,10,0,-10
1322,0,0,5,0,-5
1323,1,0,122,0,-122
1324,1,1,111,1394,1283
1325,0,0,27,0,-27
1326,1,1,235,1286,1051
1327,1,1,840,1258,418
1328,0,0,10,0,-10
1329,1,1,461,1579,1118
1330,1,1,511,2785,2274
1331,0,0,10,0,-10
1332,0,0,76,0,-76
1333,0,0,78,0,-78
1334,1,1,1297,1428,131
1335,0,0,2,0,-2
1336,1,0,30,0,-30
1337,1,1,1263,1272,9
1338,1,0,124,0,-124
1339,0,0,33,0,-33
1340,0,0,19,0,-19
1341,0,0,18,0,-18
1342,1,0,12,0,-12
1343,1,1,18,1927,1909
1344,1,1,200,2834,2634
1345,1,0,26,0,-26
1346,0,0,136,0,-136
1347,1,0,28,0,-28
1348,0,0,339,0,-339
1349,1,1,772,1307,535
1350,0,0,196,0,-196
1351,0,0,10,0,-10
1352,0,0,44,0,-44
1353,1,0,55,0,-55
1354,1,0,50,0,-50
1355,0,0,20,0,-20
1356,1,1,96,1310,1214
1357,1,0,20,0,-20
1358,1,0,3,0,-3
1359,1,0,27,0,-27
1360,1,0,75,0,-75
1361,1,1,1726,1330,-396
1362,0,0,109,0,-109
1363,0,0,103,0,-103
1364,0,0,10,0,-10
1365,1,0,4,0,-4
1366,1,1,22,1214,1192
1367,1,1,270,1237,967
1368,1,0,37,0,-37
1369,1,1,265,1326,1061
1370,1,0,113,0,-113
1371,1,1,550,1761,1211
1372,0,0,17,0,-17
1373,0,0,52,0,-52
1374,1,0,56,0,-56
1375,0,0,23,0,-23
1376,1,0,67,0,-67
1377,0,0,27,0,-27
1378,0,0,9,0,-9
1379,1,1,855,1638,783
1380,1,0,33,0,-33
1381,1,0,79,0,-79
1382,1,0,2,0,-2
1383,0,0,5,0,-5
1384,0,0,35,0,-35
1385,0,0,20,0,-20
1386,1,1,807,1205,398
1387,0,0,9,0,-9
1388,0,0,11,0,-11
1389,1,1,1334,1508,174
1390,0,0,31,0,-31
1391,0,0,12,0,-12
1392,0,0,10,0,-10
1393,0,0,88,0,-88
1394,1,1,379,1892,1513
1395,1,0,1,0,-1
1396,0,0,0,0,0
1397,1,0,78,0,-78
1398,1,1,911,1400,489
1399,0,0,28,0,-28
1400,0,0,80,0,-80
1401,1,0,105,0,-105
1402,1,0,3,0,-3
1403,1,1,964,1480,516
1404,1,0,39,0,-39
1405,1,1,530,1385,855
1406,0,0,107,0,-107
1407,1,1,467,1375,908
1408,1,0,145,0,-145
1409,0,0,45,0,-45
1410,1,0,20,0,-20
1411,0,0,8,0,-8
1412,0,0,8,0,-8
1413,1,1,233,1393,1160
1414,0,0,10,0,-10
1415,1,1,675,1718,1043
1416,0,0,0,0,0
1417,1,1,645,1307,662
1418,1,0,9,0,-9
1419,1,0,5,0,-5
1420,1,0,24,0,-24
1421,0,0,61,0,-61
1422,0,0,5,0,-5
1423,0,0,30,0,-30
1424,1,0,30,0,-30
1425,1,1,1292,1354,62
1426,1,0,45,0,-45
1427,1,0,41,0,-41
1428,0,0,23,0,-23
1429,1,1,569,1235,666
1430,1,0,140,0,-140
1431,1,1,749,1776,1027
1432,0,0,87,0,-87
1433,1,1,385,1315,930
1434,0,0,69,0,-69
1435,1,1,16,1693,1677
1436,1,1,418,1653,1235
1437,0,0,16,0,-16
1438,1,0,36,0,-36
1439,0,0,35,0,-35
1440,1,1,1045,1688,643
1441,1,1,164,8601,8437
1442,1,0,20,0,-20
1443,0,0,7,0,-7
1444,1,0,1,0,-1
1445,1,1,155,2093,1938
1446,1,1,968,1215,247
1447,0,0,54,0,-54
1448,1,0,43,0,-43
1449,1,0,17,0,-17
1450,1,1,390,1602,1212
1451,1,1,23,1400,1377
1452,1,0,32,0,-32
1453,1,0,5,0,-5
1454,1,0,45,0,-45
1455,1,1,368,1959,1591
1456,0,0,176,0,-176
1457,0,0,8,0,-8
1458,0,0,51,0,-51
1459,0,0,45,0,-45
1460,1,0,9,0,-9
1461,1,1,459,1213,754
1462,1,1,434,1678,1244
1463,1,1,162,1569,1407
1464,1,0,240,0,-240
1465,0,0,129,0,-129
1466,1,1,87,2976,2889
1467,1,0,13,0,-13
1468,1,1,112,1476,1364
1469,0,0,146,0,-146
1470,1,0,38,0,-38
1471,1,1,384,1220,836
1472,0,0,8,0,-8
1473,0,0,35,0,-35
1474,1,0,56,0,-56
1475,0,0,66,0,-66
1476,1,1,132,1281,1149
1477,1,0,1,0,-1
1478,1,0,1,0,-1
1479,0,0,16,0,-16
1480,1,1,389,1319,930
1481,0,0,124,0,-124
1482,1,1,388,1836,1448
1483,1,0,38,0,-38
1484,0,0,61,0,-61
1485,0,0,2,0,-2
1486,0,0,68,0,-68
1487,1,0,79,0,-79
1488,0,0,11,0,-11
1489,1,0,197,0,-197
1490,0,0,24,0,-24
1491,0,0,11,0,-11
1492,1,0,193,0,-193
1493,0,0,94,0,-94
1494,0,0,6,0,-6
1495,1,1,339,1293,954
1496,1,1,737,1284,547
1497,1,0,15,0,-15
1498,0,0,10,0,-10
1499,0,0,91,0,-91
1500,1,1,615,1379,764
1501,1,1,247,1321,1074
1502,0,0,42,0,-42
1503,0,0,18,0,-18
1504,0,0,109,0,-109
1505,1,1,1187,5718,4531
1506,0,0,85,0,-85
1507,1,0,7,0,-7
1508,1,1,30,1469,1439
1509,1,1,536,1867,1331
1510,0,0,37,0,-37
1511,0,0,1,0,-1
1512,1,1,496,1525,1029
1513,1,0,50,0,-50
1514,1,1,289,1552,1263
1515,0,0,22,0,-22
1516,1,0,56,0,-56
1517,1,0,22,0,-22
1518,1,0,133,0,-133
1519,0,0,115,0,-115
1520,1,1,161,1675,1514
1521,1,1,577,1488,911
1522,0,0,19,0,-19
1523,1,0,71,0,-71
1524,1,1,1190,1235,45
1525,0,0,20,0,-20
1526,1,1,560,1342,782
1527,1,1,1117,1478,361
1528,0,0,48,0,-48
1529,1,1,211,1396,1185
1530,1,1,253,1284,1031
1531,0,0,40,0,-40
1532,0,0,8,0,-8
1533,1,0,191,0,-191
1534,1,0,38,0,-38
1535,1,0,58,0,-58
1536,1,0,79,0,-79
1537,1,0,115,0,-115
1538,1,0,51,0,-51
1539,0,0,76,0,-76
1540,1,1,227,1252,1025
1541,0,0,56,0,-56
1542,0,0,29,0,-29
1543,1,1,1879,1682,-197
1544,1,1,1472,1288,-184
1545,1,1,232,1728,1496
1546,1,0,0,0,0
1547,1,1,43,3165,3122
1548,1,1,523,1789,1266
1549,1,0,15,0,-15
1550,1,0,65,0,-65
1551,0,0,27,0,-27
1552,0,0,107,0,-107
1553,1,0,12,0,-12
1554,1,1,249,1215,966
1555,0,0,1,0,-1
1556,1,0,6,0,-6
1557,1,1,1057,1610,553
1558,1,1,214,1205,991
1559,1,0,11,0,-11
1560,1,1,306,1263,957
1561,0,0,18,0,-18
1562,0,0,35,0,-35
1563,0,0,58,0,-58
1564,1,1,54,1274,1220
1565,1,0,20,0,-20
1566,1,0,0,0,0
1567,1,0,112,0,-112
1568,0,0,29,0,-29
1569,0,0,91,0,-91
1570,1,0,92,0,-92
1571,0,0,8,0,-8
1572,1,0,2,0,-2
1573,0,0,10,0,-10
1574,1,0,15,0,-15
1575,1,1,542,1423,881
1576,0,0,9,0,-9
1577,1,0,5,0,-5
1578,0,0,67,0,-67
1579,0,0,3,0,-3
1580,0,0,6,0,-6
1581,0,0,42,0,-42
1582,1,0,103,0,-103
1583,1,0,69,0,-69
1584,0,0,63,0,-63
1585,0,0,58,0,-58
1586,0,0,42,0,-42
1587,0,0,17,0,-17
1588,0,0,56,0,-56
1589,0,0,69,0,-69
1590,0,0,70,0,-70
1591,1,0,8,0,-8
1592,1,1,142,3587,3445
1593,1,1,216,1358,1142
1594,0,0,31,0,-31
1595,1,0,75,0,-75
1596,0,0,12,0,-12
1597,1,0,34,0,-34
1598,0,0,32,0,-32
1599,0,0,86,0,-86
1600,0,0,0,0,0
1601,1,0,77,0,-77
1602,0,0,39,0,-39
1603,1,1,434,1710,1276
1604,0,0,42,0,-42
1605,1,1,244,2902,2658
1606,0,0,75,0,-75
1607,0,0,126,0,-126
1608,1,1,411,1502,1091
1609,1,1,661,1277,616
1610,1,0,20,0,-20
1611,0,0,175,0,-175
1612,0,0,79,0,-79
1613,1,1,169,1219,1050
1614,0,0,84,0,-84
1615,0,0,71,0,-71
1616,1,1,2933,2222,-711
1617,1,1,527,1401,874
1618,0,0,48,0,-48
1619,1,1,448,1514,1066
1620,1,1,683,1682,999
1621,1,0,7,0,-7
1622,0,0,53,0,-53
1623,1,0,5,0,-5
1624,0,0,7,0,-7
1625,0,0,47,0,-47
1626,0,0,122,0,-122
1627,1,0,217,0,-217
1628,1,1,1442,1578,136
1629,1,1,466,1288,822
1630,1,1,240,1244,1004
1631,0,0,1,0,-1
1632,0,0,9,0,-9
1633,0,0,38,0,-38
1634,1,0,143,0,-143
1635,1,1,362,1655,1293
1636,0,0,9,0,-9
1637,1,1,180,1331,1151
1638,1,1,1741,1200,-541
1639,0,0,16,0,-16
1640,1,1,255,2671,2416
1641,0,0,2,0,-2
1642,1,1,554,1271,717
1643,1,1,747,1789,1042
1644,1,1,489,1249,760
1645,0,0,120,0,-120
1646,1,1,969,1761,792
1647,1,0,16,0,-16
1648,0,0,41,0,-41
1649,0,0,87,0,-87
1650,0,0,33,0,-33
1651,1,1,814,1222,408
1652,1,0,78,0,-78
1653,0,0,60,0,-60
1654,0,0,52,0,-52
1655,1,1,610,1306,696
1656,0,0,41,0,-41
1657,1,1,14,1572,1558
1658,1,0,34,0,-34
1659,1,1,183,1343,1160
1660,1,1,190,1432,1242
1661,0,0,72,0,-72
1662,1,1,283,1745,1462
1663,0,0,41,0,-41
1664,1,0,10,0,-10
1665,1,0,8,0,-8
1666,1,0,136,0,-136
1667,1,1,312,1500,1188
1668,0,0,63,0,-63
1669,1,1,110,1359,1249
1670,1,1,174,1446,1272
1671,0,0,54,0,-54
1672,0,0,7,0,-7
1673,1,1,428,1397,969
1674,1,1,122,1390,1268
1675,0,0,29,0,-29
1676,1,1,1492,1530,38
1677,0,0,0,0,0
1678,1,0,37,0,-37
1679,0,0,12,0,-12
1680,1,0,41,0,-41
1681,0,0,25,0,-25
1682,1,1,504,1476,972
1683,1,1,342,1649,1307
1684,1,0,78,0,-78
1685,1,0,44,0,-44
1686,1,1,171,1461,1290
1687,1,0,95,0,-95
1688,0,0,0,0,0
1689,1,1,64,1220,1156
1690,1,1,751,1668,917
1691,0,0,136,0,-136
1692,0,0,13,0,-13
1693,1,0,45,0,-45
1694,0,0,22,0,-22
1695,1,1,1216,4520,3304
1696,0,0,9,0,-9
1697,1,0,37,0,-37
1698,1,0,76,0,-76
1699,1,1,425,1253,828
1700,1,1,709,1502,793
1701,0,0,90,0,-90
1702,0,0,8,0,-8
1703,1,0,22,0,-22
1704,1,0,124,0,-124
1705,0,0,11,0,-11
1706,1,0,48,0,-48
1707,0,0,4,0,-4
1708,1,0,14,0,-14
1709,1,0,88,0,-88
1710,1,1,88,1624,1536
1711,0,0,22,0,-22
1712,1,0,0,0,0
1713,0,0,24,0,-24
1714,1,1,1024,2905,1881
1715,0,0,54,0,-54
1716,1,0,44,0,-44
1717,0,0,3,0,-3
1718,0,0,22,0,-22
1719,0,0,74,0,-74
1720,0,0,22,0,-22
1721,0,0,73,0,-73
1722,0,0,76,0,-76
1723,0,0,18,0,-18
1724,0,0,19,0,-19
1725,1,1,740,1535,795
1726,0,0,48,0,-48
1727,0,0,33,0,-33
1728,1,1,744,1267,523
1729,1,1,702,2462,1760
1730,1,1,1155,1468,313
1731,0,0,143,0,-143
1732,0,0,13,0,-13
1733,1,0,90,0,-90
1734,1,0,46,0,-46
1735,0,0,15,0,-15
1736,0,0,35,0,-35
1737,0,0,163,0,-163
1738,1,1,280,1209,929
1739,0,0,8,0,-8
1740,0,0,56,0,-56
1741,1,0,29,0,-29
1742,1,1,595,1267,672
1743,1,0,33,0,-33
1744,1,0,7,0,-7
1745,1,1,566,1477,911
1746,0,0,103,0,-103
1747,0,0,63,0,-63
1748,1,0,20,0,-20
1749,0,0,68,0,-68
1750,0,0,37,0,-37
1751,0,0,80,0,-80
1752,1,0,107,0,-107
1753,1,0,24,0,-24
1754,1,0,6,0,-6
1755,1,1,218,1212,994
1756,1,0,3,0,-3
1757,0,0,61,0,-61
1758,1,0,21,0,-21
1759,0,0,9,0,-9
1760,1,1,855,1402,547
1761,0,0,10,0,-10
1762,1,0,27,0,-27
1763,0,0,82,0,-82
1764,0,0,11,0,-11
1765,0,0,20,0,-20
1766,1,0,4,0,-4
1767,0,0,3,0,-3
1768,0,0,115,0,-115
1769,1,1,187,1454,1267
1770,0,0,10,0,-10
1771,1,1,465,1547,1082
1772,1,1,872,1571,699
1773,1,1,283,1745,1462
1774,1,0,12,0,-12
1775,1,0,0,0,0
1776,1,0,21,0,-21
1777,0,0,63,0,-63
1778,1,1,344,1710,1366
1779,1,0,56,0,-56
1780,1,0,36,0,-36
1781,1,1,318,1420,1102
1782,0,0,4,0,-4
1783,1,0,21,0,-21
1784,1,0,164,0,-164
1785,1,0,98,0,-98
1786,1,1,395,2447,2052
1787,0,0,2,0,-2
1788,0,0,5,0,-5
1789,0,0,52,0,-52
1790,1,0,2,0,-2
1791,0,0,3,0,-3
1792,1,0,9,0,-9
1793,1,0,52,0,-52
1794,1,1,168,1686,1518
1795,1,0,10,0,-10
1796,0,0,5,0,-5
1797,0,0,57,0,-57
1798,1,0,41,0,-41
1799,0,0,33,0,-33
1800,0,0,3,0,-3
1801,0,0,7,0,-7
1802,0,0,158,0,-158
1803,1,0,53,0,-53
1804,0,0,52,0,-52
1805,0,0,107,0,-107
1806,0,0,22,0,-22
1807,0,0,272,0,-272
1808,1,0,43,0,-43
1809,0,0,124,0,-124
1810,1,1,85,1717,1632
1811,0,0,40,0,-40
1812,1,1,1080,1224,144
1813,1,0,109,0,-109
1814,0,0,6,0,-6
1815,1,0,17,0,-17
1816,1,0,14,0,-14
1817,0,0,29,0,-29
1818,0,0,188,0,-188
1819,1,0,71,0,-71
1820,1,1,290,2112,1822
1821,0,0,4,0,-4
1822,1,0,29,0,-29
1823,1,1,180,1429,1249
1824,1,0,60,0,-60
1825,1,0,92,0,-92
1826,1,0,17,0,-17
1827,1,1,1276,1243,-33
1828,1,0,38,0,-38
1829,1,1,958,1275,317
1830,1,0,19,0,-19
1831,1,1,299,1257,958
1832,0,0,225,0,-225
1833,0,0,76,0,-76
1834,0,0,128,0,-128
1835,1,1,408,1496,1088
1836,0,0,90,0,-90
1837,0,0,8,0,-8
1838,1,1,710,1435,725
1839,1,0,342,0,-342
1840,0,0,122,0,-122
1841,0,0,61,0,-61
1842,1,0,68,0,-68
1843,1,0,67,0,-67
1844,0,0,31,0,-31
1845,1,1,1598,1329,-269
1846,1,0,13,0,-13
1847,0,0,147,0,-147
1848,1,0,12,0,-12
1849,1,0,21,0,-21
1850,0,0,95,0,-95
1851,0,0,8,0,-8
1852,1,1,228,2229,2001
1853,1,0,50,0,-50
1854,1,0,27,0,-27
1855,1,0,3,0,-3
1856,1,0,25,0,-25
1857,0,0,42,0,-42
1858,1,0,62,0,-62
1859,0,0,87,0,-87
1860,1,1,235,1977,1742
1861,0,0,9,0,-9
1862,1,0,49,0,-49
1863,1,1,1526,1308,-218
1864,1,1,123,1262,1139
1865,0,0,16,0,-16
1866,1,1,286,1553,1267
1867,0,0,140,0,-140
1868,0,0,27,0,-27
1869,1,1,370,1354,984
1870,0,0,18,0,-18
1871,1,0,139,0,-139
1872,0,0,32,0,-32
1873,1,0,5,0,-5
1874,0,0,15,0,-15
1875,1,1,424,1386,962
1876,1,0,9,0,-9
1877,1,1,637,1484,847
1878,1,0,76,0,-76
1879,1,1,1047,1441,394
1880,0,0,236,0,-236
1881,1,0,16,0,-16
1882,1,0,6,0,-6
1883,1,0,179,0,-179
1884,1,1,70,1661,1591
1885,0,0,52,0,-52
1886,1,0,15,0,-15
1887,0,0,58,0,-58
1888,0,0,10,0,-10
1889,0,0,29,0,-29
1890,0,0,235,0,-235
1891,1,1,81,1964,1883
1892,1,1,284,1284,1000
1893,1,0,5,0,-5
1894,1,1,1091,1249,158
1895,0,0,85,0,-85
1896,0,0,69,0,-69
1897,1,0,24,0,-24
1898,1,1,57,1861,1804
1899,1,1,382,1952,1570
1900,1,1,208,1384,1176
1901,1,0,104,0,-104
1902,0,0,55,0,-55
1903,1,1,424,1749,1325
1904,0,0,132,0,-132
1905,1,1,350,1522,1172
1906,0,0,106,0,-106
1907,1,0,3,0,-3
1908,1,0,9,0,-9
1909,1,0,3,0,-3
1910,1,0,56,0,-56
1911,0,0,62,0,-62
1912,1,1,306,2343,2037
1913,1,1,379,1264,885
1914,0,0,8,0,-8
1915,1,1,389,1322,933
1916,0,0,64,0,-64
1917,1,0,15,0,-15
1918,1,1,979,1284,305
1919,1,1,238,1299,1061
1920,0,0,77,0,-77
1921,0,0,29,0,-29
1922,1,0,153,0,-153
1923,1,0,4,0,-4
1924,0,0,80,0,-80
1925,1,0,165,0,-165
1926,0,0,26,0,-26
1927,1,0,17,0,-17
1928,1,1,1675,1351,-324
1929,1,0,6,0,-6
1930,1,1,286,1583,1297
1931,0,0,34,0,-34
1932,1,1,224,1319,1095
1933,1,1,571,2183,1612
1934,0,0,38,0,-38
1935,0,0,36,0,-36
1936,1,1,18,1360,1342
1937,1,0,79,0,-79
1938,1,0,81,0,-81
1939,1,1,44,2059,2015
1940,1,1,947,2123,1176
1941,0,0,13,0,-13
1942,1,1,415,1728,1313
1943,1,0,90,0,-90
1944,1,0,32,0,-32
1945,1,0,117,0,-117
1946,1,0,10,0,-10
1947,1,0,7,0,-7
1948,0,0,39,0,-39
1949,1,1,187,1242,1055
1950,0,0,77,0,-77
1951,1,0,20,0,-20
1952,1,1,111,1389,1278
1953,0,0,34,0,-34
1954,1,0,6,0,-6
1955,1,0,90,0,-90
1956,0,0,3,0,-3
1957,1,1,163,1392,1229
1958,1,0,130,0,-130
1959,0,0,43,0,-43
1960,1,0,6,0,-6
1961,1,1,757,1685,928
1962,0,0,25,0,-25
1963,0,0,93,0,-93
1964,1,0,39,0,-39
1965,1,0,169,0,-169
1966,1,1,296,1375,1079
1967,1,1,1456,1289,-167
1968,0,0,51,0,-51
1969,1,0,130,0,-130
1970,0,0,4,0,-4
1971,0,0,116,0,-116
1972,1,1,309,1237,928
1973,1,1,260,1314,1054
1974,1,1,339,1561,1222
1975,0,0,43,0,-43
1976,0,0,10,0,-10
1977,1,0,116,0,-116
1978,1,1,78,1201,1123
1979,1,1,304,1207,903
1980,0,0,65,0,-65
1981,1,1,72,1757,1685
1982,1,1,155,1284,1129
1983,1,0,7,0,-7
1984,1,1,143,3656,3513
1985,1,1,412,1327,915
1986,1,0,0,0,0
1987,0,0,95,0,-95
1988,0,0,73,0,-73
1989,1,0,52,0,-52
1990,0,0,34,0,-34
1991,1,0,0,0,0
1992,0,0,31,0,-31
1993,1,1,865,1389,524
1994,1,0,4,0,-4
1995,1,1,634,1481,847
1996,1,0,36,0,-36
1997,1,1,361,1326,965
1998,0,0,12,0,-12
1999,1,0,7,0,-7
2000,1,0,27,0,-27
2001,0,0,1,0,-1
2002,0,0,4,0,-4
2003,1,1,565,1357,792
2004,1,1,173,1344,1171
2005,0,0,4,0,-4
2006,1,1,189,1285,1096
2007,0,0,4,0,-4
2008,1,0,91,0,-91
2009,1,0,0,0,0
2010,0,0,6,0,-6
2011,1,0,22,0,-22
2012,0,0,6,0,-6
2013,1,0,48,0,-48
2014,0,0,55,0,-55
2015,1,0,3,0,-3
2016,1,0,86,0,-86
2017,1,0,76,0,-76
2018,0,0,1,0,-1
2019,1,1,617,1261,644
2020,0,0,0,0,0
2021,1,1,311,1737,1426
2022,1,1,501,1515,1014
2023,0,0,101,0,-101
2024,0,0,100,0,-100
2025,0,0,7,0,-7
2026,1,0,77,0,-77
2027,0,0,25,0,-25
2028,0,0,17,0,-17
2029,1,0,68,0,-68
2030,1,1,2491,1484,-1007
2031,1,1,772,1322,550
2032,1,1,1093,1562,469
2033,1,1,590,1365,775
2034,1,0,35,0,-35
2035,1,0,252,0,-252
2036,1,1,595,1390,795
2037,1,0,32,0,-32
2038,0,0,45,0,-45
2039,0,0,53,0,-53
2040,0,0,33,0,-33
2041,1,1,437,1231,794
2042,0,0,25,0,-25
2043,1,0,31,0,-31
2044,1,1,669,1316,647
2045,1,0,19,0,-19
2046,1,1,2328,1409,-919
2047,0,0,363,0,-363
2048,0,0,9,0,-9
2049,0,0,10,0,-10
2050,0,0,39,0,-39
2051,1,1,779,2018,1239
2052,1,0,49,0,-49
2053,1,1,298,1276,978
2054,1,1,194,1298,1104
2055,1,0,42,0,-42
2056,0,0,47,0,-47
2057,0,0,48,0,-48
2058,1,0,118,0,-118
2059,1,1,118,1297,1179
2060,1,1,540,1688,1148
2061,1,1,391,1393,1002
2062,0,0,109,0,-109
2063,1,1,1122,1533,411
2064,1,0,78,0,-78
2065,0,0,1,0,-1
2066,1,1,779,1466,687
2067,1,0,67,0,-67
2068,1,0,28,0,-28
2069,1,0,5,0,-5
2070,1,1,41,2939,2898
2071,1,1,146,1325,1179
2072,0,0,86,0,-86
2073,1,0,16,0,-16
2074,0,0,38,0,-38
2075,0,0,55,0,-55
2076,1,1,316,1726,1410
2077,0,0,116,0,-116
2078,1,1,830,1208,378
2079,1,0,7,0,-7
2080,0,0,59,0,-59
2081,0,0,41,0,-41
2082,1,1,1358,1266,-92
2083,0,0,1,0,-1
2084,1,0,43,0,-43
2085,1,1,211,1253,1042
2086,0,0,56,0,-56
2087,1,0,22,0,-22
2088,1,1,861,1314,453
2089,1,0,43,0,-43
2090,1,1,644,1299,655
2091,1,1,82,1232,1150
2092,0,0,42,0,-42
2093,0,0,7,0,-7
2094,1,1,321,1269,948
2095,1,1,712,1266,554
2096,1,1,1500,1590,90
2097,1,0,57,0,-57
2098,1,0,3,0,-3
2099,0,0,27,0,-27
2100,0,0,21,0,-21
2101,0,0,7,0,-7
2102,1,1,348,1968,1620
2103,1,0,7,0,-7
2104,1,0,87,0,-87
2105,1,1,615,1424,809
2106,0,0,3,0,-3
2107,0,0,71,0,-71
2108,0,0,15,0,-15
2109,1,1,888,1771,883
2110,1,1,1054,1320,266
2111,0,0,6,0,-6
2112,0,0,60,0,-60
2113,0,0,32,0,-32
2114,0,0,21,0,-21
2115,1,1,178,2134,1956
2116,1,0,12,0,-12
2117,1,1,168,1307,1139
2118,1,0,52,0,-52
2119,1,0,141,0,-141
2120,1,1,364,1240,876
2121,1,0,79,0,-79
2122,1,0,63,0,-63
2123,0,0,49,0,-49
2124,1,0,12,0,-12
2125,0,0,72,0,-72
2126,1,0,40,0,-40
2127,1,0,35,0,-35
2128,1,1,1089,1384,295
2129,0,0,27,0,-27
2130,0,0,4,0,-4
2131,1,0,243,0,-243
2132,1,1,764,1325,561
2133,0,0,231,0,-231
2134,1,0,21,0,-21
2135,0,0,171,0,-171
2136,0,0,9,0,-9
2137,1,1,408,1441,1033
2138,1,1,306,1507,1201
2139,1,1,74,2223,2149
2140,1,1,525,1592,1067
2141,1,0,11,0,-11
2142,0,0,68,0,-68
2143,1,1,1459,1321,-138
2144,0,0,67,0,-67
2145,1,0,35,0,-35
2146,0,0,49,0,-49
2147,0,0,55,0,-55
2148,1,0,67,0,-67
2149,1,1,919,2188,1269
2150,0,0,38,0,-38
2151,1,1,348,1736,1388
2152,1,1,289,2164,1875
2153,1,1,141,1729,1588
2154,1,0,40,0,-40
2155,0,0,26,0,-26
2156,0,0,174,0,-174
2157,0,0,40,0,-40
2158,0,0,26,0,-26
2159,1,1,352,1341,989
2160,1,0,122,0,-122
2161,1,0,102,0,-102
2162,0,0,83,0,-83
2163,1,0,155,0,-155
2164,1,1,352,1259,907
2165,1,1,325,1840,1515
2166,0,0,4,0,-4
2167,1,0,19,0,-19
2168,1,1,120,1278,1158
2169,0,0,14,0,-14
2170,1,1,118,1531,1413
2171,1,1,114,1383,1269
2172,0,0,59,0,-59
2173,1,0,17,0,-17
2174,1,0,11,0,-11
2175,0,0,57,0,-57
2176,1,1,1583,1975,392
2177,1,0,13,0,-13
2178,0,0,18,0,-18
2179,0,0,25,0,-25
2180,1,0,23,0,-23
2181,0,0,49,0,-49
2182,0,0,34,0,-34
2183,1,0,64,0,-64
2184,0,0,3,0,-3
2185,0,0,30,0,-30
2186,0,0,59,0,-59
2187,1,0,1,0,-1
2188,0,0,17,0,-17
2189,0,0,38,0,-38
2190,1,1,108,1457,1349
2191,0,0,205,0,-205
2192,1,0,36,0,-36
2193,1,0,60,0,-60
2194,0,0,48,0,-48
2195,1,0,6,0,-6
2196,1,1,1535,1500,-35
2197,1,0,33,0,-33
2198,0,0,35,0,-35
2199,1,0,37,0,-37
2200,0,0,8,0,-8
2201,1,1,1984,1341,-643
2202,1,0,26,0,-26
2203,0,0,30,0,-30
2204,1,0,16,0,-16
2205,0,0,42,0,-42
2206,1,1,587,1211,624
2207,1,1,586,1465,879
2208,1,1,26,1354,1328
2209,0,0,55,0,-55
2210,1,1,1862,1227,-635
2211,0,0,23,0,-23
2212,1,1,402,1212,810
2213,1,0,69,0,-69
2214,1,0,13,0,-13
2215,0,0,53,0,-53
2216,1,1,227,1255,1028
2217,1,0,50,0,-50
2218,0,0,22,0,-22
2219,0,0,5,0,-5
2220,0,0,39,0,-39
2221,1,1,843,1291,448
2222,1,1,489,1201,712
2223,1,1,1243,1329,86
2224,1,0,63,0,-63
2225,1,0,30,0,-30
2226,0,0,31,0,-31
2227,1,1,168,1492,1324
2228,0,0,20,0,-20
2229,1,1,123,1349,1226
2230,0,0,48,0,-48
2231,1,1,620,2062,1442
2232,1,0,166,0,-166
2233,0,0,33,0,-33
2234,1,1,463,1362,899
2235,1,1,307,1311,1004
2236,1,1,200,1419,1219
2237,0,0,78,0,-78
2238,0,0,5,0,-5
2239,1,1,96,1201,1105
2240,0,0,20,0,-20
2241,1,0,4,0,-4
2242,0,0,3,0,-3
2243,0,0,48,0,-48
2244,1,1,456,1331,875
2245,0,0,65,0,-65
2246,0,0,97,0,-97
2247,0,0,29,0,-29
2248,0,0,36,0,-36
2249,0,0,58,0,-58
2250,1,1,234,1407,1173
2251,1,1,1820,1330,-490
2252,1,0,7,0,-7
2253,0,0,29,0,-29
2254,1,0,15,0,-15
2255,1,0,102,0,-102
2256,1,1,669,1280,611
2257,1,0,59,0,-59
2258,0,0,100,0,-100
2259,0,0,94,0,-94
2260,0,0,5,0,-5
2261,0,0,3,0,-3
2262,0,0,126,0,-126
2263,1,0,4,0,-4
2264,1,0,41,0,-41
2265,1,1,103,1225,1122
2266,1,0,51,0,-51
2267,1,0,109,0,-109
2268,1,1,306,1327,1021
2269,0,0,37,0,-37
2270,0,0,128,0,-128
2271,0,0,45,0,-45
2272,1,0,42,0,-42
2273,0,0,72,0,-72
2274,0,0,48,0,-48
2275,1,1,48,1350,1302
2276,1,1,748,1353,605
2277,0,0,38,0,-38
2278,1,1,1145,1313,168
2279,0,0,267,0,-267
2280,1,1,351,1255,904
2281,0,0,27,0,-27
2282,1,0,18,0,-18
2283,1,0,71,0,-71
2284,1,0,12,0,-12
2285,1,1,187,2253,2066
2286,0,0,7,0,-7
2287,1,0,14,0,-14
2288,1,1,295,1398,1103
2289,1,1,474,1416,942
2290,1,0,15,0,-15
2291,1,0,13,0,-13
2292,1,0,3,0,-3
2293,1,0,91,0,-91
2294,1,1,215,1295,1080
2295,1,0,1,0,-1
2296,1,1,1334,1801,467
2297,0,0,10,0,-10
2298,1,0,14,0,-14
2299,1,0,6,0,-6
2300,0,0,33,0,-33
2301,1,0,7,0,-7
2302,0,0,31,0,-31
2303,1,1,54,1452,1398
2304,1,1,552,1499,947
2305,1,0,51,0,-51
2306,0,0,154,0,-154
2307,1,0,141,0,-141
2308,1,0,4,0,-4
2309,1,0,65,0,-65
2310,0,0,19,0,-19
2311,1,1,516,1640,1124
2312,1,1,1085,1323,238
2313,0,0,128,0,-128
2314,1,1,2401,1552,-849
2315,0,0,92,0,-92
2316,0,0,45,0,-45
2317,1,1,248,1223,975
2318,0,0,3,0,-3
2319,1,0,12,0,-12
2320,1,1,522,1549,1027
2321,1,0,29,0,-29
2322,1,0,13,0,-13
2323,1,1,382,1413,1031
2324,0,0,5,0,-5
2325,0,0,4,0,-4
2326,1,1,559,1337,778
2327,1,1,600,1498,898
2328,0,0,52,0,-52
2329,1,1,387,1395,1008
2330,0,0,24,0,-24
2331,1,1,917,1322,405
2332,0,0,45,0,-45
2333,1,1,218,1390,1172
2334,0,0,73,0,-73
2335,1,0,74,0,-74
2336,1,1,326,1398,1072
2337,1,1,53,1317,1264
2338,1,0,155,0,-155
2339,0,0,42,0,-42
2340,1,1,594,1342,748
2341,1,1,396,1332,936
2342,1,0,0,0,0
2343,1,0,54,0,-54
2344,1,0,27,0,-27
2345,1,1,1543,1717,174
2346,0,0,25,0,-25
2347,1,1,370,1528,1158
2348,1,1,166,1209,1043
2349,1,1,64,1292,1228
2350,0,0,13,0,-13
2351,1,1,649,1256,607
2352,0,0,66,0,-66
2353,1,1,401,1507,1106
2354,1,1,82,1386,1304
2355,0,0,36,0,-36
2356,0,0,100,0,-100
2357,0,0,8,0,-8
2358,0,0,7,0,-7
2359,0,0,2,0,-2
2360,1,1,1174,1226,52
2361,0,0,37,0,-37
2362,1,0,50,0,-50
2363,1,1,130,1444,1314
2364,0,0,126,0,-126
2365,0,0,8,0,-8
2366,1,1,394,1377,983
2367,0,0,161,0,-161
2368,1,0,1,0,-1
2369,1,0,62,0,-62
2370,1,0,171,0,-171
2371,0,0,6,0,-6
2372,1,1,214,1247,1033
2373,1,1,256,1312,1056
2374,1,0,12,0,-12
2375,1,0,152,0,-152
2376,1,0,32,0,-32
2377,1,1,1240,1544,304
2378,0,0,14,0,-14
2379,0,0,10,0,-10
2380,1,0,163,0,-163
2381,1,1,434,1238,804
2382,1,1,1805,1298,-507
2383,0,0,45,0,-45
2384,1,1,775,1306,531
2385,0,0,82,0,-82
2386,0,0,136,0,-136
2387,0,0,61,0,-61
2388,0,0,96,0,-96
2389,1,0,24,0,-24
2390,0,0,106,0,-106
2391,1,0,1,0,-1
2392,0,0,30,0,-30
2393,1,1,507,1427,920
2394,1,0,11,0,-11
2395,0,0,6,0,-6
2396,0,0,125,0,-125
2397,1,0,48,0,-48
2398,1,0,49,0,-49
2399,0,0,12,0,-12
2400,0,0,63,0,-63
2401,1,1,218,1202,984
2402,1,1,71,2329,2258
2403,1,0,25,0,-25
2404,0,0,27,0,-27
2405,0,0,43,0,-43
2406,1,1,327,1470,1143
2407,1,0,7,0,-7
2408,1,1,601,1223,622
2409,0,0,135,0,-135
2410,0,0,27,0,-27
2411,0,0,6,0,-6
2412,0,0,25,0,-25
2413,0,0,100,0,-100
2414,1,1,1832,1402,-430
2415,1,1,238,1540,1302
2416,0,0,14,0,-14
2417,1,0,5,0,-5
2418,0,0,0,0,0
2419,0,0,43,0,-43
2420,0,0,62,0,-62
2421,0,0,29,0,-29
2422,0,0,86,0,-86
2423,1,1,248,1244,996
2424,1,1,1146,1284,138
2425,1,1,681,3948,3267
2426,1,0,55,0,-55
2427,0,0,101,0,-101
2428,1,0,42,0,-42
2429,1,1,1195,2281,1086
2430,1,1,1231,1221,-10
2431,0,0,5,0,-5
2432,1,0,29,0,-29
2433,1,1,618,1297,679
2434,0,0,3,0,-3
2435,1,1,2419,1377,-1042
2436,1,0,8,0,-8
2437,0,0,4,0,-4
2438,0,0,73,0,-73
2439,0,0,11,0,-11
2440,0,0,69,0,-69
2441,0,0,60,0,-60
2442,1,0,188,0,-188
2443,1,1,965,1260,295
2444,1,0,176,0,-176
2445,1,0,58,0,-58
2446,0,0,2,0,-2
2447,0,0,43,0,-43
2448,1,1,259,1262,1003
2449,1,1,492,1410,918
2450,1,0,23,0,-23
2451,1,0,51,0,-51
2452,1,1,320,2997,2677
2453,1,0,10,0,-10
2454,0,0,7,0,-7
2455,0,0,33,0,-33
2456,1,0,15,0,-15
2457,0,0,54,0,-54
2458,0,0,12,0,-12
2459,1,0,27,0,-27
2460,1,1,1185,1862,677
2461,0,0,138,0,-138
2462,0,0,95,0,-95
2463,0,0,98,0,-98
2464,0,0,58,0,-58
2465,0,0,1,0,-1
2466,0,0,156,0,-156
2467,1,0,48,0,-48
2468,0,0,72,0,-72
2469,0,0,9,0,-9
2470,0,0,35,0,-35
2471,1,0,124,0,-124
2472,1,1,1150,1200,50
2473,0,0,13,0,-13
2474,1,1,846,1309,463
2475,1,0,65,0,-65
2476,0,0,14,0,-14
2477,1,0,33,0,-33
2478,0,0,43,0,-43
2479,1,1,120,1343,1223
2480,1,0,222,0,-222
2481,1,1,253,1602,1349
2482,1,0,4,0,-4
2483,1,0,86,0,-86
2484,0,0,42,0,-42
2485,0,0,14,0,-14
2486,0,0,25,0,-25
2487,1,0,9,0,-9
2488,1,0,176,0,-176
2489,0,0,60,0,-60
2490,0,0,87,0,-87
2491,1,1,176,1287,1111
2492,1,0,46,0,-46
2493,1,0,33,0,-33
2494,1,0,14,0,-14
2495,1,0,27,0,-27
2496,0,0,19,0,-19
2497,1,1,1255,1271,16
2498,1,1,351,1902,1551
2499,0,0,4,0,-4
2500,1,1,265,1254,989
2501,1,0,2,0,-2
2502,0,0,70,0,-70
2503,1,1,95,1408,1313
2504,1,0,3,0,-3
2505,1,0,52,0,-52
2506,0,0,61,0,-61
2507,0,0,52,0,-52
2508,1,0,8,0,-8
2509,1,0,28,0,-28
2510,0,0,61,0,-61
2511,0,0,6,0,-6
2512,0,0,1,0,-1
2513,0,0,30,0,-30
2514,0,0,81,0,-81
2515,0,0,34,0,-34
2516,1,0,25,0,-25
2517,1,1,214,6267,6053
2518,1,0,10,0,-10
2519,0,0,120,0,-120
2520,1,0,6,0,-6
2521,1,0,5,0,-5
2522,1,0,4,0,-4
2523,0,0,58,0,-58
2524,1,0,70,0,-70
2525,1,1,969,1311,342
2526,1,1,1525,1750,225
2527,0,0,2,0,-2
2528,1,0,25,0,-25
2529,1,1,348,1552,1204
2530,0,0,20,0,-20
2531,1,0,87,0,-87
2532,0,0,64,0,-64
2533,0,0,56,0,-56
2534,0,0,101,0,-101
2535,1,1,678,1302,624
2536,1,0,78,0,-78
2537,1,1,63,1915,1852
2538,0,0,48,0,-48
2539,0,0,126,0,-126
2540,0,0,0,0,0
2541,0,0,64,0,-64
2542,1,1,15,1247,1232
2543,1,1,329,1626,1297
2544,1,1,230,1703,1473
2545,0,0,30,0,-30
2546,1,0,34,0,-34
2547,0,0,2,0,-2
2548,0,0,5,0,-5
2549,0,0,62,0,-62
2550,0,0,157,0,-157
2551,1,0,6,0,-6
2552,1,1,228,1609,1381
2553,0,0,3,0,-3
2554,0,0,5,0,-5
2555,1,1,273,1262,989
2556,0,0,0,0,0
2557,1,1,851,1200,349
2558,1,1,345,1669,1324
2559,1,1,557,1551,994
2560,1,0,32,0,-32
2561,0,0,29,0,-29
2562,0,0,1,0,-1
2563,1,1,672,1547,875
2564,0,0,36,0,-36
2565,0,0,21,0,-21
2566,1,1,30,1248,1218
2567,0,0,7,0,-7
2568,0,0,13,0,-13
2569,1,0,65,0,-65
2570,1,0,42,0,-42
2571,1,1,299,1883,1584
2572,0,0,44,0,-44
2573,1,1,324,1205,881
2574,0,0,4,0,-4
2575,1,0,37,0,-37
2576,0,0,97,0,-97
2577,0,0,11,0,-11
2578,0,0,258,0,-258
2579,1,0,57,0,-57
2580,1,1,433,1261,828
2581,0,0,15,0,-15
2582,1,0,46,0,-46
2583,1,1,1437,1242,-195
2584,0,0,39,0,-39
2585,1,1,356,2104,1748
2586,0,0,84,0,-84
2587,1,1,400,1220,820
2588,0,0,3,0,-3
2589,1,1,75,2251,2176
2590,0,0,13,0,-13
2591,1,1,1154,1252,98
2592,1,0,12,0,-12
2593,0,0,25,0,-25
2594,1,1,624,1236,612
2595,0,0,121,0,-121
2596,0,0,5,0,-5
2597,1,1,148,1607,1459
2598,0,0,35,0,-35
2599,0,0,29,0,-29
2600,1,0,107,0,-107
2601,1,1,458,1493,1035
2602,1,1,270,1591,1321
2603,1,1,480,1300,820
2604,1,1,1264,1979,715
2605,1,1,337,2265,1928
2606,1,0,12,0,-12
2607,0,0,9,0,-9
2608,1,0,39,0,-39
2609,1,0,35,0,-35
2610,1,1,1273,2085,812
2611,1,0,10,0,-10
2612,1,1,431,1225,794
2613,1,1,120,1402,1282
2614,1,0,23,0,-23
2615,1,0,97,0,-97
2616,0,0,34,0,-34
2617,0,0,18,0,-18
2618,1,1,1079,1519,440
2619,1,0,4,0,-4
2620,1,1,79,2374,2295
2621,0,0,72,0,-72
2622,1,0,14,0,-14
2623,1,1,188,1236,1048
2624,1,0,241,0,-241
2625,1,1,213,1969,1756
2626,1,1,981,1538,557
2627,1,0,20,0,-20
2628,1,1,1281,1454,173
2629,1,1,59,1381,1322
2630,1,0,144,0,-144
2631,0,0,91,0,-91
2632,0,0,7,0,-7
2633,0,0,21,0,-21
2634,0,0,41,0,-41
2635,1,0,13,0,-13
2636,0,0,62,0,-62
2637,1,0,15,0,-15
2638,1,1,607,1769,1162
2639,1,1,575,1696,1121
2640,1,0,1,0,-1
2641,0,0,42,0,-42
2642,1,0,96,0,-96
2643,1,0,9,0,-9
2644,1,0,30,0,-30
2645,0,0,50,0,-50
2646,0,0,9,0,-9
2647,0,0,40,0,-40
2648,1,1,76,1225,1149
2649,1,0,63,0,-63
2650,0,0,17,0,-17
2651,1,0,17,0,-17
2652,1,1,1709,1268,-441
2653,0,0,83,0,-83
2654,1,0,42,0,-42
2655,1,0,110,0,-110
2656,1,0,16,0,-16
2657,0,0,4,0,-4
2658,1,0,9,0,-9
2659,1,1,135,1282,1147
2660,1,1,1793,2855,1062
2661,0,0,7,0,-7
2662,1,1,317,1200,883
2663,0,0,12,0,-12
2664,1,1,211,1259,1048
2665,0,0,0,0,0
2666,0,0,55,0,-55
2667,0,0,46,0,-46
2668,1,1,418,1299,881
2669,1,0,83,0,-83
2670,0,0,34,0,-34
2671,1,0,30,0,-30
2672,0,0,34,0,-34
2673,0,0,44,0,-44
2674,1,0,126,0,-126
2675,0,0,81,0,-81
2676,0,0,96,0,-96
2677,1,0,68,0,-68
2678,1,0,6,0,-6
2679,1,1,1962,5687,3725
2680,1,0,56,0,-56
2681,0,0,131,0,-131
2682,1,0,50,0,-50
2683,0,0,82,0,-82
2684,1,0,15,0,-15
2685,0,0,104,0,-104
2686,0,0,76,0,-76
2687,0,0,5,0,-5
2688,0,0,118,0,-118
2689,0,0,8,0,-8
2690,1,0,28,0,-28
2691,0,0,87,0,-87
2692,1,1,991,1204,213
2693,0,0,0,0,0
2694,0,0,48,0,-48
2695,1,0,16,0,-16
2696,0,0,184,0,-184
2697,0,0,112,0,-112
2698,1,0,13,0,-13
2699,1,0,51,0,-51
2700,0,0,21,0,-21
2701,0,0,164,0,-164
2702,0,0,11,0,-11
2703,0,0,10,0,-10
2704,0,0,54,0,-54
2705,1,0,3,0,-3
2706,1,0,18,0,-18
2707,0,0,42,0,-42
2708,1,0,36,0,-36
2709,1,1,157,1306,1149
2710,0,0,12,0,-12
2711,1,0,49,0,-49
2712,1,1,1094,1754,660
2713,0,0,59,0,-59
2714,1,1,309,1304,995
2715,1,0,105,0,-105
2716,1,0,16,0,-16
2717,1,0,78,0,-78
2718,1,0,40,0,-40
2719,1,0,27,0,-27
2720,1,0,24,0,-24
2721,1,0,141,0,-141
2722,1,0,8,0,-8
2723,0,0,48,0,-48
2724,0,0,31,0,-31
2725,1,0,39,0,-39
2726,1,0,187,0,-187
2727,1,0,51,0,-51
2728,0,0,36,0,-36
2729,0,0,53,0,-53
2730,1,1,642,2398,1756
2731,1,1,122,1781,1659
2732,0,0,4,0,-4
2733,1,0,1,0,-1
2734,1,1,872,1202,330
2735,1,1,473,1327,854
2736,1,1,637,1256,619
2737,1,0,147,0,-147
2738,0,0,12,0,-12
2739,1,0,8,0,-8
2740,0,0,60,0,-60
2741,1,0,11,0,-11
2742,0,0,23,0,-23
2743,1,0,2,0,-2
2744,1,0,38,0,-38
2745,0,0,20,0,-20
2746,0,0,130,0,-130
2747,0,0,41,0,-41
2748,1,1,211,1551,1340
2749,1,1,1072,1212,140
2750,1,1,891,1222,331
2751,1,1,86,1432,1346
2752,1,1,976,2057,1081
2753,0,0,55,0,-55
2754,1,0,8,0,-8
2755,1,1,670,1214,544
2756,1,0,29,0,-29
2757,0,0,4,0,-4
2758,1,0,12,0,-12
2759,1,0,111,0,-111
2760,0,0,22,0,-22
2761,1,1,376,1215,839
2762,1,0,99,0,-99
2763,1,1,731,1405,674
2764,0,0,20,0,-20
2765,1,0,27,0,-27
2766,0,0,23,0,-23
2767,1,1,438,1632,1194
2768,1,0,71,0,-71
2769,1,1,1325,1358,33
2770,1,1,282,1653,1371
2771,0,0,1,0,-1
2772,0,0,21,0,-21
2773,0,0,39,0,-39
2774,0,0,13,0,-13
2775,1,1,195,1395,1200
2776,0,0,3,0,-3
2777,1,1,1100,2664,1564
2778,1,0,117,0,-117
2779,1,0,22,0,-22
2780,1,1,1299,1962,663
2781,0,0,13,0,-13
2782,1,1,918,1216,298
2783,0,0,46,0,-46
2784,0,0,74,0,-74
2785,1,1,106,1566,1460
2786,1,1,380,1212,832
2787,0,0,15,0,-15
2788,1,0,25,0,-25
2789,0,0,10,0,-10
2790,1,1,204,6771,6567
2791,1,1,827,1206,379
2792,0,0,51,0,-51
2793,0,0,34,0,-34
2794,1,1,271,1355,1084
2795,1,0,63,0,-63
2796,1,0,26,0,-26
2797,1,1,790,1239,449
2798,0,0,13,0,-13
2799,1,1,116,1452,1336
2800,0,0,22,0,-22
2801,1,0,14,0,-14
2802,0,0,30,0,-30
2803,1,1,398,2013,1615
2804,0,0,4,0,-4
2805,0,0,62,0,-62
2806,1,1,2242,1389,-853
2807,0,0,44,0,-44
2808,0,0,0,0,0
2809,1,0,15,0,-15
2810,1,1,459,1284,825
2811,1,1,513,1409,896
2812,0,0,21,0,-21
2813,0,0,337,0,-337
2814,0,0,0,0,0
2815,0,0,31,0,-31
2816,1,1,734,1234,500
2817,1,1,273,1573,1300
2818,1,1,211,1447,1236
2819,1,0,13,0,-13
2820,1,0,19,0,-19
2821,1,0,28,0,-28
2822,0,0,74,0,-74
2823,1,0,27,0,-27
2824,1,0,75,0,-75
2825,1,0,2,0,-2
2826,1,1,492,1527,1035
2827,1,1,828,1608,780
2828,1,0,15,0,-15
2829,1,1,94,1776,1682
2830,1,0,28,0,-28
2831,1,1,163,1285,1122
2832,1,1,3455,1283,-2172
2833,0,0,1,0,-1
2834,1,0,110,0,-110
2835,0,0,60,0,-60
2836,1,0,108,0,-108
2837,1,1,279,1377,1098
2838,1,0,93,0,-93
2839,1,0,18,0,-18
2840,1,1,1468,1684,216
2841,1,1,43,1250,1207
2842,1,0,45,0,-45
2843,1,0,26,0,-26
2844,0,0,45,0,-45
2845,1,0,45,0,-45
2846,0,0,54,0,-54
2847,1,1,817,1987,1170
2848,1,1,103,1232,1129
2849,1,1,355,1582,1227
2850,0,0,55,0,-55
2851,0,0,129,0,-129
2852,1,0,11,0,-11
2853,1,1,83,1882,1799
2854,0,0,236,0,-236
2855,0,0,48,0,-48
2856,0,0,1,0,-1
2857,1,1,943,1325,382
2858,1,0,24,0,-24
2859,1,0,145,0,-145
2860,1,0,19,0,-19
2861,1,1,767,1216,449
2862,1,1,173,1241,1068
2863,1,0,118,0,-118
2864,1,1,1214,1216,2
2865,1,0,69,0,-69
2866,1,1,1248,2181,933
2867,1,1,319,1386,1067
2868,1,1,1089,1438,349
2869,1,1,293,1312,1019
2870,0,0,10,0,-10
2871,0,0,124,0,-124
2872,1,0,82,0,-82
2873,1,0,91,0,-91
2874,1,1,208,2559,2351
2875,1,0,31,0,-31
2876,0,0,31,0,-31
2877,1,0,96,0,-96
2878,0,0,0,0,0
2879,0,0,96,0,-96
2880,0,0,78,0,-78
2881,0,0,113,0,-113
2882,0,0,7,0,-7
2883,0,0,82,0,-82
2884,0,0,46,0,-46
2885,1,0,82,0,-82
2886,1,1,40,1597,1557
2887,1,1,518,1580,1062
2888,1,0,37,0,-37
2889,0,0,9,0,-9
2890,0,0,21,0,-21
2891,1,0,59,0,-59
2892,1,0,83,0,-83
2893,1,0,151,0,-151
2894,0,0,60,0,-60
2895,1,1,308,1266,958
2896,0,0,57,0,-57
2897,0,0,41,0,-41
2898,1,0,6,0,-6
2899,1,1,1599,1510,-89
2900,1,1,401,1370,969
2901,1,0,26,0,-26
2902,0,0,55,0,-55
2903,1,0,14,0,-14
2904,1,1,242,1309,1067
2905,0,0,194,0,-194
2906,1,0,11,0,-11
2907,1,0,117,0,-117
2908,0,0,74,0,-74
2909,1,1,1234,1502,268
2910,0,0,49,0,-49
2911,0,0,38,0,-38
2912,0,0,5,0,-5
2913,1,0,38,0,-38
2914,1,1,54,1521,1467
2915,0,0,55,0,-55
2916,0,0,100,0,-100
2917,1,1,1068,3103,2035
2918,1,1,193,1288,1095
2919,1,1,338,1575,1237
2920,1,1,395,1531,1136
2921,1,0,2,0,-2
2922,1,0,58,0,-58
2923,1,0,5,0,-5
2924,1,1,1665,1207,-458
2925,0,0,163,0,-163
2926,0,0,73,0,-73
2927,1,1,115,1460,1345
2928,0,0,0,0,0
2929,0,0,14,0,-14
2930,0,0,0,0,0
2931,0,0,36,0,-36
2932,0,0,82,0,-82
2933,1,0,54,0,-54
2934,0,0,16,0,-16
2935,1,0,43,0,-43
2936,1,1,163,1423,1260
2937,1,0,15,0,-15
2938,1,0,86,0,-86
2939,0,0,53,0,-53
2940,1,1,85,1229,1144
2941,0,0,7,0,-7
2942,1,0,118,0,-118
2943,0,0,146,0,-146
2944,0,0,4,0,-4
2945,1,0,179,0,-179
2946,1,1,243,1416,1173
2947,0,0,8,0,-8
2948,1,0,0,0,0
2949,0,0,56,0,-56
2950,1,1,3313,1313,-2000
2951,1,0,32,0,-32
2952,1,1,265,1293,1028
2953,1,0,29,0,-29
2954,0,0,34,0,-34
2955,0,0,33,0,-33
2956,1,1,332,1243,911
2957,1,0,104,0,-104
2958,0,0,6,0,-6
2959,1,1,58,1546,1488
2960,1,0,113,0,-113
2961,1,1,276,1472,1196
2962,1,1,262,2053,1791
2963,0,0,233,0,-233
2964,0,0,19,0,-19
2965,0,0,4,0,-4
2966,1,1,494,2350,1856
2967,1,0,38,0,-38
2968,0,0,11,0,-11
2969,0,0,49,0,-49
2970,0,0,12,0,-12
2971,1,1,949,1250,301
2972,1,1,991,1269,278
2973,1,0,7,0,-7
2974,1,0,20,0,-20
2975,0,0,24,0,-24
2976,0,0,0,0,0
2977,1,0,25,0,-25
2978,1,1,792,1706,914
2979,0,0,23,0,-23
2980,0,0,134,0,-134
2981,0,0,23,0,-23
2982,1,0,47,0,-47
2983,1,1,1014,1366,352
2984,1,1,734,2067,1333
2985,1,1,797,2373,1576
2986,1,0,24,0,-24
2987,1,0,30,0,-30
2988,1,0,128,0,-128
2989,1,0,75,0,-75
2990,1,1,284,1546,1262
2991,0,0,71,0,-71
2992,1,0,0,0,0
2993,0,0,33,0,-33
2994,1,0,12,0,-12
2995,1,1,962,2866,1904
2996,0,0,152,0,-152
2997,0,0,16,0,-16
2998,1,1,313,1639,1326
2999,0,0,31,0,-31
3000,1,0,74,0,-74
3001,1,1,632,1676,1044
3002,0,0,8,0,-8
3003,1,0,78,0,-78
3004,0,0,0,0,0
3005,0,0,67,0,-67
3006,1,0,7,0,-7
3007,0,0,60,0,-60
3008,1,1,93,1288,1195
3009,1,1,797,1578,781
3010,1,1,1166,1457,291
3011,0,0,25,0,-25
3012,1,0,38,0,-38
3013,1,1,140,1644,1504
3014,1,1,95,1249,1154
3015,1,0,3,0,-3
3016,0,0,85,0,-85
3017,0,0,18,0,-18
3018,1,1,72,1507,1435
3019,1,1,135,1833,1698
3020,0,0,153,0,-153
3021,0,0,117,0,-117
3022,1,0,20,0,-20
3023,0,0,9,0,-9
3024,1,1,216,2349,2133
3025,0,0,67,0,-67
3026,1,1,294,1514,1220
3027,1,0,157,0,-157
3028,1,1,175,1396,1221
3029,0,0,80,0,-80
3030,0,0,5,0,-5
3031,1,0,16,0,-16
3032,1,1,797,3547,2750
3033,1,1,705,1483,778
3034,0,0,0,0,0
3035,0,0,23,0,-23
3036,1,1,2750,2752,2
3037,0,0,5,0,-5
3038,1,0,13,0,-13
3039,1,0,24,0,-24
3040,1,1,758,1638,880
3041,0,0,5,0,-5
3042,1,0,11,0,-11
3043,1,1,353,2157,1804
3044,1,1,830,1256,426
3045,0,0,17,0,-17
3046,1,1,518,1246,728
3047,1,1,1410,1374,-36
3048,1,0,185,0,-185
3049,1,0,6,0,-6
3050,1,0,51,0,-51
3051,1,0,0,0,0
3052,1,1,257,1234,977
3053,1,1,314,1303,989
3054,1,0,21,0,-21
3055,1,0,0,0,0
3056,0,0,10,0,-10
3057,1,1,314,2016,1702
3058,1,0,42,0,-42
3059,1,0,0,0,0
3060,0,0,308,0,-308
3061,1,1,128,1962,1834
3062,0,0,43,0,-43
3063,0,0,14,0,-14
3064,1,1,238,1240,1002
3065,0,0,8,0,-8
3066,1,1,91,1801,1710
3067,1,1,260,1247,987
3068,1,0,63,0,-63
3069,0,0,75,0,-75
3070,0,0,10,0,-10
3071,1,1,584,1240,656
3072,0,0,141,0,-141
3073,0,0,48,0,-48
3074,0,0,29,0,-29
3075,0,0,32,0,-32
3076,0,0,20,0,-20
3077,1,0,74,0,-74
3078,0,0,3,0,-3
3079,1,0,91,0,-91
3080,1,1,242,1210,968
3081,0,0,8,0,-8
3082,1,1,533,1347,814
3083,1,0,2,0,-2
3084,0,0,49,0,-49
3085,1,0,7,0,-7
3086,1,0,261,0,-261
3087,0,0,21,0,-21
3088,1,0,2,0,-2
3089,1,0,75,0,-75
3090,0,0,15,0,-15
3091,0,0,83,0,-83
3092,0,0,0,0,0
3093,0,0,48,0,-48
3094,1,1,703,1645,942
3095,0,0,93,0,-93
3096,1,0,6,0,-6
3097,1,1,1075,1742,667
3098,1,1,1160,1539,379
3099,0,0,97,0,-97
3100,1,1,273,1557,1284
3101,1,0,32,0,-32
3102,1,1,698,1408,710
3103,0,0,20,0,-20
3104,0,0,30,0,-30
3105,1,1,1189,1702,513
3106,0,0,0,0,0
3107,1,1,757,1205,448
3108,1,0,26,0,-26
3109,0,0,8,0,-8
3110,0,0,9,0,-9
3111,1,0,103,0,-103
3112,0,0,5,0,-5
3113,1,0,48,0,-48
3114,0,0,4,0,-4
3115,0,0,50,0,-50
3116,1,0,10,0,-10
3117,1,1,1013,1207,194
3118,1,1,31,1944,1913
3119,0,0,166,0,-166
3120,0,0,13,0,-13
3121,0,0,65,0,-65
3122,1,0,99,0,-99
3123,0,0,57,0,-57
3124,0,0,1,0,-1
3125,1,0,76,0,-76
3126,1,1,492,1311,819
3127,1,1,1554,2043,489
3128,1,0,44,0,-44
3129,1,1,419,1302,883
3130,0,0,38,0,-38
3131,1,1,214,1351,1137
3132,0,0,10,0,-10
3133,1,1,206,4311,4105
3134,0,0,52,0,-52
3135,1,0,48,0,-48
3136,0,0,4,0,-4
3137,1,0,46,0,-46
3138,0,0,150,0,-150
3139,1,1,172,1316,1144
3140,1,1,262,3168,2906
3141,1,0,12,0,-12
3142,1,1,1190,1907,717
3143,0,0,13,0,-13
3144,1,1,287,1654,1367
3145,0,0,11,0,-11
3146,1,1,82,1403,1321
3147,1,0,86,0,-86
3148,1,0,24,0,-24
3149,0,0,21,0,-21
3150,1,0,64,0,-64
3151,0,0,27,0,-27
3152,1,1,245,1284,1039
3153,1,1,188,1224,1036
3154,1,0,114,0,-114
3155,0,0,204,0,-204
3156,1,0,10,0,-10
3157,0,0,17,0,-17
3158,1,1,748,2441,1693
3159,0,0,77,0,-77
3160,0,0,44,0,-44
3161,0,0,33,0,-33
3162,0,0,11,0,-11
3163,1,1,166,1465,1299
3164,1,0,140,0,-140
3165,1,0,235,0,-235
3166,1,0,89,0,-89
3167,1,1,424,1264,840
3168,1,1,545,1457,912
3169,1,0,53,0,-53
3170,1,1,126,1403,1277
3171,1,1,73,1935,1862
3172,0,0,41,0,-41
3173,0,0,90,0,-90
3174,0,0,60,0,-60
3175,0,0,3,0,-3
3176,1,1,157,1420,1263
3177,1,0,60,0,-60
3178,1,0,11,0,-11
3179,1,0,140,0,-140
3180,0,0,81,0,-81
3181,1,1,836,1475,639
3182,1,1,186,1666,1480
3183,1,0,147,0,-147
3184,0,0,31,0,-31
3185,1,1,38,1268,1230
3186,1,1,701,1258,557
3187,1,1,65,1804,1739
3188,0,0,10,0,-10
3189,0,0,196,0,-196
3190,1,1,188,1415,1227
3191,0,0,1,0,-1
3192,1,0,13,0,-13
3193,0,0,69,0,-69
3194,0,0,30,0,-30
3195,1,0,52,0,-52
3196,1,0,14,0,-14
3197,1,1,978,1207,229
3198,0,0,14,0,-14
3199,1,0,62,0,-62
3200,0,0,13,0,-13
3201,1,0,8,0,-8
3202,1,1,140,1426,1286
3203,1,0,11,0,-11
3204,1,1,283,1353,1070
3205,0,0,153,0,-153
3206,1,1,364,1244,880
3207,1,1,189,1367,1178
3208,1,1,405,1661,1256
3209,0,0,89,0,-89
3210,0,0,46,0,-46
3211,0,0,31,0,-31
3212,1,0,19,0,-19
3213,0,0,134,0,-134
3214,1,1,231,2335,2104
3215,1,1,150,1510,1360
3216,1,0,15,0,-15
3217,1,0,149,0,-149
3218,1,1,483,1563,1080
3219,0,0,77,0,-77
3220,1,0,1,0,-1
3221,1,1,319,2452,2133
3222,0,0,28,0,-28
3223,1,1,1557,3239,1682
3224,0,0,31,0,-31
3225,1,0,13,0,-13
3226,1,0,77,0,-77
3227,0,0,59,0,-59
3228,1,0,11,0,-11
3229,0,0,121,0,-121
3230,0,0,88,0,-88
3231,0,0,32,0,-32
3232,1,1,170,1417,1247
3233,0,0,21,0,-21
3234,0,0,59,0,-59
3235,0,0,11,0,-11
3236,1,0,15,0,-15
3237,0,0,77,0,-77
3238,0,0,39,0,-39
3239,0,0,29,0,-29
3240,0,0,4,0,-4
3241,1,1,1034,1295,261
3242,1,0,84,0,-84
3243,1,0,125,0,-125
3244,1,1,205,1487,1282
3245,1,0,10,0,-10
3246,0,0,20,0,-20
3247,1,1,222,1233,1011
3248,1,0,22,0,-22
3249,0,0,67,0,-67
3250,0,0,43,0,-43
3251,1,1,397,1354,957
3252,1,1,125,1564,1439
3253,1,1,209,1445,1236
3254,1,0,69,0,-69
3255,1,0,24,0,-24
3256,0,0,19,0,-19
3257,0,0,19,0,-19
3258,1,1,151,1377,1226
3259,0,0,3,0,-3
3260,1,0,18,0,-18
3261,0,0,10,0,-10
3262,1,1,408,1663,1255
3263,1,1,66,2065,1999
3264,1,1,405,2328,1923
3265,1,0,13,0,-13
3266,1,0,44,0,-44
3267,1,0,2,0,-2
3268,1,1,286,1545,1259
3269,0,0,39,0,-39
3270,0,0,12,0,-12
3271,1,1,553,1219,666
3272,1,1,294,1321,1027
3273,1,0,22,0,-22
3274,0,0,92,0,-92
3275,0,0,11,0,-11
3276,1,1,123,1388,1265
3277,0,0,39,0,-39
3278,1,0,5,0,-5
3279,1,1,288,3042,2754
3280,1,0,60,0,-60
3281,0,0,92,0,-92
3282,1,1,394,1233,839
3283,1,1,265,1332,1067
3284,1,0,96,0,-96
3285,0,0,202,0,-202
3286,0,0,49,0,-49
3287,0,0,116,0,-116
3288,1,0,20,0,-20
3289,0,0,4,0,-4
3290,0,0,0,0,0
3291,0,0,94,0,-94
3292,0,0,49,0,-49
3293,0,0,9,0,-9
3294,1,1,259,1622,1363
3295,1,1,888,2079,1191
3296,1,1,967,1319,352
3297,1,1,561,1216,655
3298,1,0,65,0,-65
3299,1,1,261,1364,1103
3300,0,0,19,0,-19
3301,1,0,86,0,-86
3302,1,1,55,1264,1209
3303,1,0,10,0,-10
3304,1,1,316,3003,2687
3305,1,0,5,0,-5
3306,1,1,354,1304,950
3307,1,1,407,1217,810
3308,1,1,251,1708,1457
3309,1,0,9,0,-9
3310,1,0,149,0,-149
3311,0,0,6,0,-6
3312,1,0,3,0,-3
3313,0,0,26,0,-26
3314,1,1,1498,1462,-36
3315,1,0,72,0,-72
3316,0,0,14,0,-14
3317,1,1,706,2215,1509
3318,0,0,95,0,-95
3319,0,0,51,0,-51
3320,0,0,38,0,-38
3321,0,0,16,0,-16
3322,0,0,91,0,-91
3323,0,0,98,0,-98
3324,0,0,23,0,-23
3325,1,0,15,0,-15
3326,0,0,42,0,-42
3327,1,0,40,0,-40
3328,1,0,29,0,-29
3329,1,1,96,1228,1132
3330,1,0,17,0,-17
3331,1,1,1202,2131,929
3332,1,1,241,1362,1121
3333,1,1,265,1218,953
3334,0,0,70,0,-70
3335,1,0,45,0,-45
3336,1,0,62,0,-62
3337,0,0,43,0,-43
3338,1,0,28,0,-28
3339,0,0,69,0,-69
3340,0,0,77,0,-77
3341,1,0,20,0,-20
3342,0,0,17,0,-17
3343,1,0,23,0,-23
3344,1,0,79,0,-79
3345,1,1,1355,1492,137
3346,0,0,158,0,-158
3347,1,1,67,1253,1186
3348,0,0,44,0,-44
3349,1,1,150,1270,1120
3350,1,0,4,0,-4
3351,1,0,5,0,-5
3352,1,1,2264,1398,-866
3353,0,0,100,0,-100
3354,0,0,5,0,-5
3355,1,0,67,0,-67
3356,1,0,2,0,-2
3357,0,0,18,0,-18
3358,1,0,110,0,-110
3359,1,0,10,0,-10
3360,1,1,435,1676,1241
3361,1,0,140,0,-140
3362,1,1,176,1314,1138
3363,1,1,532,1215,683
3364,1,1,26,2200,2174
3365,1,1,459,1429,970
3366,1,1,424,1236,812
3367,1,0,39,0,-39
3368,1,0,38,0,-38
3369,1,1,322,1282,960
3370,1,0,144,0,-144
3371,0,0,19,0,-19
3372,1,1,136,1292,1156
3373,1,1,642,1544,902
3374,1,1,932,1445,513
3375,0,0,92,0,-92
3376,1,1,205,1234,1029
3377,0,0,12,0,-12
3378,1,0,24,0,-24
3379,0,0,39,0,-39
3380,0,0,19,0,-19
3381,0,0,58,0,-58
3382,1,1,2124,1309,-815
3383,1,0,19,0,-19
3384,1,1,208,1233,1025
3385,1,1,351,1373,1022
3386,1,0,0,0,0
3387,0,0,7,0,-7
3388,1,0,31,0,-31
3389,0,0,43,0,-43
3390,1,1,365,1491,1126
3391,1,0,60,0,-60
3392,0,0,20,0,-20
3393,1,0,8,0,-8
3394,1,0,178,0,-178
3395,0,0,45,0,-45
3396,0,0,48,0,-48
3397,1,1,384,1283,899
3398,1,1,184,1215,1031
3399,1,1,126,1352,1226
3400,0,0,67,0,-67
3401,0,0,1,0,-1
3402,0,0,11,0,-11
3403,0,0,49,0,-49
3404,1,1,440,1637,1197
3405,1,1,1172,1320,148
3406,1,0,65,0,-65
3407,0,0,47,0,-47
3408,0,0,51,0,-51
3409,0,0,68,0,-68
3410,0,0,6,0,-6
3411,1,1,1029,2067,1038
3412,1,0,87,0,-87
3413,1,0,27,0,-27
3414,0,0,47,0,-47
3415,0,0,86,0,-86
3416,1,0,100,0,-100
3417,0,0,42,0,-42
3418,0,0,4,0,-4
3419,1,0,43,0,-43
3420,1,1,362,1387,1025
3421,0,0,47,0,-47
3422,1,0,10,0,-10
3423,1,1,1038,2041,1003
3424,0,0,57,0,-57
3425,0,0,35,0,-35
3426,1,1,400,1821,1421
3427,1,1,193,1248,1055
3428,1,0,28,0,-28
3429,0,0,62,0,-62
3430,0,0,31,0,-31
3431,0,0,82,0,-82
3432,0,0,24,0,-24
3433,1,1,453,1200,747
3434,1,1,543,1233,690
3435,0,0,120,0,-120
3436,0,0,53,0,-53
3437,1,0,26,0,-26
3438,1,1,1353,1843,490
3439,0,0,0,0,0
3440,1,0,11,0,-11
3441,0,0,17,0,-17
3442,1,1,1368,1261,-107
3443,0,0,190,0,-190
3444,0,0,20,0,-20
3445,0,0,82,0,-82
3446,1,1,368,1273,905
3447,1,1,1176,1287,111
3448,1,0,10,0,-10
3449,1,0,64,0,-64
3450,0,0,73,0,-73
3451,1,1,877,1519,642
3452,1,1,1170,1202,32
3453,1,1,197,1349,1152
3454,0,0,22,0,-22
3455,1,1,117,1276,1159
3456,1,1,412,1902,1490
3457,1,1,316,1898,1582
3458,0,0,53,0,-53
3459,1,1,1156,1246,90
3460,1,1,363,2002,1639
3461,0,0,28,0,-28
3462,0,0,33,0,-33
3463,1,1,593,1725,1132
3464,1,0,12,0,-12
3465,0,0,4,0,-4
3466,0,0,0,0,0
3467,1,1,344,1304,960
3468,1,0,27,0,-27
3469,1,1,1111,1273,162
3470,1,0,13,0,-13
3471,0,0,42,0,-42
3472,0,0,35,0,-35
3473,1,0,14,0,-14
3474,0,0,36,0,-36
3475,0,0,84,0,-84
3476,0,0,13,0,-13
3477,1,0,11,0,-11
3478,1,0,11,0,-11
3479,0,0,49,0,-49
3480,1,1,407,2953,2546
3481,1,1,310,1515,1205
3482,0,0,80,0,-80
3483,1,1,1676,1318,-358
3484,1,1,1073,4863,3790
3485,1,0,1,0,-1
3486,0,0,35,0,-35
3487,1,0,83,0,-83
3488,0,0,31,0,-31
3489,1,0,14,0,-14
3490,1,0,4,0,-4
3491,1,0,28,0,-28
3492,0,0,235,0,-235
3493,0,0,38,0,-38
3494,0,0,48,0,-48
3495,1,0,6,0,-6
3496,0,0,57,0,-57
3497,0,0,82,0,-82
3498,0,0,36,0,-36
3499,1,0,206,0,-206
3500,1,1,869,1309,440
3501,1,1,145,1259,1114
3502,0,0,34,0,-34
3503,1,0,8,0,-8
3504,1,1,42,1332,1290
3505,1,0,93,0,-93
3506,0,0,29,0,-29
3507,1,0,4,0,-4
3508,0,0,23,0,-23
3509,1,1,890,4251,3361
3510,1,0,4,0,-4
3511,0,0,7,0,-7
3512,0,0,4,0,-4
3513,1,1,461,3541,3080
3514,0,0,11,0,-11
3515,0,0,138,0,-138
3516,0,0,53,0,-53
3517,1,0,38,0,-38
3518,1,1,1316,1541,225
3519,1,1,86,1406,1320
3520,0,0,137,0,-137
3521,1,1,72,1264,1192
3522,1,0,94,0,-94
3523,1,1,431,1999,1568
3524,0,0,17,0,-17
3525,0,0,76,0,-76
3526,1,0,32,0,-32
3527,1,1,1015,1419,404
3528,0,0,42,0,-42
3529,0,0,12,0,-12
3530,0,0,78,0,-78
3531,1,0,110,0,-110
3532,0,0,1,0,-1
3533,1,1,99,1332,1233
3534,1,1,2418,1291,-1127
3535,1,0,4,0,-4
3536,1,1,498,1321,823
3537,1,1,514,1251,737
3538,1,0,25,0,-25
3539,1,1,230,1535,1305
3540,0,0,9,0,-9
3541,1,0,94,0,-94
3542,1,0,3,0,-3
3543,1,0,61,0,-61
3544,0,0,68,0,-68
3545,0,0,4,0,-4
3546,1,0,10,0,-10
3547,0,0,60,0,-60
3548,0,0,28,0,-28
3549,1,1,899,1206,307
3550,1,1,648,1237,589
3551,0,0,74,0,-74
3552,0,0,71,0,-71
3553,0,0,50,0,-50
3554,1,0,43,0,-43
3555,1,1,1436,1655,219
3556,1,0,38,0,-38
3557,0,0,38,0,-38
3558,1,1,75,1241,1166
3559,1,0,9,0,-9
3560,1,0,118,0,-118
3561,1,1,440,1362,922
3562,0,0,78,0,-78
3563,0,0,46,0,-46
3564,1,0,34,0,-34
3565,1,1,91,1590,1499
3566,0,0,34,0,-34
3567,1,0,42,0,-42
3568,1,0,114,0,-114
3569,0,0,4,0,-4
3570,1,1,145,1379,1234
3571,0,0,20,0,-20
3572,1,1,386,1263,877
3573,1,0,41,0,-41
3574,1,0,8,0,-8
3575,0,0,14,0,-14
3576,0,0,88,0,-88
3577,0,0,135,0,-135
3578,0,0,55,0,-55
3579,1,0,14,0,-14
3580,1,1,122,1569,1447
3581,0,0,112,0,-112
3582,1,1,339,1315,976
3583,0,0,26,0,-26
3584,0,0,41,0,-41
3585,0,0,44,0,-44
3586,0,0,81,0,-81
3587,0,0,4,0,-4
3588,0,0,0,0,0
3589,1,0,79,0,-79
3590,1,1,182,1628,1446
3591,0,0,21,0,-21
3592,1,0,1,0,-1
3593,1,0,9,0,-9
3594,1,1,336,1373,1037
3595,1,0,85,0,-85
3596,1,1,1068,1675,607
3597,0,0,104,0,-104
3598,1,0,19,0,-19
3599,0,0,56,0,-56
3600,1,0,27,0,-27
3601,0,0,45,0,-45
3602,1,0,27,0,-27
3603,1,1,1210,1399,189
3604,0,0,72,0,-72
3605,0,0,28,0,-28
3606,0,0,8,0,-8
3607,1,0,57,0,-57
3608,1,0,7,0,-7
3609,0,0,4,0,-4
3610,0,0,0,0,0
3611,1,0,23,0,-23
3612,1,0,53,0,-53
3613,0,0,135,0,-135
3614,0,0,52,0,-52
3615,0,0,130,0,-130
3616,0,0,69,0,-69
3617,1,0,7,0,-7
3618,0,0,7,0,-7
3619,1,0,13,0,-13
3620,0,0,195,0,-195
3621,1,1,1649,1605,-44
3622,1,0,65,0,-65
3623,1,1,249,6016,5767
3624,1,0,29,0,-29
3625,0,0,29,0,-29
3626,0,0,85,0,-85
3627,0,0,150,0,-150
3628,0,0,178,0,-178
3629,1,1,826,1769,943
3630,0,0,6,0,-6
3631,1,0,35,0,-35
3632,0,0,153,0,-153
3633,1,1,709,1216,507
3634,0,0,22,0,-22
3635,1,0,94,0,-94
3636,1,1,298,1639,1341
3637,0,0,18,0,-18
3638,0,0,75,0,-75
3639,1,0,140,0,-140
3640,1,0,2,0,-2
3641,1,0,22,0,-22
3642,1,0,109,0,-109
3643,1,1,1330,1351,21
3644,1,1,253,2792,2539
3645,0,0,6,0,-6
3646,1,0,72,0,-72
3647,1,1,284,1372,1088
3648,1,0,69,0,-69
3649,0,0,95,0,-95
3650,1,0,157,0,-157
3651,1,1,517,1207,690
3652,1,0,46,0,-46
3653,0,0,140,0,-140
3654,1,0,70,0,-70
3655,1,0,246,0,-246
3656,0,0,47,0,-47
3657,0,0,57,0,-57
3658,1,0,5,0,-5
3659,1,1,305,1629,1324
3660,1,1,237,1953,1716
3661,1,1,663,1577,914
3662,0,0,45,0,-45
3663,0,0,11,0,-11
3664,1,0,51,0,-51
3665,1,1,109,1328,1219
3666,1,1,910,1811,901
3667,1,1,261,1368,1107
3668,1,0,4,0,-4
3669,0,0,48,0,-48
3670,0,0,15,0,-15
3671,0,0,115,0,-115
3672,0,0,211,0,-211
3673,1,0,32,0,-32
3674,1,0,17,0,-17
3675,1,1,230,1215,985
3676,1,1,585,1890,1305
3677,0,0,20,0,-20
3678,0,0,71,0,-71
3679,1,1,285,1358,1073
3680,1,0,104,0,-104
3681,0,0,142,0,-142
3682,1,1,141,1347,1206
3683,1,1,461,1253,792
3684,1,0,28,0,-28
3685,0,0,27,0,-27
3686,1,0,66,0,-66
3687,0,0,11,0,-11
3688,1,0,55,0,-55
3689,1,0,41,0,-41
3690,1,0,4,0,-4
3691,1,0,99,0,-99
3692,1,1,289,1354,1065
3693,0,0,13,0,-13
3694,1,0,134,0,-134
3695,1,1,399,1267,868
3696,1,0,1,0,-1
3697,1,0,80,0,-80
3698,1,0,166,0,-166
3699,0,0,26,0,-26
3700,1,0,180,0,-180
3701,0,0,134,0,-134
3702,1,1,571,1487,916
3703,1,0,68,0,-68
3704,1,0,86,0,-86
3705,1,1,569,1206,637
3706,1,1,1031,1391,360
3707,1,0,39,0,-39
3708,1,1,143,1662,1519
3709,1,0,152,0,-152
3710,0,0,20,0,-20
3711,0,0,47,0,-47
3712,0,0,1,0,-1
3713,0,0,8,0,-8
3714,0,0,61,0,-61
3715,1,0,127,0,-127
3716,1,1,66,1298,1232
3717,1,1,1072,1351,279
3718,0,0,9,0,-9
3719,1,0,13,0,-13
3720,1,1,608,1522,914
3721,0,0,10,0,-10
3722,0,0,54,0,-54
3723,1,1,316,1395,1079
3724,1,0,15,0,-15
3725,1,1,940,1989,1049
3726,0,0,3,0,-3
3727,1,1,380,1264,884
3728,0,0,33,0,-33
3729,1,1,1023,2173,1150
3730,1,0,7,0,-7
3731,0,0,81,0,-81
3732,0,0,102,0,-102
3733,0,0,7,0,-7
3734,1,1,276,1335,1059
3735,0,0,109,0,-109
3736,1,0,9,0,-9
3737,0,0,106,0,-106
3738,1,0,106,0,-106
3739,1,0,40,0,-40
3740,1,1,1848,1457,-391
3741,0,0,65,0,-65
3742,0,0,260,0,-260
3743,0,0,32,0,-32
3744,0,0,27,0,-27
3745,1,1,395,1836,1441
3746,1,0,19,0,-19
3747,0,0,112,0,-112
3748,1,1,1051,2327,1276
3749,0,0,4,0,-4
3750,1,0,35,0,-35
3751,1,0,5,0,-5
3752,0,0,21,0,-21
3753,1,0,18,0,-18
3754,1,1,124,2441,2317
3755,0,0,85,0,-85
3756,1,1,116,1299,1183
3757,0,0,12,0,-12
3758,0,0,16,0,-16
3759,1,1,1598,2737,1139
3760,0,0,77,0,-77
3761,1,1,533,1386,853
3762,1,1,462,1523,1061
3763,0,0,5,0,-5
3764,0,0,34,0,-34
3765,1,1,176,1260,1084
3766,1,1,489,1202,713
3767,0,0,27,0,-27
3768,0,0,17,0,-17
3769,1,1,372,1512,1140
3770,1,0,11,0,-11
3771,1,1,219,1575,1356
3772,1,0,70,0,-70
3773,1,0,35,0,-35
3774,1,0,84,0,-84
3775,0,0,12,0,-12
3776,0,0,86,0,-86
3777,0,0,39,0,-39
3778,0,0,57,0,-57
3779,1,0,90,0,-90
3780,0,0,190,0,-190
3781,1,1,293,1581,1288
3782,1,1,90,1201,1111
3783,1,0,112,0,-112
3784,1,0,126,0,-126
3785,0,0,46,0,-46
3786,1,0,118,0,-118
3787,0,0,12,0,-12
3788,0,0,0,0,0
3789,0,0,23,0,-23
3790,1,0,139,0,-139
3791,0,0,29,0,-29
3792,1,1,501,1203,702
3793,1,1,369,2945,2576
3794,1,1,291,1591,1300
3795,1,1,312,1311,999
3796,1,1,178,2158,1980
3797,1,1,1138,1302,164
3798,1,0,0,0,0
3799,1,0,134,0,-134
3800,1,0,38,0,-38
3801,0,0,12,0,-12
3802,1,1,153,1539,1386
3803,1,1,383,2072,1689
3804,1,0,15,0,-15
3805,0,0,147,0,-147
3806,1,1,1066,1371,305
3807,1,0,28,0,-28
3808,1,1,3009,1220,-1789
3809,1,0,16,0,-16
3810,0,0,63,0,-63
3811,1,1,185,1528,1343
3812,0,0,63,0,-63
3813,0,0,2,0,-2
3814,1,0,260,0,-260
3815,0,0,91,0,-91
3816,0,0,87,0,-87
3817,1,1,701,1517,816
3818,1,0,18,0,-18
3819,0,0,161,0,-161
3820,1,0,11,0,-11
3821,0,0,13,0,-13
3822,1,0,45,0,-45
3823,1,0,13,0,-13
3824,0,0,57,0,-57
3825,0,0,40,0,-40
3826,1,0,94,0,-94
3827,0,0,14,0,-14
3828,1,1,1320,1320,0
3829,1,0,81,0,-81
3830,1,0,54,0,-54
3831,0,0,72,0,-72
3832,1,1,412,1940,1528
3833,0,0,73,0,-73
3834,0,0,32,0,-32
3835,1,1,193,1349,1156
3836,1,1,998,2871,1873
3837,0,0,90,0,-90
3838,1,1,1023,1362,339
3839,0,0,28,0,-28
3840,1,0,89,0,-89
3841,0,0,37,0,-37
3842,1,1,1534,1354,-180
3843,1,0,44,0,-44
3844,1,1,292,1223,931
3845,0,0,98,0,-98
3846,0,0,29,0,-29
3847,0,0,9,0,-9
3848,1,1,457,1419,962
3849,1,0,23,0,-23
3850,1,1,212,1217,1005
3851,1,0,29,0,-29
3852,0,0,251,0,-251
3853,1,0,5,0,-5
3854,0,0,8,0,-8
3855,1,1,77,1562,1485
3856,1,0,231,0,-231
3857,0,0,15,0,-15
3858,1,1,454,1343,889
3859,0,0,6,0,-6
3860,1,1,941,1291,350
3861,1,1,280,1733,1453
3862,0,0,43,0,-43
3863,1,0,14,0,-14
3864,1,1,287,1374,1087
3865,0,0,3,0,-3
3866,1,1,112,1331,1219
3867,1,1,89,1820,1731
3868,0,0,14,0,-14
3869,1,0,24,0,-24
3870,1,0,39,0,-39
3871,0,0,5,0,-5
3872,0,0,23,0,-23
3873,0,0,24,0,-24
3874,1,0,3,0,-3
3875,0,0,152,0,-152
3876,0,0,49,0,-49
3877,0,0,80,0,-80
3878,0,0,148,0,-148
3879,1,0,20,0,-20
3880,0,0,6,0,-6
3881,0,0,162,0,-162
3882,1,1,118,1211,1093
3883,0,0,36,0,-36
3884,1,1,189,1294,1105
3885,1,1,826,1572,746
3886,0,0,36,0,-36
3887,1,0,7,0,-7
3888,1,0,83,0,-83
3889,0,0,4,0,-4
3890,0,0,75,0,-75
3891,1,1,742,1710,968
3892,0,0,13,0,-13
3893,0,0,14,0,-14
3894,0,0,7,0,-7
3895,1,0,70,0,-70
3896,1,0,66,0,-66
3897,0,0,20,0,-20
3898,0,0,100,0,-100
3899,1,0,111,0,-111
3900,1,1,192,1301,1109
3901,1,1,721,1274,553
3902,1,0,27,0,-27
3903,1,1,158,1323,1165
3904,1,0,104,0,-104
3905,1,1,963,1239,276
3906,1,1,1613,1345,-268
3907,1,0,37,0,-37
3908,1,0,20,0,-20
3909,0,0,123,0,-123
3910,1,1,100,2616,2516
3911,0,0,14,0,-14
3912,1,1,282,3102,2820
3913,1,1,752,1572,820
3914,1,0,17,0,-17
3915,0,0,28,0,-28
3916,0,0,68,0,-68
3917,1,1,866,1228,362
3918,0,0,15,0,-15
3919,1,1,704,1285,581
3920,1,0,11,0,-11
3921,1,1,380,1607,1227
3922,1,0,70,0,-70
3923,1,1,1536,1228,-308
3924,1,1,72,1227,1155
3925,1,0,41,0,-41
3926,0,0,18,0,-18
3927,1,1,36,1252,1216
3928,1,0,48,0,-48
3929,1,0,28,0,-28
3930,0,0,101,0,-101
3931,1,1,198,1231,1033
3932,1,1,595,1290,695
3933,1,1,710,1363,653
3934,0,0,210,0,-210
3935,1,1,165,1597,1432
3936,0,0,14,0,-14
3937,0,0,174,0,-174
3938,1,0,8,0,-8
3939,0,0,20,0,-20
3940,1,1,1526,2853,1327
3941,1,1,1274,1495,221
3942,1,0,1,0,-1
3943,0,0,19,0,-19
3944,1,0,31,0,-31
3945,0,0,24,0,-24
3946,1,1,15,1384,1369
3947,1,1,234,1368,1134
3948,1,0,56,0,-56
3949,1,1,567,3849,3282
3950,0,0,70,0,-70
3951,1,0,97,0,-97
3952,1,1,332,1626,1294
3953,1,1,375,1584,1209
3954,1,1,1281,2031,750
3955,1,0,216,0,-216
3956,0,0,46,0,-46
3957,1,0,19,0,-19
3958,1,0,2,0,-2
3959,0,0,36,0,-36
3960,0,0,83,0,-83
3961,1,1,2388,1282,-1106
3962,1,1,471,1229,758
3963,1,0,6,0,-6
3964,0,0,149,0,-149
3965,1,0,18,0,-18
3966,0,0,132,0,-132
3967,0,0,35,0,-35
3968,1,1,380,2794,2414
3969,0,0,53,0,-53
3970,0,0,45,0,-45
3971,1,1,583,1203,620
3972,1,0,53,0,-53
3973,1,0,3,0,-3
3974,1,1,392,1310,918
3975,1,1,1805,1223,-582
3976,0,0,31,0,-31
3977,1,0,114,0,-114
3978,0,0,105,0,-105
3979,1,0,57,0,-57
3980,1,1,202,1570,1368
3981,0,0,0,0,0
3982,0,0,14,0,-14
3983,1,0,3,0,-3
3984,1,1,237,1204,967
3985,1,0,47,0,-47
3986,1,0,45,0,-45
3987,1,1,448,1275,827
3988,1,1,115,1446,1331
3989,0,0,8,0,-8
3990,1,1,90,1267,1177
3991,0,0,122,0,-122
3992,1,1,446,1289,843
3993,0,0,24,0,-24
3994,0,0,68,0,-68
3995,0,0,43,0,-43
3996,0,0,114,0,-114
3997,1,1,731,1459,728
3998,1,0,10,0,-10
3999,1,0,23,0,-23
4000,1,1,53,1815,1762
4001,1,0,13,0,-13
4002,0,0,5,0,-5
4003,0,0,26,0,-26
4004,1,0,15,0,-15
4005,0,0,36,0,-36
4006,1,1,200,1272,1072
4007,0,0,213,0,-213
4008,1,1,882,1249,367
4009,1,0,55,0,-55
4010,0,0,11,0,-11
4011,0,0,8,0,-8
4012,0,0,43,0,-43
4013,1,1,51,1239,1188
4014,1,1,335,2091,1756
4015,1,1,385,1265,880
4016,1,1,1162,1812,650
4017,1,0,149,0,-149
4018,1,1,264,1722,1458
4019,0,0,19,0,-19
4020,1,1,609,1270,661
4021,1,1,518,1723,1205
4022,0,0,29,0,-29
4023,0,0,16,0,-16
4024,0,0,6,0,-6
4025,1,1,658,1405,747
4026,0,0,119,0,-119
4027,1,0,79,0,-79
4028,1,1,58,1281,1223
4029,0,0,21,0,-21
4030,1,1,64,1692,1628
4031,1,1,1058,1205,147
4032,0,0,62,0,-62
4033,0,0,29,0,-29
4034,1,0,60,0,-60
4035,0,0,32,0,-32
4036,1,0,19,0,-19
4037,1,0,25,0,-25
4038,1,1,149,1793,1644
4039,1,1,2398,1378,-1020
4040,0,0,17,0,-17
4041,1,1,521,1361,840
4042,1,0,163,0,-163
4043,1,0,28,0,-28
4044,1,0,30,0,-30
4045,1,0,0,0,0
4046,1,0,29,0,-29
4047,1,0,1,0,-1
4048,1,1,253,1803,1550
4049,1,1,459,1541,1082
4050,1,0,16,0,-16
4051,0,0,34,0,-34
4052,1,0,33,0,-33
4053,1,0,37,0,-37
4054,0,0,142,0,-142
4055,1,1,173,1327,1154
4056,1,1,187,1540,1353
4057,0,0,101,0,-101
4058,0,0,78,0,-78
4059,0,0,6,0,-6
4060,0,0,66,0,-66
4061,0,0,32,0,-32
4062,0,0,5,0,-5
4063,0,0,44,0,-44
4064,1,0,31,0,-31
4065,1,0,50,0,-50
4066,1,0,145,0,-145
4067,1,0,14,0,-14
4068,1,0,35,0,-35
4069,1,1,575,1734,1159
4070,1,1,606,1567,961
4071,0,0,5,0,-5
4072,0,0,2,0,-2
4073,0,0,19,0,-19
4074,1,0,67,0,-67
4075,1,1,449,1342,893
4076,1,1,651,1378,727
4077,0,0,44,0,-44
4078,1,1,357,3114,2757
4079,1,1,41,1415,1374
4080,1,0,22,0,-22
4081,0,0,6,0,-6
4082,0,0,136,0,-136
4083,1,1,464,2009,1545
4084,1,1,191,2090,1899
4085,1,0,35,0,-35
4086,1,0,10,0,-10
4087,0,0,143,0,-143
4088,1,0,127,0,-127
4089,0,0,22,0,-22
4090,1,0,39,0,-39
4091,0,0,93,0,-93
4092,1,1,354,1475,1121
4093,1,0,10,0,-10
4094,0,0,60,0,-60
4095,1,0,1,0,-1
4096,1,0,147,0,-147
4097,0,0,20,0,-20
4098,1,1,1288,1792,504
4099,1,1,1014,1355,341
4100,0,0,185,0,-185
4101,1,1,203,1335,1132
4102,1,1,274,1513,1239
4103,1,1,17,1298,1281
4104,0,0,50,0,-50
4105,0,0,39,0,-39
4106,1,1,29,1205,1176
4107,0,0,131,0,-131
4108,1,1,260,1684,1424
4109,1,1,674,1293,619
4110,0,0,23,0,-23
4111,1,0,111,0,-111
4112,1,0,113,0,-113
4113,1,0,32,0,-32
4114,1,1,776,1786,1010
4115,0,0,13,0,-13
4116,0,0,92,0,-92
4117,1,0,84,0,-84
4118,0,0,68,0,-68
4119,1,0,32,0,-32
4120,0,0,40,0,-40
4121,1,1,1011,1286,275
4122,1,0,127,0,-127
4123,1,1,1182,1236,54
4124,0,0,47,0,-47
4125,1,0,55,0,-55
4126,0,0,70,0,-70
4127,1,1,118,1223,1105
4128,1,0,19,0,-19
4129,0,0,0,0,0
4130,1,1,296,1251,955
4131,0,0,66,0,-66
4132,1,1,506,1425,919
4133,1,0,76,0,-76
4134,0,0,16,0,-16
4135,1,1,801,1314,513
4136,1,0,90,0,-90
4137,1,0,106,0,-106
4138,1,1,903,4586,3683
4139,1,0,7,0,-7
4140,1,1,828,1493,665
4141,1,0,19,0,-19
4142,0,0,7,0,-7
4143,1,0,47,0,-47
4144,0,0,15,0,-15
4145,0,0,3,0,-3
4146,0,0,60,0,-60
4147,1,0,26,0,-26
4148,1,1,924,1248,324
4149,1,0,50,0,-50
4150,1,0,24,0,-24
4151,1,0,54,0,-54
4152,1,1,317,1420,1103
4153,1,1,61,1312,1251
4154,1,1,196,1879,1683
4155,0,0,6,0,-6
4156,1,1,977,2353,1376
4157,1,1,327,1645,1318
4158,0,0,39,0,-39
4159,1,0,119,0,-119
4160,0,0,29,0,-29
4161,1,1,27,1214,1187
4162,1,0,38,0,-38
4163,1,0,32,0,-32
4164,0,0,46,0,-46
4165,0,0,70,0,-70
4166,1,1,1124,2250,1126
4167,1,1,960,1313,353
4168,1,0,41,0,-41
4169,1,1,100,1292,1192
4170,0,0,6,0,-6
4171,1,1,1051,1213,162
4172,0,0,5,0,-5
4173,1,0,5,0,-5
4174,0,0,120,0,-120
4175,1,1,123,1506,1383
4176,0,0,115,0,-115
4177,1,1,570,1417,847
4178,1,1,436,1315,879
4179,1,0,10,0,-10
4180,0,0,158,0,-158
4181,1,0,44,0,-44
4182,1,1,1668,1317,-351
4183,1,1,1055,1673,618
4184,0,0,0,0,0
4185,0,0,29,0,-29
4186,0,0,55,0,-55
4187,0,0,42,0,-42
4188,0,0,10,0,-10
4189,0,0,11,0,-11
4190,1,1,597,1274,677
4191,0,0,36,0,-36
4192,0,0,45,0,-45
4193,1,1,716,1233,517
4194,1,1,752,1315,563
4195,0,0,82,0,-82
4196,1,1,765,1422,657
4197,1,0,21,0,-21
4198,1,0,12,0,-12
4199,1,0,3,0,-3
4200,1,0,88,0,-88
4201,1,1,310,2110,1800
4202,1,1,112,1288,1176
4203,1,0,59,0,-59
4204,1,0,37,0,-37
4205,1,1,147,1389,1242
4206,1,1,484,1912,1428
4207,1,0,26,0,-26
4208,1,0,15,0,-15
4209,1,0,138,0,-138
4210,1,1,180,1310,1130
4211,0,0,62,0,-62
4212,0,0,8,0,-8
4213,1,1,252,1455,1203
4214,0,0,46,0,-46
4215,1,1,486,1572,1086
4216,1,0,13,0,-13
4217,0,0,12,0,-12
4218,0,0,51,0,-51
4219,0,0,6,0,-6
4220,0,0,23,0,-23
4221,1,0,38,0,-38
4222,1,1,106,1317,1211
4223,0,0,34,0,-34
4224,1,0,79,0,-79
4225,1,0,4,0,-4
4226,0,0,27,0,-27
4227,0,0,1,0,-1
4228,0,0,45,0,-45
4229,1,1,834,1241,407
4230,1,1,379,1523,1144
4231,1,0,109,0,-109
4232,0,0,5,0,-5
4233,1,1,5,1425,1420
4234,1,1,249,1215,966
4235,1,1,674,1720,1046
4236,1,1,759,1332,573
4237,1,0,31,0,-31
4238,1,0,35,0,-35
4239,1,1,569,1267,698
4240,0,0,48,0,-48
4241,1,0,142,0,-142
4242,0,0,24,0,-24
4243,0,0,21,0,-21
4244,0,0,83,0,-83
4245,1,0,5,0,-5
4246,0,0,11,0,-11
4247,1,0,85,0,-85
4248,1,0,1,0,-1
4249,0,0,19,0,-19
4250,0,0,10,0,-10
4251,0,0,27,0,-27
4252,1,1,53,2305,2252
4253,0,0,55,0,-55
4254,1,1,808,1205,397
4255,0,0,69,0,-69
4256,0,0,57,0,-57
4257,0,0,42,0,-42
4258,0,0,380,0,-380
4259,1,0,23,0,-23
4260,1,1,153,2137,1984
4261,0,0,42,0,-42
4262,1,0,9,0,-9
4263,1,1,801,1421,620
4264,0,0,34,0,-34
4265,0,0,15,0,-15
4266,1,0,30,0,-30
4267,1,1,695,2284,1589
4268,0,0,32,0,-32
4269,0,0,18,0,-18
4270,0,0,67,0,-67
4271,0,0,122,0,-122
4272,0,0,78,0,-78
4273,0,0,3,0,-3
4274,1,1,209,2884,2675
4275,0,0,104,0,-104
4276,0,0,117,0,-117
4277,0,0,29,0,-29
4278,0,0,40,0,-40
4279,0,0,11,0,-11
4280,0,0,39,0,-39
4281,1,1,607,1274,667
4282,0,0,93,0,-93
4283,0,0,43,0,-43
4284,1,0,8,0,-8
4285,1,0,17,0,-17
4286,1,1,290,1340,1050
4287,0,0,156,0,-156
4288,0,0,131,0,-131
4289,1,0,99,0,-99
4290,1,0,84,0,-84
4291,1,0,63,0,-63
4292,1,0,72,0,-72
4293,0,0,72,0,-72
4294,0,0,5,0,-5
4295,1,1,126,2281,2155
4296,0,0,66,0,-66
4297,1,1,259,1339,1080
4298,1,1,298,1264,966
4299,1,1,332,1707,1375
4300,0,0,58,0,-58
4301,1,0,25,0,-25
4302,0,0,37,0,-37
4303,0,0,41,0,-41
4304,1,0,51,0,-51
4305,1,0,94,0,-94
4306,1,1,689,1256,567
4307,1,0,7,0,-7
4308,0,0,23,0,-23
4309,1,0,8,0,-8
4310,1,1,1012,1387,375
4311,0,0,8,0,-8
4312,1,0,333,0,-333
4313,1,0,39,0,-39
4314,0,0,8,0,-8
4315,0,0,47,0,-47
4316,1,1,2524,1504,-1020
4317,1,0,35,0,-35
4318,1,0,47,0,-47
4319,0,0,42,0,-42
4320,0,0,28,0,-28
4321,0,0,44,0,-44
4322,0,0,117,0,-117
4323,0,0,32,0,-32
4324,1,0,9,0,-9
4325,1,0,13,0,-13
4326,1,1,776,1731,955
4327,0,0,115,0,-115
4328,1,1,726,1283,557
4329,1,1,1121,1331,210
4330,1,0,21,0,-21
4331,1,1,1576,1408,-168
4332,1,1,317,3137,2820
4333,0,0,23,0,-23
4334,1,1,236,1862,1626
4335,0,0,2,0,-2
4336,0,0,40,0,-40
4337,1,0,86,0,-86
4338,1,1,492,1437,945
4339,1,0,39,0,-39
4340,1,1,654,1283,629
4341,1,1,553,1391,838
4342,0,0,24,0,-24
4343,1,0,10,0,-10
4344,1,1,517,1751,1234
4345,0,0,25,0,-25
4346,1,0,12,0,-12
4347,0,0,19,0,-19
4348,1,0,195,0,-195
4349,1,1,271,1763,1492
4350,1,0,63,0,-63
4351,1,0,89,0,-89
4352,1,0,24,0,-24
4353,1,1,1196,1250,54
4354,0,0,77,0,-77
4355,1,0,42,0,-42
4356,0,0,79,0,-79
4357,1,0,79,0,-79
4358,1,0,23,0,-23
4359,0,0,14,0,-14
4360,1,1,519,1630,1111
4361,0,0,109,0,-109
4362,0,0,51,0,-51
4363,0,0,32,0,-32
4364,0,0,50,0,-50
4365,0,0,87,0,-87
4366,0,0,6,0,-6
4367,1,0,54,0,-54
4368,1,1,715,1692,977
4369,0,0,10,0,-10
4370,1,0,28,0,-28
4371,1,1,190,1830,1640
4372,0,0,102,0,-102
4373,0,0,49,0,-49
4374,0,0,87,0,-87
4375,1,0,21,0,-21
4376,1,0,185,0,-185
4377,0,0,92,0,-92
4378,0,0,2,0,-2
4379,1,0,57,0,-57
4380,1,0,103,0,-103
4381,0,0,17,0,-17
4382,1,1,98,1291,1193
4383,0,0,9,0,-9
4384,1,0,28,0,-28
4385,0,0,18,0,-18
4386,1,0,24,0,-24
4387,0,0,51,0,-51
4388,1,1,523,1557,1034
4389,1,0,41,0,-41
4390,1,1,2079,1824,-255
4391,1,0,92,0,-92
4392,0,0,79,0,-79
4393,1,0,15,0,-15
4394,0,0,17,0,-17
4395,1,1,156,1437,1281
4396,1,1,463,2350,1887
4397,0,0,12,0,-12
4398,0,0,50,0,-50
4399,1,1,553,3298,2745
4400,1,0,61,0,-61
4401,1,0,31,0,-31
4402,0,0,8,0,-8
4403,1,1,487,1376,889
4404,0,0,3,0,-3
4405,0,0,32,0,-32
4406,1,0,37,0,-37
4407,1,0,17,0,-17
4408,1,0,8,0,-8
4409,1,0,14,0,-14
4410,0,0,78,0,-78
4411,0,0,29,0,-29
4412,1,0,151,0,-151
4413,1,1,394,1464,1070
4414,0,0,4,0,-4
4415,1,1,884,1365,481
4416,1,1,950,1930,980
4417,1,1,287,1534,1247
4418,0,0,23,0,-23
4419,1,1,492,2323,1831
4420,1,1,905,1894,989
4421,0,0,25,0,-25
4422,0,0,9,0,-9
4423,1,0,35,0,-35
4424,1,1,228,1690,1462
4425,0,0,25,0,-25
4426,0,0,148,0,-148
4427,1,0,61,0,-61
4428,1,1,396,1320,924
4429,0,0,18,0,-18
4430,1,1,370,1363,993
4431,1,0,17,0,-17
4432,1,1,138,1314,1176
4433,1,0,25,0,-25
4434,1,1,403,1436,1033
4435,1,0,26,0,-26
4436,0,0,42,0,-42
4437,1,0,34,0,-34
4438,0,0,65,0,-65
4439,0,0,74,0,-74
4440,1,0,68,0,-68
4441,1,0,72,0,-72
4442,1,1,446,2067,1621
4443,1,1,825,1843,1018
4444,0,0,66,0,-66
4445,1,1,137,1444,1307
4446,1,1,772,1352,580
4447,1,0,28,0,-28
4448,0,0,23,0,-23
4449,0,0,81,0,-81
4450,1,1,415,1297,882
4451,0,0,85,0,-85
4452,1,1,686,2845,2159
4453,1,0,36,0,-36
4454,1,1,286,1497,1211
4455,1,0,24,0,-24
4456,1,1,637,1620,983
4457,0,0,21,0,-21
4458,0,0,16,0,-16
4459,1,0,40,0,-40
4460,1,1,661,1278,617
4461,1,0,38,0,-38
4462,1,1,270,1559,1289
4463,0,0,57,0,-57
4464,1,1,475,1675,1200
4465,0,0,36,0,-36
4466,0,0,3,0,-3
4467,1,0,23,0,-23
4468,1,1,61,1376,1315
4469,0,0,95,0,-95
4470,1,1,1002,1216,214
4471,1,1,1662,1581,-81
4472,0,0,78,0,-78
4473,0,0,39,0,-39
4474,0,0,2,0,-2
4475,0,0,6,0,-6
4476,0,0,108,0,-108
4477,1,0,7,0,-7
4478,0,0,26,0,-26
4479,1,1,107,1712,1605
4480,0,0,71,0,-71
4481,0,0,56,0,-56
4482,0,0,26,0,-26
4483,0,0,182,0,-182
4484,0,0,105,0,-105
4485,1,0,39,0,-39
4486,1,0,13,0,-13
4487,1,1,1168,1572,404
4488,1,0,92,0,-92
4489,1,0,111,0,-111
4490,1,0,110,0,-110
4491,1,1,135,1266,1131
4492,0,0,184,0,-184
4493,0,0,17,0,-17
4494,1,0,78,0,-78
4495,1,0,168,0,-168
4496,1,0,75,0,-75
4497,1,0,69,0,-69
4498,0,0,78,0,-78
4499,0,0,2,0,-2
4500,0,0,19,0,-19
4501,1,0,39,0,-39
4502,1,0,15,0,-15
4503,1,0,23,0,-23
4504,1,0,6,0,-6
4505,0,0,36,0,-36
4506,0,0,20,0,-20
4507,0,0,151,0,-151
4508,0,0,75,0,-75
4509,1,1,146,1764,1618
4510,1,0,117,0,-117
4511,1,0,3,0,-3
4512,1,0,49,0,-49
4513,1,1,1157,1500,343
4514,0,0,96,0,-96
4515,1,1,640,1383,743
4516,1,1,479,2211,1732
4517,1,0,41,0,-41
4518,1,0,15,0,-15
4519,1,0,9,0,-9
4520,1,0,31,0,-31
4521,0,0,71,0,-71
4522,1,0,18,0,-18
4523,1,1,815,1538,723
4524,1,1,420,1723,1303
4525,0,0,4,0,-4
4526,1,0,16,0,-16
4527,1,0,4,0,-4
4528,1,0,46,0,-46
4529,0,0,4,0,-4
4530,1,0,160,0,-160
4531,0,0,16,0,-16
4532,1,1,534,1812,1278
4533,0,0,0,0,0
4534,0,0,1,0,-1
4535,1,1,880,1291,411
4536,0,0,16,0,-16
4537,1,0,30,0,-30
4538,1,0,13,0,-13
4539,0,0,106,0,-106
4540,1,0,12,0,-12
4541,1,1,274,1659,1385
4542,1,1,2325,1328,-997
4543,0,0,10,0,-10
4544,1,0,18,0,-18
4545,0,0,3,0,-3
4546,1,1,301,1242,941
4547,0,0,26,0,-26
4548,1,1,24,1215,1191
4549,1,1,231,1223,992
4550,0,0,9,0,-9
4551,1,1,376,2196,1820
4552,0,0,21,0,-21
4553,0,0,27,0,-27
4554,1,1,206,1732,1526
4555,1,0,2,0,-2
4556,0,0,39,0,-39
4557,1,1,94,2609,2515
4558,1,1,272,1402,1130
4559,1,1,432,1274,842
4560,1,1,583,1453,870
4561,1,1,380,1298,918
4562,0,0,101,0,-101
4563,1,0,59,0,-59
4564,0,0,26,0,-26
4565,0,0,9,0,-9
4566,0,0,43,0,-43
4567,1,0,30,0,-30
4568,0,0,43,0,-43
4569,1,0,15,0,-15
4570,0,0,0,0,0
4571,1,0,29,0,-29
4572,0,0,22,0,-22
4573,1,0,11,0,-11
4574,1,1,610,3443,2833
4575,1,1,558,1242,684
4576,1,1,618,1387,769
4577,1,0,50,0,-50
4578,1,1,1035,1766,731
4579,1,0,66,0,-66
4580,0,0,12,0,-12
4581,0,0,52,0,-52
4582,1,0,64,0,-64
4583,1,1,267,1413,1146
4584,1,1,498,1464,966
4585,0,0,57,0,-57
4586,1,1,928,1788,860
4587,1,0,20,0,-20
4588,1,1,304,2473,2169
4589,1,1,97,1234,1137
4590,1,0,126,0,-126
4591,1,1,496,1214,718
4592,1,0,52,0,-52
4593,1,0,20,0,-20
4594,1,0,27,0,-27
4595,1,0,50,0,-50
4596,1,1,1028,1210,182
4597,1,0,28,0,-28
4598,1,0,82,0,-82
4599,1,0,6,0,-6
4600,0,0,6,0,-6
4601,1,1,500,1422,922
4602,0,0,8,0,-8
4603,1,0,23,0,-23
4604,1,1,177,1201,1024
4605,1,0,20,0,-20
4606,1,1,589,1267,678
4607,0,0,52,0,-52
4608,0,0,57,0,-57
4609,0,0,58,0,-58
4610,1,1,268,1344,1076
4611,1,1,307,1398,1091
4612,1,0,26,0,-26
4613,1,1,219,1215,996
4614,0,0,12,0,-12
4615,0,0,47,0,-47
4616,1,1,181,1360,1179
4617,0,0,47,0,-47
4618,0,0,218,0,-218
4619,0,0,76,0,-76
4620,1,0,73,0,-73
4621,1,0,8,0,-8
4622,0,0,1,0,-1
4623,1,0,14,0,-14
4624,0,0,151,0,-151
4625,1,1,3133,1985,-1148
4626,1,1,134,1252,1118
4627,1,0,39,0,-39
4628,0,0,35,0,-35
4629,1,1,235,1786,1551
4630,1,0,131,0,-131
4631,1,0,8,0,-8
4632,0,0,58,0,-58
4633,1,1,479,2029,1550
4634,1,1,346,1235,889
4635,1,0,104,0,-104
4636,0,0,52,0,-52
4637,0,0,39,0,-39
4638,1,0,10,0,-10
4639,1,0,210,0,-210
4640,1,1,254,1838,1584
4641,1,1,93,1544,1451
4642,0,0,9,0,-9
4643,1,1,387,1222,835
4644,1,1,189,1207,1018
4645,0,0,37,0,-37
4646,1,1,1115,1524,409
4647,1,1,168,1492,1324
4648,1,1,718,1719,1001
4649,1,1,519,1307,788
4650,1,1,466,2056,1590
4651,1,0,98,0,-98
4652,1,1,239,1430,1191
4653,0,0,0,0,0
4654,1,0,42,0,-42
4655,1,0,11,0,-11
4656,1,0,47,0,-47
4657,1,1,664,1227,563
4658,1,0,64,0,-64
4659,1,1,107,1701,1594
4660,1,0,48,0,-48
4661,0,0,84,0,-84
4662,1,1,293,1400,1107
4663,0,0,20,0,-20
4664,0,0,33,0,-33
4665,1,1,590,1248,658
4666,1,1,624,2143,1519
4667,1,1,667,1453,786
4668,1,0,217,0,-217
4669,1,0,8,0,-8
4670,1,0,35,0,-35
4671,1,0,13,0,-13
4672,1,0,82,0,-82
4673,0,0,1,0,-1
4674,1,0,14,0,-14
4675,1,1,45,1580,1535
4676,0,0,89,0,-89
4677,1,0,36,0,-36
4678,1,1,914,1325,411
4679,1,1,882,1331,449
4680,1,0,20,0,-20
4681,0,0,13,0,-13
4682,1,1,2445,1423,-1022
4683,0,0,57,0,-57
4684,1,0,4,0,-4
4685,0,0,110,0,-110
4686,1,0,61,0,-61
4687,0,0,10,0,-10
4688,1,0,73,0,-73
4689,1,1,442,2176,1734
4690,0,0,8,0,-8
4691,1,1,64,1368,1304
4692,0,0,31,0,-31
4693,1,1,169,1828,1659
4694,1,0,52,0,-52
4695,1,0,53,0,-53
4696,0,0,60,0,-60
4697,0,0,22,0,-22
4698,1,0,68,0,-68
4699,0,0,107,0,-107
4700,1,1,400,1602,1202
4701,1,0,44,0,-44
4702,1,1,1278,1460,182
4703,0,0,5,0,-5
4704,1,0,16,0,-16
4705,0,0,134,0,-134
4706,0,0,33,0,-33
4707,1,0,39,0,-39
4708,1,1,79,1636,1557
4709,1,0,17,0,-17
4710,1,0,98,0,-98
4711,0,0,61,0,-61
4712,1,1,372,2129,1757
4713,0,0,67,0,-67
4714,1,1,249,1481,1232
4715,0,0,33,0,-33
4716,0,0,9,0,-9
4717,0,0,13,0,-13
4718,0,0,111,0,-111
4719,1,0,64,0,-64
4720,1,0,13,0,-13
4721,0,0,13,0,-13
4722,0,0,39,0,-39
4723,1,0,99,0,-99
4724,0,0,55,0,-55
4725,1,0,38,0,-38
4726,1,1,1016,1664,648
4727,1,1,315,1477,1162
4728,1,0,164,0,-164
4729,1,1,845,1276,431
4730,0,0,2,0,-2
4731,1,0,10,0,-10
4732,1,0,31,0,-31
4733,1,1,236,1834,1598
4734,1,0,63,0,-63
4735,1,0,3,0,-3
4736,1,0,9,0,-9
4737,1,1,363,2290,1927
4738,1,1,1066,1589,523
4739,0,0,55,0,-55
4740,1,0,25,0,-25
4741,1,1,1425,1526,101
4742,1,1,29,1933,1904
4743,0,0,47,0,-47
4744,1,0,3,0,-3
4745,1,0,25,0,-25
4746,0,0,14,0,-14
4747,1,0,27,0,-27
4748,1,1,248,1288,1040
4749,1,0,53,0,-53
4750,0,0,44,0,-44
4751,1,0,0,0,0
4752,1,1,235,1228,993
4753,0,0,68,0,-68
4754,1,0,63,0,-63
4755,0,0,36,0,-36
4756,0,0,32,0,-32
4757,1,1,218,1604,1386
4758,1,1,244,1214,970
4759,1,1,209,1627,1418
4760,1,1,1142,1346,204
4761,1,1,189,2138,1949
4762,0,0,66,0,-66
4763,0,0,17,0,-17
4764,1,1,92,1352,1260
4765,1,1,681,1968,1287
4766,1,1,92,1339,1247
4767,1,1,276,1506,1230
4768,1,0,76,0,-76
4769,1,0,5,0,-5
4770,1,1,774,1275,501
4771,1,0,12,0,-12
4772,1,1,208,3401,3193
4773,1,1,67,3308,3241
4774,0,0,70,0,-70
4775,0,0,69,0,-69
4776,0,0,37,0,-37
4777,1,0,74,0,-74
4778,0,0,158,0,-158
4779,0,0,101,0,-101
4780,1,1,468,1419,951
4781,1,0,7,0,-7
4782,0,0,101,0,-101
4783,1,1,50,2874,2824
4784,0,0,110,0,-110
4785,0,0,30,0,-30
4786,1,0,3,0,-3
4787,1,1,276,1245,969
4788,1,0,73,0,-73
4789,0,0,23,0,-23
4790,0,0,63,0,-63
4791,1,0,21,0,-21
4792,0,0,36,0,-36
4793,0,0,36,0,-36
4794,0,0,59,0,-59
4795,1,0,22,0,-22
4796,0,0,1,0,-1
4797,0,0,3,0,-3
4798,0,0,36,0,-36
4799,0,0,32,0,-32
4800,0,0,94,0,-94
4801,0,0,37,0,-37
4802,0,0,12,0,-12
4803,0,0,13,0,-13
4804,1,1,524,1281,757
4805,1,1,292,1654,1362
4806,1,1,333,1571,1238
4807,0,0,9,0,-9
4808,0,0,53,0,-53
4809,1,1,696,1628,932
4810,1,0,4,0,-4
4811,0,0,12,0,-12
4812,1,0,111,0,-111
4813,0,0,12,0,-12
4814,0,0,32,0,-32
4815,1,0,203,0,-203
4816,0,0,3,0,-3
4817,0,0,50,0,-50
4818,1,1,357,1206,849
4819,0,0,23,0,-23
4820,1,0,29,0,-29
4821,1,0,33,0,-33
4822,0,0,19,0,-19
4823,0,0,27,0,-27
4824,1,1,255,1302,1047
4825,1,0,143,0,-143
4826,0,0,65,0,-65
4827,0,0,3,0,-3
4828,1,1,135,1267,1132
4829,1,0,32,0,-32
4830,0,0,35,0,-35
4831,1,0,23,0,-23
4832,0,0,53,0,-53
4833,1,1,55,1458,1403
4834,0,0,73,0,-73
4835,0,0,1,0,-1
4836,0,0,59,0,-59
4837,1,1,692,1265,573
4838,1,1,363,1450,1087
4839,1,0,39,0,-39
4840,0,0,20,0,-20
4841,1,1,427,1429,1002
4842,1,0,3,0,-3
4843,1,0,53,0,-53
4844,1,0,30,0,-30
4845,1,0,4,0,-4
4846,1,1,484,1251,767
4847,1,0,18,0,-18
4848,1,0,43,0,-43
4849,1,0,6,0,-6
4850,1,1,349,1246,897
4851,1,1,537,1686,1149
4852,1,1,121,1203,1082
4853,1,1,233,1252,1019
4854,0,0,90,0,-90
4855,1,0,11,0,-11
4856,0,0,45,0,-45
4857,1,0,4,0,-4
4858,0,0,101,0,-101
4859,0,0,4,0,-4
4860,1,1,42,1598,1556
4861,0,0,12,0,-12
4862,0,0,4,0,-4
4863,0,0,73,0,-73
4864,1,0,28,0,-28
4865,1,1,369,1991,1622
4866,1,0,10,0,-10
4867,1,0,31,0,-31
4868,1,0,48,0,-48
4869,0,0,10,0,-10
4870,1,1,160,2039,1879
4871,0,0,12,0,-12
4872,1,0,27,0,-27
4873,1,0,69,0,-69
4874,0,0,57,0,-57
4875,1,1,16,1763,1747
4876,0,0,20,0,-20
4877,0,0,15,0,-15
4878,1,0,37,0,-37
4879,1,1,322,1417,1095
4880,1,1,160,1250,1090
4881,1,0,12,0,-12
4882,1,0,8,0,-8
4883,1,0,76,0,-76
4884,1,1,1722,1440,-282
4885,0,0,3,0,-3
4886,0,0,226,0,-226
4887,1,0,8,0,-8
4888,0,0,50,0,-50
4889,0,0,46,0,-46
4890,1,1,810,1659,849
4891,1,1,257,1408,1151
4892,1,1,404,1352,948
4893,1,0,2,0,-2
4894,1,1,48,1686,1638
4895,1,1,270,1468,1198
4896,0,0,17,0,-17
4897,0,0,3,0,-3
4898,1,0,31,0,-31
4899,1,1,52,1291,1239
4900,1,0,34,0,-34
4901,0,0,60,0,-60
4902,1,0,4,0,-4
4903,1,0,21,0,-21
4904,0,0,45,0,-45
4905,1,0,43,0,-43
4906,1,1,943,1364,421
4907,0,0,16,0,-16
4908,1,0,140,0,-140
4909,1,1,24,1241,1217
4910,1,0,33,0,-33
4911,0,0,91,0,-91
4912,1,1,485,1369,884
4913,1,1,521,1541,1020
4914,1,1,550,1234,684
4915,1,1,615,1216,601
4916,1,0,13,0,-13
4917,0,0,126,0,-126
4918,1,0,28,0,-28
4919,1,1,313,1401,1088
4920,0,0,5,0,-5
4921,0,0,19,0,-19
4922,0,0,10,0,-10
4923,1,0,13,0,-13
4924,1,0,72,0,-72
4925,1,0,4,0,-4
4926,0,0,208,0,-208
4927,0,0,49,0,-49
4928,1,0,22,0,-22
4929,0,0,5,0,-5
4930,1,0,16,0,-16
4931,0,0,52,0,-52
4932,1,0,162,0,-162
4933,1,1,11,1647,1636
4934,0,0,104,0,-104
4935,1,0,12,0,-12
4936,0,0,31,0,-31
4937,0,0,12,0,-12
4938,1,1,816,1352,536
4939,1,1,1666,1377,-289
4940,0,0,1,0,-1
4941,1,1,214,1882,1668
4942,1,1,533,2540,2007
4943,1,1,164,1267,1103
4944,0,0,5,0,-5
4945,1,0,31,0,-31
4946,0,0,25,0,-25
4947,1,0,39,0,-39
4948,1,1,1252,1824,572
4949,0,0,62,0,-62
4950,1,0,16,0,-16
4951,1,1,1698,1506,-192
4952,0,0,67,0,-67
4953,1,1,1173,1210,37
4954,1,1,75,1432,1357
4955,0,0,60,0,-60
4956,0,0,40,0,-40
4957,0,0,1,0,-1
4958,1,1,265,2322,2057
4959,1,0,21,0,-21
4960,0,0,44,0,-44
4961,1,0,43,0,-43
4962,0,0,41,0,-41
4963,1,0,10,0,-10
4964,1,1,693,1293,600
4965,0,0,50,0,-50
4966,0,0,4,0,-4
4967,1,0,65,0,-65
4968,1,0,53,0,-53
4969,1,1,154,3640,3486
4970,1,1,1700,1455,-245
4971,1,1,45,1229,1184
4972,0,0,18,0,-18
4973,1,1,242,1204,962
4974,1,1,1043,1459,416
4975,0,0,15,0,-15
4976,0,0,6,0,-6
4977,1,1,356,3339,2983
4978,1,1,283,1632,1349
4979,1,1,683,1560,877
4980,0,0,13,0,-13
4981,1,0,47,0,-47
4982,0,0,16,0,-16
4983,1,1,304,1456,1152
4984,1,1,146,1299,1153
4985,1,0,61,0,-61
4986,1,0,76,0,-76
4987,0,0,69,0,-69
4988,1,0,35,0,-35
4989,1,1,2574,1457,-1117
4990,1,1,25,1825,1800
4991,1,0,77,0,-77
4992,1,0,17,0,-17
4993,1,1,507,1480,973
4994,0,0,36,0,-36
4995,1,0,112,0,-112
4996,1,0,6,0,-6
4997,1,0,70,0,-70
4998,0,0,43,0,-43
4999,0,0,150,0,-150
5000,1,0,13,0,-13
5001,0,0,21,0,-21
5002,1,1,321,1941,1620
5003,1,1,287,1531,1244
5004,1,1,339,1379,1040
5005,1,1,438,1277,839
5006,1,1,881,1285,404
5007,0,0,20,0,-20
5008,1,0,1,0,-1
5009,0,0,0,0,0
5010,0,0,65,0,-65
5011,1,0,11,0,-11
5012,1,1,754,1930,1176
5013,0,0,46,0,-46
5014,1,1,437,1652,1215
5015,1,1,490,2066,1576
5016,0,0,42,0,-42
5017,1,1,1195,1356,161
5018,1,0,59,0,-59
5019,1,0,75,0,-75
5020,0,0,16,0,-16
5021,0,0,34,0,-34
5022,0,0,104,0,-104
5023,1,0,82,0,-82
5024,0,0,86,0,-86
5025,0,0,75,0,-75
5026,1,0,101,0,-101
5027,0,0,6,0,-6
5028,0,0,108,0,-108
5029,0,0,4,0,-4
5030,1,0,26,0,-26
5031,0,0,2,0,-2
5032,1,1,180,1370,1190
5033,1,1,987,1456,469
5034,1,0,3,0,-3
5035,1,1,288,1243,955
5036,0,0,51,0,-51
5037,1,0,55,0,-55
5038,1,1,375,1207,832
5039,0,0,20,0,-20
5040,1,1,1001,1411,410
5041,1,1,145,1318,1173
5042,1,0,60,0,-60
5043,1,0,13,0,-13
5044,0,0,12,0,-12
5045,1,1,512,1597,1085
5046,0,0,16,0,-16
5047,0,0,23,0,-23
5048,1,1,395,1253,858
5049,1,0,81,0,-81
5050,0,0,19,0,-19
5051,0,0,74,0,-74
5052,1,0,16,0,-16
5053,1,0,1,0,-1
5054,1,1,428,1544,1116
5055,1,1,866,1250,384
5056,0,0,15,0,-15
5057,0,0,3,0,-3
5058,1,1,461,1665,1204
5059,1,0,27,0,-27
5060,1,1,209,1295,1086
5061,0,0,20,0,-20
5062,1,1,216,1231,1015
5063,0,0,43,0,-43
5064,1,1,107,1685,1578
5065,1,0,24,0,-24
5066,0,0,18,0,-18
5067,1,1,379,1354,975
5068,0,0,88,0,-88
5069,1,0,16,0,-16
5070,1,1,46,1382,1336
5071,0,0,48,0,-48
5072,0,0,82,0,-82
5073,1,1,657,1215,558
5074,1,0,92,0,-92
5075,0,0,11,0,-11
5076,0,0,120,0,-120
5077,1,1,329,1721,1392
5078,1,1,723,1345,622
5079,1,0,60,0,-60
5080,1,0,51,0,-51
5081,1,0,36,0,-36
5082,0,0,31,0,-31
5083,1,1,230,1820,1590
5084,1,0,98,0,-98
5085,1,0,7,0,-7
5086,0,0,4,0,-4
5087,0,0,30,0,-30
5088,0,0,26,0,-26
5089,1,0,4,0,-4
5090,0,0,5,0,-5
5091,1,0,46,0,-46
5092,1,1,652,1436,784
5093,1,0,94,0,-94
5094,1,0,9,0,-9
5095,0,0,20,0,-20
5096,0,0,18,0,-18
5097,1,1,232,2941,2709
5098,0,0,14,0,-14
5099,1,0,67,0,-67
5100,1,1,782,1376,594
5101,1,0,36,0,-36
5102,1,1,377,1246,869
5103,0,0,115,0,-115
5104,0,0,5,0,-5
5105,1,1,469,1269,800
5106,0,0,21,0,-21
5107,0,0,50,0,-50
5108,1,1,216,1418,1202
5109,0,0,9,0,-9
5110,0,0,15,0,-15
5111,1,1,97,1428,1331
5112,0,0,5,0,-5
5113,0,0,3,0,-3
5114,0,0,8,0,-8
5115,1,1,54,1546,1492
5116,0,0,30,0,-30
5117,0,0,95,0,-95
5118,0,0,18,0,-18
5119,1,1,506,1315,809
5120,0,0,89,0,-89
5121,0,0,89,0,-89
5122,1,1,3313,1480,-1833
5123,1,0,52,0,-52
5124,0,0,46,0,-46
5125,1,0,26,0,-26
5126,1,0,60,0,-60
5127,1,0,8,0,-8
5128,1,0,45,0,-45
5129,1,0,16,0,-16
5130,1,1,536,1282,746
5131,1,1,1243,1279,36
5132,0,0,4,0,-4
5133,1,0,48,0,-48
5134,1,0,32,0,-32
5135,0,0,98,0,-98
5136,1,0,67,0,-67
5137,0,0,32,0,-32
5138,1,0,119,0,-119
5139,1,0,3,0,-3
5140,1,0,39,0,-39
5141,1,1,162,1401,1239
5142,1,0,2,0,-2
5143,0,0,9,0,-9
5144,0,0,0,0,0
5145,0,0,34,0,-34
5146,1,0,5,0,-5
5147,1,1,1427,1531,104
5148,1,1,809,1235,426
5149,1,0,201,0,-201
5150,1,1,365,1940,1575
5151,1,1,420,1319,899
5152,0,0,75,0,-75
5153,1,1,124,1513,1389
5154,1,0,43,0,-43
5155,1,1,393,1309,916
5156,1,1,191,1455,1264
5157,0,0,29,0,-29
5158,1,1,547,2273,1726
5159,1,0,115,0,-115
5160,1,1,1125,1245,120
5161,1,1,38,1322,1284
5162,1,0,18,0,-18
5163,1,0,15,0,-15
5164,0,0,28,0,-28
5165,0,0,13,0,-13
5166,1,1,170,1547,1377
5167,1,0,43,0,-43
5168,0,0,52,0,-52
5169,0,0,91,0,-91
5170,1,0,1,0,-1
5171,1,0,14,0,-14
5172,1,0,59,0,-59
5173,0,0,118,0,-118
5174,1,1,543,1344,801
5175,1,0,5,0,-5
5176,0,0,24,0,-24
5177,1,0,29,0,-29
5178,1,0,48,0,-48
5179,1,1,526,1238,712
5180,0,0,28,0,-28
5181,1,1,21,1491,1470
5182,0,0,90,0,-90
5183,0,0,107,0,-107
5184,1,1,687,2628,1941
5185,1,1,401,1600,1199
5186,0,0,114,0,-114
5187,1,0,51,0,-51
5188,1,0,81,0,-81
5189,1,0,75,0,-75
5190,1,1,366,2352,1986
5191,1,0,69,0,-69
5192,1,0,14,0,-14
5193,1,0,25,0,-25
5194,1,0,39,0,-39
5195,1,0,70,0,-70
5196,1,0,22,0,-22
5197,1,0,110,0,-110
5198,1,1,721,1668,947
5199,0,0,61,0,-61
5200,1,1,690,1940,1250
5201,0,0,101,0,-101
5202,0,0,3,0,-3
5203,1,1,511,1934,1423
5204,1,0,48,0,-48
5205,1,0,83,0,-83
5206,0,0,11,0,-11
5207,0,0,18,0,-18
5208,1,0,105,0,-105
5209,1,0,173,0,-173
5210,1,0,109,0,-109
5211,1,0,14,0,-14
5212,1,0,67,0,-67
5213,0,0,10,0,-10
5214,1,1,298,1281,983
5215,0,0,54,0,-54
5216,1,1,536,1421,885
5217,0,0,3,0,-3
5218,1,0,22,0,-22
5219,1,0,9,0,-9
5220,1,1,535,2198,1663
5221,1,1,1825,1624,-201
5222,1,0,33,0,-33
5223,1,1,270,1317,1047
5224,0,0,1,0,-1
5225,0,0,22,0,-22
5226,0,0,15,0,-15
5227,1,1,429,1480,1051
5228,0,0,157,0,-157
5229,1,0,17,0,-17
5230,0,0,1,0,-1
5231,0,0,28,0,-28
5232,1,1,825,1333,508
5233,1,0,319,0,-319
5234,0,0,30,0,-30
5235,1,1,991,1549,558
5236,0,0,12,0,-12
5237,1,0,29,0,-29
5238,1,0,88,0,-88
5239,1,1,292,1348,1056
5240,1,1,2204,2278,74
5241,1,1,1134,1259,125
5242,1,1,59,1262,1203
5243,0,0,12,0,-12
5244,0,0,14,0,-14
5245,0,0,26,0,-26
5246,0,0,52,0,-52
5247,1,0,241,0,-241
5248,0,0,9,0,-9
5249,1,1,569,1586,1017
5250,1,1,1081,1331,250
5251,0,0,112,0,-112
5252,0,0,22,0,-22
5253,0,0,45,0,-45
5254,1,1,631,1439,808
5255,1,0,40,0,-40
5256,1,0,6,0,-6
5257,1,1,362,2096,1734
5258,1,0,149,0,-149
5259,1,1,343,1528,1185
5260,0,0,22,0,-22
5261,0,0,25,0,-25
5262,1,0,34,0,-34
5263,1,1,2189,1257,-932
5264,1,1,370,1645,1275
5265,0,0,10,0,-10
5266,1,0,16,0,-16
5267,1,1,118,1218,1100
5268,1,1,469,1289,820
5269,1,0,10,0,-10
5270,0,0,53,0,-53
5271,1,1,280,1493,1213
5272,0,0,28,0,-28
5273,1,0,187,0,-187
5274,0,0,14,0,-14
5275,0,0,21,0,-21
5276,0,0,121,0,-121
5277,1,1,77,1284,1207
5278,0,0,37,0,-37
5279,0,0,0,0,0
5280,0,0,0,0,0
5281,1,0,176,0,-176
5282,1,0,37,0,-37
5283,1,0,80,0,-80
5284,0,0,97,0,-97
5285,1,0,65,0,-65
5286,0,0,4,0,-4
5287,0,0,20,0,-20
5288,0,0,9,0,-9
5289,0,0,38,0,-38
5290,0,0,8,0,-8
5291,1,1,46,1393,1347
5292,0,0,37,0,-37
5293,0,0,79,0,-79
5294,0,0,75,0,-75
5295,1,0,60,0,-60
5296,0,0,40,0,-40
5297,0,0,49,0,-49
5298,1,0,20,0,-20
5299,1,0,17,0,-17
5300,0,0,68,0,-68
5301,0,0,33,0,-33
5302,1,0,106,0,-106
5303,0,0,192,0,-192
5304,1,1,572,1387,815
5305,0,0,160,0,-160
5306,1,0,5,0,-5
5307,1,1,632,2994,2362
5308,0,0,97,0,-97
5309,0,0,55,0,-55
5310,0,0,11,0,-11
5311,0,0,6,0,-6
5312,1,0,94,0,-94
5313,1,1,72,1455,1383
5314,1,1,731,1311,580
5315,1,0,59,0,-59
5316,1,0,205,0,-205
5317,0,0,30,0,-30
5318,1,0,22,0,-22
5319,0,0,36,0,-36
5320,1,0,29,0,-29
5321,1,1,449,3260,2811
5322,0,0,68,0,-68
5323,1,1,1177,1295,118
5324,1,0,79,0,-79
5325,1,1,318,1560,1242
5326,0,0,34,0,-34
5327,0,0,23,0,-23
5328,1,0,11,0,-11
5329,0,0,17,0,-17
5330,0,0,3,0,-3
5331,1,0,24,0,-24
5332,1,1,374,1242,868
5333,1,0,25,0,-25
5334,1,0,51,0,-51
5335,1,0,114,0,-114
5336,0,0,135,0,-135
5337,0,0,1,0,-1
5338,0,0,92,0,-92
5339,1,1,227,1211,984
5340,1,0,8,0,-8
5341,0,0,47,0,-47
5342,1,0,16,0,-16
5343,0,0,0,0,0
5344,0,0,8,0,-8
5345,1,1,235,1586,1351
5346,0,0,6,0,-6
5347,1,1,576,1221,645
5348,0,0,43,0,-43
5349,0,0,30,0,-30
5350,1,0,3,0,-3
5351,1,1,24,2276,2252
5352,0,0,176,0,-176
5353,1,0,14,0,-14
5354,1,1,310,1457,1147
5355,0,0,79,0,-79
5356,1,0,85,0,-85
5357,1,0,44,0,-44
5358,1,1,744,3167,2423
5359,1,1,265,1627,1362
5360,1,0,18,0,-18
5361,0,0,46,0,-46
5362,0,0,25,0,-25
5363,1,0,49,0,-49
5364,1,1,187,1897,1710
5365,1,1,109,1208,1099
5366,1,0,27,0,-27
5367,0,0,149,0,-149
5368,0,0,55,0,-55
5369,0,0,38,0,-38
5370,1,0,15,0,-15
5371,1,0,5,0,-5
5372,0,0,65,0,-65
5373,1,1,50,1560,1510
5374,0,0,6,0,-6
5375,0,0,31,0,-31
5376,0,0,78,0,-78
5377,1,0,33,0,-33
5378,1,1,645,2663,2018
5379,1,1,309,1246,937
5380,0,0,5,0,-5
5381,0,0,58,0,-58
5382,0,0,7,0,-7
5383,1,0,107,0,-107
5384,1,1,174,2514,2340
5385,0,0,67,0,-67
5386,0,0,77,0,-77
5387,0,0,0,0,0
5388,0,0,161,0,-161
5389,0,0,220,0,-220
5390,1,1,684,1262,578
5391,1,0,17,0,-17
5392,0,0,40,0,-40
5393,1,0,30,0,-30
5394,0,0,25,0,-25
5395,1,0,41,0,-41
5396,0,0,30,0,-30
5397,1,1,56,1745,1689
5398,1,1,34,1509,1475
5399,1,1,152,1261,1109
5400,1,1,442,1504,1062
5401,0,0,206,0,-206
5402,1,1,466,1628,1162
5403,1,0,42,0,-42
5404,1,1,175,1257,1082
5405,1,0,39,0,-39
5406,1,0,62,0,-62
5407,0,0,3,0,-3
5408,0,0,18,0,-18
5409,1,0,164,0,-164
5410,0,0,87,0,-87
5411,1,1,738,1236,498
5412,1,1,1372,1590,218
5413,0,0,46,0,-46
5414,1,1,233,1541,1308
5415,1,1,218,1287,1069
5416,0,0,18,0,-18
5417,1,0,56,0,-56
5418,0,0,40,0,-40
5419,1,0,148,0,-148
5420,1,0,84,0,-84
5421,1,0,126,0,-126
5422,0,0,7,0,-7
5423,1,0,36,0,-36
5424,1,0,39,0,-39
5425,1,0,33,0,-33
5426,1,1,120,1240,1120
5427,0,0,91,0,-91
5428,1,1,182,2485,2303
5429,1,0,67,0,-67
5430,1,1,569,2174,1605
5431,1,0,17,0,-17
5432,0,0,8,0,-8
5433,1,0,74,0,-74
5434,0,0,40,0,-40
5435,1,1,361,1564,1203
5436,0,0,68,0,-68
5437,1,1,589,1478,889
5438,1,0,422,0,-422
5439,1,1,882,1471,589
5440,0,0,114,0,-114
5441,1,1,502,1488,986
5442,1,1,298,1364,1066
5443,0,0,20,0,-20
5444,0,0,10,0,-10
5445,1,0,74,0,-74
5446,1,1,397,1201,804
5447,1,0,252,0,-252
5448,0,0,36,0,-36
5449,0,0,58,0,-58
5450,0,0,44,0,-44
5451,1,0,11,0,-11
5452,0,0,25,0,-25
5453,1,0,27,0,-27
5454,0,0,162,0,-162
5455,1,0,84,0,-84
5456,0,0,50,0,-50
5457,0,0,13,0,-13
5458,1,1,558,1294,736
5459,1,1,165,1321,1156
5460,1,0,173,0,-173
5461,1,1,123,1210,1087
5462,1,0,17,0,-17
5463,1,1,963,1255,292
5464,0,0,146,0,-146
5465,0,0,205,0,-205
5466,1,0,35,0,-35
5467,1,0,16,0,-16
5468,1,1,1304,1215,-89
5469,0,0,56,0,-56
5470,1,0,39,0,-39
5471,1,0,40,0,-40
5472,0,0,299,0,-299
5473,0,0,73,0,-73
5474,0,0,115,0,-115
5475,0,0,267,0,-267
5476,1,1,410,1210,800
5477,0,0,49,0,-49
5478,0,0,9,0,-9
5479,1,1,508,1412,904
5480,0,0,219,0,-219
5481,1,0,4,0,-4
5482,0,0,39,0,-39
5483,0,0,107,0,-107
5484,1,1,866,1467,601
5485,1,0,19,0,-19
5486,1,0,67,0,-67
5487,1,1,288,1218,930
5488,1,0,11,0,-11
5489,0,0,94,0,-94
5490,1,0,15,0,-15
5491,0,0,1,0,-1
5492,1,1,1252,1260,8
5493,0,0,4,0,-4
5494,1,1,1736,1400,-336
5495,0,0,8,0,-8
5496,1,1,685,1218,533
5497,0,0,31,0,-31
5498,1,1,331,1812,1481
5499,1,0,6,0,-6
5500,1,1,37,1427,1390
5501,1,1,256,1256,1000
5502,0,0,1,0,-1
5503,1,1,166,1586,1420
5504,0,0,128,0,-128
5505,1,0,44,0,-44
5506,1,1,161,1342,1181
5507,0,0,33,0,-33
5508,0,0,56,0,-56
5509,1,1,286,2843,2557
5510,1,1,631,1308,677
5511,1,0,131,0,-131
5512,0,0,114,0,-114
5513,0,0,21,0,-21
5514,0,0,22,0,-22
5515,1,0,19,0,-19
5516,1,1,876,1222,346
5517,0,0,116,0,-116
5518,0,0,6,0,-6
5519,1,1,245,2162,1917
5520,1,0,10,0,-10
5521,1,1,2170,1555,-615
5522,1,0,51,0,-51
5523,1,1,429,1739,1310
5524,1,1,516,1666,1150
5525,1,1,4,1998,1994
5526,1,0,4,0,-4
5527,1,0,120,0,-120
5528,1,0,13,0,-13
5529,0,0,61,0,-61
5530,0,0,153,0,-153
5531,0,0,140,0,-140
5532,0,0,20,0,-20
5533,0,0,87,0,-87
5534,1,0,130,0,-130
5535,1,0,108,0,-108
5536,0,0,40,0,-40
5537,1,0,39,0,-39
5538,0,0,0,0,0
5539,0,0,31,0,-31
5540,1,1,184,1334,1150
5541,0,0,1,0,-1
5542,1,1,744,1317,573
5543,0,0,61,0,-61
5544,1,1,103,2406,2303
5545,0,0,52,0,-52
5546,0,0,53,0,-53
5547,0,0,8,0,-8
5548,1,0,14,0,-14
5549,0,0,2,0,-2
5550,0,0,1,0,-1
5551,1,1,192,1586,1394
5552,1,0,1,0,-1
5553,1,0,50,0,-50
5554,1,1,29,2345,2316
5555,1,1,285,1300,1015
5556,0,0,145,0,-145
5557,1,1,127,1466,1339
5558,0,0,4,0,-4
5559,0,0,15,0,-15
5560,1,1,832,1871,1039
5561,1,0,38,0,-38
5562,1,0,15,0,-15
5563,0,0,41,0,-41
5564,0,0,80,0,-80
5565,1,0,13,0,-13
5566,1,0,29,0,-29
5567,1,0,0,0,0
5568,1,0,77,0,-77
5569,0,0,104,0,-104
5570,0,0,34,0,-34
5571,1,0,1,0,-1
5572,1,0,54,0,-54
5573,1,1,230,1206,976
5574,0,0,3,0,-3
5575,1,0,112,0,-112
5576,1,1,203,1554,1351
5577,1,1,2405,1539,-866
5578,0,0,7,0,-7
5579,0,0,83,0,-83
5580,1,0,62,0,-62
5581,0,0,94,0,-94
5582,1,0,144,0,-144
5583,0,0,45,0,-45
5584,0,0,37,0,-37
5585,1,0,5,0,-5
5586,0,0,30,0,-30
5587,0,0,36,0,-36
5588,1,0,46,0,-46
5589,1,0,2,0,-2
5590,1,1,342,1340,998
5591,0,0,71,0,-71
5592,0,0,82,0,-82
5593,0,0,115,0,-115
5594,0,0,5,0,-5
5595,0,0,148,0,-148
5596,1,1,144,1286,1142
5597,1,1,1063,1394,331
5598,1,1,285,1236,951
5599,1,1,101,1247,1146
5600,0,0,148,0,-148
5601,0,0,50,0,-50
5602,0,0,21,0,-21
5603,1,0,35,0,-35
5604,0,0,18,0,-18
5605,0,0,0,0,0
5606,0,0,39,0,-39
5607,1,0,67,0,-67
5608,1,0,78,0,-78
5609,1,1,791,1659,868
5610,0,0,76,0,-76
5611,1,0,10,0,-10
5612,1,1,1132,1946,814
5613,1,1,82,1209,1127
5614,1,0,1,0,-1
5615,1,0,52,0,-52
5616,1,1,527,2288,1761
5617,0,0,18,0,-18
5618,0,0,12,0,-12
5619,0,0,157,0,-157
5620,0,0,29,0,-29
5621,1,0,66,0,-66
5622,1,1,660,3069,2409
5623,1,1,259,1451,1192
5624,1,0,27,0,-27
5625,1,1,918,1402,484
5626,1,0,42,0,-42
5627,1,1,1655,1888,233
5628,1,0,7,0,-7
5629,1,0,4,0,-4
5630,1,0,68,0,-68
5631,1,1,671,1476,805
5632,1,0,8,0,-8
5633,1,1,530,1730,1200
5634,1,0,30,0,-30
5635,0,0,8,0,-8
5636,0,0,3,0,-3
5637,1,0,13,0,-13
5638,0,0,78,0,-78
5639,0,0,75,0,-75
5640,1,1,142,2036,1894
5641,0,0,106,0,-106
5642,1,0,211,0,-211
5643,1,0,13,0,-13
5644,0,0,33,0,-33
5645,0,0,15,0,-15
5646,1,1,416,1434,1018
5647,1,1,151,1934,1783
5648,0,0,80,0,-80
5649,1,0,46,0,-46
5650,1,0,23,0,-23
5651,0,0,78,0,-78
5652,1,1,142,1339,1197
5653,1,0,21,0,-21
5654,1,1,1461,1399,-62
5655,1,1,957,1794,837
5656,0,0,36,0,-36
5657,1,1,213,1339,1126
5658,1,1,801,1479,678
5659,1,1,743,1459,716
5660,1,1,685,1426,741
5661,1,1,911,1586,675
5662,1,1,1670,1693,23
5663,1,1,567,1285,718
5664,1,1,537,1848,1311
5665,1,0,46,0,-46
5666,0,0,48,0,-48
5667,0,0,18,0,-18
5668,0,0,6,0,-6
5669,0,0,128,0,-128
5670,1,0,160,0,-160
5671,1,0,15,0,-15
5672,1,0,96,0,-96
5673,0,0,82,0,-82
5674,0,0,17,0,-17
5675,0,0,14,0,-14
5676,1,0,65,0,-65
5677,1,1,780,1826,1046
5678,1,1,714,1368,654
5679,1,0,13,0,-13
5680,1,0,25,0,-25
5681,1,0,138,0,-138
5682,1,1,556,1284,728
5683,1,0,1,0,-1
5684,1,0,1,0,-1
5685,1,1,1166,1239,73
5686,0,0,23,0,-23
5687,1,1,433,1463,1030
5688,1,0,13,0,-13
5689,0,0,54,0,-54
5690,0,0,96,0,-96
5691,1,1,845,2893,2048
5692,0,0,61,0,-61
5693,1,0,158,0,-158
5694,1,1,321,1301,980
5695,1,0,5,0,-5
5696,1,1,242,1766,1524
5697,0,0,87,0,-87
5698,1,1,432,1263,831
5699,0,0,1,0,-1
5700,0,0,222,0,-222
5701,1,1,1378,2354,976
5702,0,0,0,0,0
5703,1,0,60,0,-60
5704,1,0,8,0,-8
5705,1,1,450,1248,798
5706,1,0,70,0,-70
5707,0,0,12,0,-12
5708,0,0,27,0,-27
5709,0,0,6,0,-6
5710,1,1,381,1230,849
5711,0,0,46,0,-46
5712,0,0,4,0,-4
5713,0,0,17,0,-17
5714,1,0,48,0,-48
5715,0,0,4,0,-4
5716,0,0,37,0,-37
5717,0,0,25,0,-25
5718,0,0,16,0,-16
5719,1,0,34,0,-34
5720,1,1,2481,1608,-873
5721,0,0,25,0,-25
5722,0,0,87,0,-87
5723,1,0,177,0,-177
5724,1,1,579,1706,1127
5725,1,0,22,0,-22
5726,1,0,2,0,-2
5727,1,1,2283,1320,-963
5728,1,0,18,0,-18
5729,1,1,118,1722,1604
5730,0,0,4,0,-4
5731,0,0,26,0,-26
5732,1,1,602,1200,598
5733,0,0,78,0,-78
5734,1,1,122,2077,1955
5735,1,1,285,1225,940
5736,1,1,245,1966,1721
5737,0,0,5,0,-5
5738,1,1,146,1668,1522
5739,0,0,23,0,-23
5740,1,1,795,1296,501
5741,0,0,18,0,-18
5742,1,1,164,1291,1127
5743,0,0,98,0,-98
5744,1,1,243,1363,1120
5745,1,1,306,1219,913
5746,1,1,526,1249,723
5747,0,0,85,0,-85
5748,0,0,4,0,-4
5749,0,0,21,0,-21
5750,1,0,21,0,-21
5751,0,0,1,0,-1
5752,1,0,24,0,-24
5753,1,1,680,1290,610
5754,1,0,27,0,-27
5755,1,1,888,1851,963
5756,1,1,822,1583,761
5757,0,0,25,0,-25
5758,0,0,51,0,-51
5759,1,1,345,1391,1046
5760,1,1,168,1947,1779
5761,0,0,25,0,-25
5762,0,0,52,0,-52
5763,0,0,2,0,-2
5764,1,1,366,1227,861
5765,1,0,14,0,-14
5766,1,1,299,2042,1743
5767,0,0,103,0,-103
5768,1,0,146,0,-146
5769,0,0,25,0,-25
5770,0,0,57,0,-57
5771,1,1,367,1374,1007
5772,0,0,7,0,-7
5773,1,0,20,0,-20
5774,1,0,64,0,-64
5775,0,0,97,0,-97
5776,1,1,182,1307,1125
5777,1,0,63,0,-63
5778,0,0,10,0,-10
5779,1,0,47,0,-47
5780,1,0,19,0,-19
5781,0,0,38,0,-38
5782,0,0,25,0,-25
5783,1,1,371,1797,1426
5784,1,0,20,0,-20
5785,0,0,163,0,-163
5786,1,0,5,0,-5
5787,1,0,11,0,-11
5788,1,0,38,0,-38
5789,1,0,5,0,-5
5790,1,1,108,1243,1135
5791,0,0,12,0,-12
5792,1,1,565,1882,1317
5793,0,0,30,0,-30
5794,1,1,248,1302,1054
5795,1,0,68,0,-68
5796,0,0,28,0,-28
5797,1,0,150,0,-150
5798,1,0,8,0,-8
5799,0,0,37,0,-37
5800,0,0,18,0,-18
5801,1,1,274,1607,1333
5802,0,0,88,0,-88
5803,0,0,22,0,-22
5804,0,0,14,0,-14
5805,1,1,345,1457,1112
5806,1,1,176,1468,1292
5807,0,0,79,0,-79
5808,1,0,46,0,-46
5809,1,0,29,0,-29
5810,1,1,779,1756,977
5811,1,1,96,2294,2198
5812,0,0,35,0,-35
5813,0,0,27,0,-27
5814,0,0,16,0,-16
5815,1,0,32,0,-32
5816,1,0,49,0,-49
5817,1,0,118,0,-118
5818,1,1,859,1274,415
5819,1,1,507,1713,1206
5820,1,1,71,1299,1228
5821,1,0,54,0,-54
5822,1,1,129,1414,1285
5823,0,0,81,0,-81
5824,0,0,41,0,-41
5825,0,0,3,0,-3
5826,1,1,504,2013,1509
5827,0,0,55,0,-55
5828,1,0,5,0,-5
5829,1,1,416,1358,942
5830,1,0,150,0,-150
5831,1,0,68,0,-68
5832,0,0,7,0,-7
5833,1,0,18,0,-18
5834,0,0,12,0,-12
5835,1,1,1189,1621,432
5836,0,0,28,0,-28
5837,0,0,64,0,-64
5838,1,1,122,1608,1486
5839,1,0,65,0,-65
5840,1,0,57,0,-57
5841,0,0,75,0,-75
5842,1,1,168,1330,1162
5843,1,1,358,1523,1165
5844,1,1,416,1264,848
5845,1,1,233,1301,1068
5846,1,0,52,0,-52
5847,0,0,55,0,-55
5848,1,0,89,0,-89
5849,0,0,36,0,-36
5850,0,0,22,0,-22
5851,1,1,184,1469,1285
5852,0,0,105,0,-105
5853,0,0,19,0,-19
5854,0,0,79,0,-79
5855,1,0,0,0,0
5856,0,0,4,0,-4
5857,0,0,7,0,-7
5858,0,0,95,0,-95
5859,0,0,32,0,-32
5860,1,0,11,0,-11
5861,1,1,147,1412,1265
5862,1,0,121,0,-121
5863,0,0,64,0,-64
5864,1,0,249,0,-249
5865,1,0,21,0,-21
5866,1,0,15,0,-15
5867,1,1,642,1250,608
5868,1,0,131,0,-131
5869,0,0,112,0,-112
5870,1,0,41,0,-41
5871,1,1,298,2514,2216
5872,0,0,101,0,-101
5873,1,1,111,1632,1521
5874,1,0,95,0,-95
5875,1,0,22,0,-22
5876,1,0,7,0,-7
5877,1,1,1227,1220,-7
5878,1,1,305,1738,1433
5879,1,0,40,0,-40
5880,1,1,683,1849,1166
5881,1,1,717,2740,2023
5882,1,0,66,0,-66
5883,1,1,235,1306,1071
5884,0,0,42,0,-42
5885,1,1,280,1244,964
5886,1,1,363,1486,1123
5887,1,0,33,0,-33
5888,0,0,32,0,-32
5889,1,1,531,2375,1844
5890,1,0,65,0,-65
5891,0,0,221,0,-221
5892,1,0,60,0,-60
5893,0,0,40,0,-40
5894,0,0,44,0,-44
5895,1,1,339,1905,1566
5896,1,1,105,2110,2005
5897,1,1,554,1241,687
5898,1,0,59,0,-59
5899,1,0,85,0,-85
5900,0,0,71,0,-71
5901,0,0,5,0,-5
5902,1,1,749,1416,667
5903,0,0,3,0,-3
5904,0,0,114,0,-114
5905,0,0,80,0,-80
5906,1,0,31,0,-31
5907,1,1,126,1275,1149
5908,0,0,42,0,-42
5909,0,0,18,0,-18
5910,0,0,7,0,-7
5911,1,0,29,0,-29
5912,1,1,2256,1405,-851
5913,0,0,15,0,-15
5914,1,0,9,0,-9
5915,1,1,201,1714,1513
5916,0,0,8,0,-8
5917,0,0,43,0,-43
5918,1,1,192,1584,1392
5919,0,0,2,0,-2
5920,1,0,69,0,-69
5921,1,0,26,0,-26
5922,0,0,197,0,-197
5923,0,0,41,0,-41
5924,1,0,50,0,-50
5925,1,1,719,1411,692
5926,1,1,1496,1428,-68
5927,1,0,8,0,-8
5928,1,0,40,0,-40
5929,0,0,8,0,-8
5930,0,0,1,0,-1
5931,0,0,6,0,-6
5932,1,1,833,1716,883
5933,0,0,13,0,-13
5934,0,0,24,0,-24
5935,1,1,58,1811,1753
5936,1,1,545,1565,1020
5937,1,1,119,2489,2370
5938,1,0,17,0,-17
5939,1,1,670,1355,685
5940,0,0,88,0,-88
5941,1,0,108,0,-108
5942,1,0,92,0,-92
5943,1,0,90,0,-90
5944,1,1,215,1453,1238
5945,1,1,568,1575,1007
5946,1,0,104,0,-104
5947,0,0,48,0,-48
5948,0,0,136,0,-136
5949,1,0,21,0,-21
5950,1,0,22,0,-22
5951,1,1,298,2251,1953
5952,1,0,38,0,-38
5953,0,0,100,0,-100
5954,0,0,147,0,-147
5955,1,1,505,1423,918
5956,0,0,32,0,-32
5957,0,0,25,0,-25
5958,0,0,77,0,-77
5959,0,0,52,0,-52
5960,0,0,37,0,-37
5961,1,0,85,0,-85
5962,1,0,86,0,-86
5963,0,0,25,0,-25
5964,0,0,2,0,-2
5965,0,0,20,0,-20
5966,1,1,29,1247,1218
5967,0,0,8,0,-8
5968,1,0,152,0,-152
5969,1,0,9,0,-9
5970,1,0,136,0,-136
5971,0,0,113,0,-113
5972,1,1,478,3351,2873
5973,1,1,443,1383,940
5974,1,0,78,0,-78
5975,0,0,240,0,-240
5976,1,1,460,1428,968
5977,0,0,13,0,-13
5978,0,0,16,0,-16
5979,0,0,51,0,-51
5980,1,0,15,0,-15
5981,1,1,510,1597,1087
5982,1,0,16,0,-16
5983,0,0,25,0,-25
5984,1,1,133,1254,1121
5985,0,0,42,0,-42
5986,0,0,10,0,-10
5987,1,0,2,0,-2
5988,0,0,77,0,-77
5989,1,1,673,1223,550
5990,0,0,53,0,-53
5991,0,0,12,0,-12
5992,1,0,75,0,-75
5993,0,0,8,0,-8
5994,1,0,9,0,-9
5995,1,1,66,1874,1808
5996,0,0,170,0,-170
5997,1,0,42,0,-42
5998,1,1,1178,1671,493
5999,0,0,0,0,0
6000,1,0,43,0,-43
6001,1,1,834,1272,438
6002,1,1,224,1365,1141
6003,0,0,35,0,-35
6004,0,0,21,0,-21
6005,0,0,29,0,-29
6006,1,1,352,1272,920
6007,0,0,19,0,-19
6008,0,0,36,0,-36
6009,1,1,1113,1349,236
6010,1,0,2,0,-2
6011,0,0,5,0,-5
6012,0,0,106,0,-106
6013,0,0,6,0,-6
6014,1,1,456,1365,909
6015,1,0,31,0,-31
6016,1,0,31,0,-31
6017,0,0,30,0,-30
6018,0,0,13,0,-13
6019,1,0,89,0,-89
6020,1,1,154,1401,1247
6021,1,0,6,0,-6
6022,1,0,45,0,-45
6023,0,0,7,0,-7
6024,1,1,39,1752,1713
6025,0,0,7,0,-7
6026,0,0,58,0,-58
6027,1,1,119,1686,1567
6028,1,0,13,0,-13
6029,0,0,35,0,-35
6030,1,0,55,0,-55
6031,1,1,147,1369,1222
6032,1,1,1696,1277,-419
6033,0,0,20,0,-20
6034,1,1,1613,1886,273
6035,1,1,711,1603,892
6036,1,1,365,1247,882
6037,0,0,37,0,-37
6038,1,1,195,1216,1021
6039,1,1,155,1275,1120
6040,1,0,4,0,-4
6041,0,0,63,0,-63
6042,1,1,659,1851,1192
6043,1,0,133,0,-133
6044,1,0,13,0,-13
6045,0,0,54,0,-54
6046,1,0,17,0,-17
6047,1,0,19,0,-19
6048,0,0,46,0,-46
6049,1,0,18,0,-18
6050,1,1,318,1236,918
6051,1,0,3,0,-3
6052,0,0,3,0,-3
6053,1,1,1218,3171,1953
6054,1,0,12,0,-12
6055,1,0,11,0,-11
6056,1,0,102,0,-102
6057,0,0,23,0,-23
6058,1,1,507,1400,893
6059,0,0,3,0,-3
6060,0,0,19,0,-19
6061,0,0,32,0,-32
6062,1,1,700,1564,864
6063,1,0,52,0,-52
6064,1,1,146,1630,1484
6065,0,0,237,0,-237
6066,0,0,108,0,-108
6067,0,0,87,0,-87
6068,0,0,0,0,0
6069,1,0,11,0,-11
6070,0,0,39,0,-39
6071,1,0,37,0,-37
6072,0,0,5,0,-5
6073,0,0,58,0,-58
6074,0,0,2,0,-2
6075,0,0,46,0,-46
6076,0,0,1,0,-1
6077,0,0,0,0,0
6078,0,0,6,0,-6
6079,0,0,45,0,-45
6080,0,0,22,0,-22
6081,1,1,212,1344,1132
6082,1,0,139,0,-139
6083,1,1,138,1690,1552
6084,1,0,36,0,-36
6085,1,1,242,2254,2012
6086,0,0,127,0,-127
6087,1,1,1413,1247,-166
6088,0,0,80,0,-80
6089,0,0,159,0,-159
6090,1,1,228,1540,1312
6091,0,0,51,0,-51
6092,0,0,74,0,-74
6093,1,0,39,0,-39
6094,1,1,866,1230,364
6095,1,1,1404,3296,1892
6096,0,0,27,0,-27
6097,0,0,44,0,-44
6098,0,0,107,0,-107
6099,1,1,51,1230,1179
6100,1,0,209,0,-209
6101,1,1,38,1723,1685
6102,0,0,21,0,-21
6103,0,0,44,0,-44
6104,0,0,86,0,-86
6105,0,0,13,0,-13
6106,0,0,39,0,-39
6107,0,0,18,0,-18
6108,1,0,7,0,-7
6109,0,0,30,0,-30
6110,1,1,211,1912,1701
6111,1,1,1377,1507,130
6112,1,1,1094,1538,444
6113,1,0,0,0,0
6114,1,1,238,1214,976
6115,1,1,863,1249,386
6116,1,0,18,0,-18
6117,0,0,38,0,-38
6118,1,1,257,1288,1031
6119,1,0,29,0,-29
6120,1,1,453,1838,1385
6121,0,0,51,0,-51
6122,0,0,29,0,-29
6123,1,1,380,1209,829
6124,0,0,18,0,-18
6125,0,0,63,0,-63
6126,0,0,166,0,-166
6127,1,0,20,0,-20
6128,1,1,696,1315,619
6129,1,0,4,0,-4
6130,1,0,36,0,-36
6131,1,0,40,0,-40
6132,1,1,556,1456,900
6133,0,0,68,0,-68
6134,1,1,2980,1399,-1581
6135,0,0,82,0,-82
6136,1,0,86,0,-86
6137,0,0,125,0,-125
6138,0,0,34,0,-34
6139,1,0,4,0,-4
6140,1,0,39,0,-39
6141,1,1,452,1609,1157
6142,1,0,223,0,-223
6143,1,1,1276,1459,183
6144,0,0,169,0,-169
6145,1,0,18,0,-18
6146,0,0,26,0,-26
6147,0,0,57,0,-57
6148,1,1,949,1328,379
6149,1,0,5,0,-5
6150,1,0,56,0,-56
6151,1,0,107,0,-107
6152,0,0,44,0,-44
6153,1,1,140,1400,1260
6154,0,0,125,0,-125
6155,1,1,66,1272,1206
6156,1,0,29,0,-29
6157,0,0,33,0,-33
6158,1,0,12,0,-12
6159,0,0,6,0,-6
6160,0,0,28,0,-28
6161,1,1,30,1300,1270
6162,1,0,20,0,-20
6163,1,0,4,0,-4
6164,1,0,84,0,-84
6165,1,0,66,0,-66
6166,1,1,787,1296,509
6167,0,0,81,0,-81
6168,1,1,1316,1279,-37
6169,1,1,697,1547,850
6170,1,0,110,0,-110
6171,0,0,109,0,-109
6172,1,0,48,0,-48
6173,1,0,25,0,-25
6174,1,1,292,1284,992
6175,1,1,600,1626,1026
6176,1,1,738,1334,596
6177,0,0,40,0,-40
6178,0,0,76,0,-76
6179,1,1,209,1481,1272
6180,0,0,47,0,-47
6181,0,0,3,0,-3
6182,1,1,221,1905,1684
6183,0,0,248,0,-248
6184,1,1,157,2548,2391
6185,1,0,2,0,-2
6186,0,0,143,0,-143
6187,0,0,71,0,-71
6188,0,0,27,0,-27
6189,1,0,39,0,-39
6190,1,1,726,1215,489
6191,1,1,1128,1452,324
6192,1,1,1336,1348,12
6193,1,1,1071,1223,152
6194,0,0,29,0,-29
6195,1,0,97,0,-97
6196,0,0,33,0,-33
6197,1,0,43,0,-43
6198,1,1,346,1592,1246
6199,0,0,6,0,-6
6200,1,0,28,0,-28
6201,0,0,58,0,-58
6202,0,0,17,0,-17
6203,0,0,90,0,-90
6204,1,0,62,0,-62
6205,1,1,1038,1597,559
6206,0,0,167,0,-167
6207,0,0,39,0,-39
6208,1,1,253,1265,1012
6209,1,0,58,0,-58
6210,1,1,423,1419,996
6211,1,0,82,0,-82
6212,1,1,1074,1319,245
6213,0,0,24,0,-24
6214,1,1,566,1511,945
6215,0,0,136,0,-136
6216,1,0,50,0,-50
6217,0,0,112,0,-112
6218,1,0,23,0,-23
6219,1,0,29,0,-29
6220,1,1,77,1258,1181
6221,1,1,595,1351,756
6222,0,0,7,0,-7
6223,0,0,4,0,-4
6224,0,0,30,0,-30
6225,0,0,36,0,-36
6226,1,1,433,1352,919
6227,0,0,38,0,-38
6228,0,0,14,0,-14
6229,0,0,32,0,-32
6230,0,0,0,0,0
6231,1,0,52,0,-52
6232,1,0,31,0,-31
6233,0,0,203,0,-203
6234,1,1,1345,1249,-96
6235,1,0,39,0,-39
6236,0,0,105,0,-105
6237,0,0,12,0,-12
6238,1,1,1547,1265,-282
6239,1,1,827,2415,1588
6240,1,0,91,0,-91
6241,1,0,58,0,-58
6242,1,1,63,1357,1294
6243,0,0,3,0,-3
6244,1,1,485,1384,899
6245,0,0,7,0,-7
6246,1,1,2638,2394,-244
6247,0,0,0,0,0
6248,1,1,9,2294,2285
6249,1,1,481,2420,1939
6250,1,1,309,1721,1412
6251,1,1,1221,2158,937
6252,1,0,149,0,-149
6253,0,0,3,0,-3
6254,1,0,90,0,-90
6255,1,1,130,1364,1234
6256,0,0,69,0,-69
6257,0,0,26,0,-26
6258,1,1,146,1398,1252
6259,1,1,153,1241,1088
6260,0,0,101,0,-101
6261,0,0,71,0,-71
6262,1,0,21,0,-21
6263,0,0,133,0,-133
6264,1,1,370,1514,1144
6265,1,0,49,0,-49
6266,0,0,51,0,-51
6267,1,0,339,0,-339
6268,0,0,46,0,-46
6269,0,0,101,0,-101
6270,1,1,286,2709,2423
6271,1,0,86,0,-86
6272,1,1,159,1587,1428
6273,1,0,7,0,-7
6274,1,0,114,0,-114
6275,1,1,103,1245,1142
6276,1,0,25,0,-25
6277,1,0,5,0,-5
6278,0,0,7,0,-7
6279,1,1,132,1649,1517
6280,1,0,197,0,-197
6281,1,1,143,1250,1107
6282,1,1,666,1544,878
6283,1,0,50,0,-50
6284,1,0,12,0,-12
6285,1,1,270,1291,1021
6286,1,0,109,0,-109
6287,0,0,75,0,-75
6288,1,1,828,1544,716
6289,0,0,20,0,-20
6290,0,0,72,0,-72
6291,1,0,10,0,-10
6292,0,0,37,0,-37
6293,1,1,258,2451,2193
6294,0,0,24,0,-24
6295,1,1,169,1662,1493
6296,0,0,37,0,-37
6297,1,1,1192,1658,466
6298,0,0,97,0,-97
6299,0,0,15,0,-15
6300,1,1,710,1302,592
6301,0,0,23,0,-23
6302,0,0,164,0,-164
6303,1,1,749,1437,688
6304,1,1,657,1277,620
6305,0,0,3,0,-3
6306,0,0,217,0,-217
6307,1,0,8,0,-8
6308,0,0,239,0,-239
6309,1,0,46,0,-46
6310,1,0,217,0,-217
6311,1,0,6,0,-6
6312,1,0,86,0,-86
6313,1,0,43,0,-43
6314,0,0,7,0,-7
6315,1,1,433,1577,1144
6316,1,1,1672,1258,-414
6317,0,0,140,0,-140
6318,1,1,619,1308,689
6319,1,0,135,0,-135
6320,0,0,1,0,-1
6321,0,0,8,0,-8
6322,0,0,36,0,-36
6323,1,0,7,0,-7
6324,1,0,45,0,-45
6325,0,0,125,0,-125
6326,0,0,53,0,-53
6327,0,0,3,0,-3
6328,0,0,35,0,-35
6329,1,1,1250,1208,-42
6330,0,0,61,0,-61
6331,0,0,94,0,-94
6332,0,0,23,0,-23
6333,0,0,47,0,-47
6334,0,0,4,0,-4
6335,1,1,48,1876,1828
6336,1,1,347,1412,1065
6337,0,0,253,0,-253
6338,1,0,11,0,-11
6339,1,0,143,0,-143
6340,1,1,198,1364,1166
6341,1,0,37,0,-37
6342,1,0,8,0,-8
6343,1,0,43,0,-43
6344,0,0,9,0,-9
6345,0,0,62,0,-62
6346,0,0,16,0,-16
6347,0,0,6,0,-6
6348,1,0,6,0,-6
6349,0,0,69,0,-69
6350,1,0,103,0,-103
6351,1,0,40,0,-40
6352,1,1,951,1272,321
6353,1,0,31,0,-31
6354,1,1,283,1373,1090
6355,0,0,72,0,-72
6356,1,1,485,1447,962
6357,1,1,148,2858,2710
6358,1,0,135,0,-135
6359,1,0,136,0,-136
6360,0,0,68,0,-68
6361,0,0,4,0,-4
6362,1,1,781,1371,590
6363,0,0,25,0,-25
6364,0,0,11,0,-11
6365,1,1,1016,1243,227
6366,1,1,385,1349,964
6367,0,0,113,0,-113
6368,1,1,740,2586,1846
6369,0,0,10,0,-10
6370,1,0,38,0,-38
6371,0,0,3,0,-3
6372,1,1,661,1423,762
6373,0,0,48,0,-48
6374,1,0,92,0,-92
6375,1,0,89,0,-89
6376,1,0,37,0,-37
6377,1,1,201,1962,1761
6378,1,0,13,0,-13
6379,1,1,271,1372,1101
6380,1,0,11,0,-11
6381,1,1,910,1877,967
6382,0,0,81,0,-81
6383,1,0,56,0,-56
6384,1,0,8,0,-8
6385,1,1,521,1235,714
6386,1,0,149,0,-149
6387,1,0,3,0,-3
6388,0,0,11,0,-11
6389,0,0,29,0,-29
6390,1,0,2,0,-2
6391,1,1,511,1685,1174
6392,1,1,762,1277,515
6393,1,0,19,0,-19
6394,0,0,103,0,-103
6395,0,0,25,0,-25
6396,0,0,79,0,-79
6397,0,0,9,0,-9
6398,1,1,1083,1350,267
6399,0,0,49,0,-49
6400,0,0,15,0,-15
6401,1,0,121,0,-121
6402,0,0,86,0,-86
6403,1,1,584,1984,1400
6404,1,0,73,0,-73
6405,1,0,80,0,-80
6406,1,0,0,0,0
6407,1,0,53,0,-53
6408,1,0,32,0,-32
6409,0,0,42,0,-42
6410,1,1,267,1654,1387
6411,1,1,998,1205,207
6412,1,0,126,0,-126
6413,1,1,235,1468,1233
6414,1,1,131,1236,1105
6415,0,0,30,0,-30
6416,1,0,1,0,-1
6417,1,0,41,0,-41
6418,0,0,30,0,-30
6419,1,1,694,1334,640
6420,1,1,1599,1720,121
6421,1,1,577,1213,636
6422,1,1,521,1792,1271
6423,1,1,64,1201,1137
6424,1,0,0,0,0
6425,0,0,76,0,-76
6426,1,1,644,2338,1694
6427,0,0,15,0,-15
6428,1,1,581,1200,619
6429,1,0,7,0,-7
6430,1,1,16,1203,1187
6431,1,1,758,1351,593
6432,1,1,101,2033,1932
6433,1,1,638,1274,636
6434,0,0,25,0,-25
6435,1,0,48,0,-48
6436,1,1,307,1629,1322
6437,0,0,7,0,-7
6438,0,0,2,0,-2
6439,1,0,38,0,-38
6440,1,1,236,1235,999
6441,0,0,24,0,-24
6442,0,0,12,0,-12
6443,1,0,70,0,-70
6444,0,0,21,0,-21
6445,0,0,22,0,-22
6446,1,0,86,0,-86
6447,0,0,63,0,-63
6448,0,0,42,0,-42
6449,1,0,22,0,-22
6450,0,0,29,0,-29
6451,1,1,929,1301,372
6452,0,0,31,0,-31
6453,1,0,248,0,-248
6454,0,0,32,0,-32
6455,1,0,93,0,-93
6456,1,1,486,1313,827
6457,1,1,41,1800,1759
6458,0,0,116,0,-116
6459,1,1,811,1287,476
6460,0,0,4,0,-4
6461,0,0,18,0,-18
6462,0,0,47,0,-47
6463,1,0,102,0,-102
6464,0,0,75,0,-75
6465,1,0,78,0,-78
6466,1,0,73,0,-73
6467,1,1,683,2080,1397
6468,0,0,94,0,-94
6469,1,1,103,1448,1345
6470,1,1,104,1721,1617
6471,1,0,103,0,-103
6472,1,0,10,0,-10
6473,0,0,112,0,-112
6474,1,0,11,0,-11
6475,1,0,1,0,-1
6476,0,0,8,0,-8
6477,1,0,17,0,-17
6478,0,0,47,0,-47
6479,0,0,6,0,-6
6480,1,1,1257,1502,245
6481,1,0,37,0,-37
6482,1,0,0,0,0
6483,0,0,126,0,-126
6484,1,0,5,0,-5
6485,1,1,127,1214,1087
6486,0,0,96,0,-96
6487,1,1,270,3992,3722
6488,1,0,23,0,-23
6489,1,1,1511,1313,-198
6490,1,0,118,0,-118
6491,1,0,18,0,-18
6492,0,0,30,0,-30
6493,1,0,21,0,-21
6494,1,1,346,1346,1000
6495,1,0,57,0,-57
6496,1,0,36,0,-36
6497,1,0,39,0,-39
6498,1,1,654,1334,680
6499,1,1,697,1343,646
6500,1,1,784,4238,3454
6501,1,0,13,0,-13
6502,0,0,18,0,-18
6503,1,1,674,1250,576
6504,1,0,205,0,-205
6505,0,0,42,0,-42
6506,1,0,0,0,0
6507,0,0,73,0,-73
6508,1,0,28,0,-28
6509,0,0,63,0,-63
6510,1,1,222,1656,1434
6511,0,0,164,0,-164
6512,1,0,253,0,-253
6513,0,0,42,0,-42
6514,1,1,54,1314,1260
6515,1,0,22,0,-22
6516,1,0,29,0,-29
6517,0,0,85,0,-85
6518,1,1,268,1227,959
6519,1,0,31,0,-31
6520,1,1,252,1296,1044
6521,0,0,11,0,-11
6522,0,0,43,0,-43
6523,0,0,16,0,-16
6524,0,0,69,0,-69
6525,1,1,385,1963,1578
6526,0,0,111,0,-111
6527,1,1,552,1461,909
6528,1,0,81,0,-81
6529,1,0,14,0,-14
6530,1,0,6,0,-6
6531,1,0,48,0,-48
6532,1,1,424,1317,893
6533,1,1,191,1338,1147
6534,0,0,33,0,-33
6535,0,0,42,0,-42
6536,1,1,576,2630,2054
6537,1,1,1280,1209,-71
6538,0,0,44,0,-44
6539,1,0,51,0,-51
6540,1,0,41,0,-41
6541,1,0,49,0,-49
6542,1,1,1496,1865,369
6543,1,1,215,1395,1180
6544,0,0,3,0,-3
6545,1,0,18,0,-18
6546,0,0,42,0,-42
6547,1,0,10,0,-10
6548,0,0,3,0,-3
6549,0,0,31,0,-31
6550,0,0,0,0,0
6551,0,0,19,0,-19
6552,0,0,6,0,-6
6553,0,0,23,0,-23
6554,1,1,971,2153,1182
6555,0,0,15,0,-15
6556,0,0,8,0,-8
6557,1,0,28,0,-28
6558,0,0,53,0,-53
6559,0,0,170,0,-170
6560,0,0,106,0,-106
6561,0,0,171,0,-171
6562,0,0,19,0,-19
6563,0,0,15,0,-15
6564,1,0,32,0,-32
6565,0,0,60,0,-60
6566,1,0,61,0,-61
6567,0,0,27,0,-27
6568,1,0,6,0,-6
6569,1,0,122,0,-122
6570,1,1,2085,1679,-406
6571,1,1,81,1408,1327
6572,0,0,97,0,-97
6573,0,0,16,0,-16
6574,0,0,17,0,-17
6575,0,0,48,0,-48
6576,0,0,200,0,-200
6577,0,0,5,0,-5
6578,1,1,1892,1360,-532
6579,0,0,11,0,-11
6580,1,1,33,1239,1206
6581,1,0,6,0,-6
6582,1,0,46,0,-46
6583,1,0,127,0,-127
6584,0,0,1,0,-1
6585,1,0,1,0,-1
6586,1,0,41,0,-41
6587,1,1,701,1269,568
6588,1,1,246,1526,1280
6589,1,0,17,0,-17
6590,0,0,49,0,-49
6591,0,0,31,0,-31
6592,0,0,28,0,-28
6593,1,0,82,0,-82
6594,0,0,3,0,-3
6595,0,0,30,0,-30
6596,1,1,87,1211,1124
6597,1,1,1152,1215,63
6598,1,1,276,1687,1411
6599,0,0,18,0,-18
6600,1,0,49,0,-49
6601,1,0,29,0,-29
6602,0,0,77,0,-77
6603,0,0,8,0,-8
6604,1,1,447,1647,1200
6605,0,0,30,0,-30
6606,1,1,276,1291,1015
6607,1,1,1005,1290,285
6608,0,0,37,0,-37
6609,0,0,50,0,-50
6610,0,0,166,0,-166
6611,0,0,9,0,-9
6612,1,0,21,0,-21
6613,0,0,79,0,-79
6614,0,0,39,0,-39
6615,1,0,16,0,-16
6616,0,0,86,0,-86
6617,0,0,21,0,-21
6618,1,0,94,0,-94
6619,0,0,48,0,-48
6620,0,0,23,0,-23
6621,1,0,2,0,-2
6622,1,1,122,1366,1244
6623,0,0,8,0,-8
6624,0,0,92,0,-92
6625,0,0,46,0,-46
6626,1,1,227,1540,1313
6627,1,1,30,2015,1985
6628,0,0,22,0,-22
6629,0,0,37,0,-37
6630,1,1,106,1202,1096
6631,1,0,2,0,-2
6632,0,0,16,0,-16
6633,1,1,176,1248,1072
6634,0,0,59,0,-59
6635,0,0,26,0,-26
6636,1,1,271,2156,1885
6637,1,1,131,1466,1335
6638,1,0,48,0,-48
6639,0,0,45,0,-45
6640,1,0,10,0,-10
6641,1,1,120,1495,1375
6642,1,1,102,1530,1428
6643,1,1,1024,1354,330
6644,0,0,8,0,-8
6645,1,1,937,1298,361
6646,1,1,643,1257,614
6647,0,0,102,0,-102
6648,1,0,3,0,-3
6649,1,0,137,0,-137
6650,0,0,11,0,-11
6651,1,1,1501,1908,407
6652,1,0,1,0,-1
6653,1,0,64,0,-64
6654,0,0,8,0,-8
6655,0,0,52,0,-52
6656,1,1,302,1441,1139
6657,1,1,679,1317,638
6658,1,0,100,0,-100
6659,1,1,76,2400,2324
6660,0,0,57,0,-57
6661,0,0,74,0,-74
6662,1,1,763,1342,579
6663,0,0,20,0,-20
6664,0,0,60,0,-60
6665,1,0,3,0,-3
6666,1,1,757,1204,447
6667,0,0,34,0,-34
6668,0,0,116,0,-116
6669,0,0,48,0,-48
6670,1,0,20,0,-20
6671,1,1,367,1757,1390
6672,1,0,111,0,-111
6673,0,0,46,0,-46
6674,1,1,348,1426,1078
6675,1,0,18,0,-18
6676,1,0,23,0,-23
6677,1,1,266,1292,1026
6678,1,1,135,1380,1245
6679,0,0,23,0,-23
6680,0,0,60,0,-60
6681,0,0,49,0,-49
6682,1,0,5,0,-5
6683,0,0,6,0,-6
6684,1,1,222,4704,4482
6685,1,1,84,1352,1268
6686,1,0,63,0,-63
6687,1,1,114,1301,1187
6688,1,1,720,1377,657
6689,0,0,61,0,-61
6690,0,0,13,0,-13
6691,0,0,1,0,-1
6692,1,1,338,1275,937
6693,0,0,57,0,-57
6694,1,0,81,0,-81
6695,0,0,27,0,-27
6696,0,0,51,0,-51
6697,1,0,9,0,-9
6698,0,0,23,0,-23
6699,1,1,811,1373,562
6700,0,0,19,0,-19
6701,1,0,87,0,-87
6702,1,0,203,0,-203
6703,1,1,225,1718,1493
6704,1,0,55,0,-55
6705,1,1,2248,1601,-647
6706,0,0,14,0,-14
6707,1,1,55,1343,1288
6708,0,0,114,0,-114
6709,0,0,128,0,-128
6710,0,0,82,0,-82
6711,0,0,195,0,-195
6712,0,0,7,0,-7
6713,1,1,114,1867,1753
6714,1,1,35,1715,1680
6715,0,0,2,0,-2
6716,1,1,199,1336,1137
6717,1,1,292,1247,955
6718,1,0,35,0,-35
6719,0,0,113,0,-113
6720,0,0,43,0,-43
6721,0,0,13,0,-13
6722,0,0,14,0,-14
6723,0,0,5,0,-5
6724,1,1,226,1200,974
6725,1,1,103,2472,2369
6726,0,0,1,0,-1
6727,0,0,14,0,-14
6728,1,1,1704,1450,-254
6729,1,1,46,1555,1509
6730,1,0,64,0,-64
6731,0,0,85,0,-85
6732,1,1,264,1206,942
6733,0,0,155,0,-155
6734,1,1,156,1332,1176
6735,1,1,1170,1772,602
6736,1,1,61,1960,1899
6737,0,0,65,0,-65
6738,1,1,466,1611,1145
6739,1,1,134,1227,1093
6740,0,0,12,0,-12
6741,1,1,50,1605,1555
6742,0,0,55,0,-55
6743,1,1,216,1327,1111
6744,0,0,9,0,-9
6745,0,0,14,0,-14
6746,1,0,5,0,-5
6747,1,1,1230,1443,213
6748,0,0,33,0,-33
6749,0,0,52,0,-52
6750,0,0,3,0,-3
6751,1,1,864,1402,538
6752,1,1,243,1285,1042
6753,1,1,85,1669,1584
6754,1,0,118,0,-118
6755,1,0,54,0,-54
6756,1,0,66,0,-66
6757,1,1,835,1235,400
6758,1,0,5,0,-5
6759,0,0,6,0,-6
6760,1,1,188,1275,1087
6761,0,0,12,0,-12
6762,1,1,168,2830,2662
6763,0,0,5,0,-5
6764,1,0,24,0,-24
6765,1,1,967,1964,997
6766,1,1,100,1208,1108
6767,1,1,588,1712,1124
6768,0,0,4,0,-4
6769,0,0,47,0,-47
6770,0,0,3,0,-3
6771,0,0,114,0,-114
6772,0,0,38,0,-38
6773,0,0,26,0,-26
6774,1,1,156,1367,1211
6775,1,0,80,0,-80
6776,0,0,141,0,-141
6777,0,0,10,0,-10
6778,0,0,153,0,-153
6779,1,0,76,0,-76
6780,1,0,94,0,-94
6781,1,1,334,1230,896
6782,1,0,31,0,-31
6783,1,0,24,0,-24
6784,1,0,21,0,-21
6785,0,0,5,0,-5
6786,1,0,0,0,0
6787,0,0,18,0,-18
6788,1,1,482,1530,1048
6789,1,1,137,1226,1089
6790,0,0,22,0,-22
6791,1,1,96,8605,8509
6792,1,0,25,0,-25
6793,1,1,818,1205,387
6794,1,0,142,0,-142
6795,0,0,7,0,-7
6796,0,0,41,0,-41
6797,1,1,481,1287,806
6798,1,1,660,1328,668
6799,0,0,1,0,-1
6800,1,0,68,0,-68
6801,1,0,12,0,-12
6802,0,0,2,0,-2
6803,1,0,29,0,-29
6804,0,0,57,0,-57
6805,1,0,18,0,-18
6806,0,0,3,0,-3
6807,1,0,34,0,-34
6808,1,1,220,1996,1776
6809,0,0,48,0,-48
6810,1,0,74,0,-74
6811,1,0,59,0,-59
6812,1,1,49,2257,2208
6813,1,1,250,1972,1722
6814,1,1,1556,1519,-37
6815,0,0,5,0,-5
6816,1,0,247,0,-247
6817,0,0,36,0,-36
6818,1,0,7,0,-7
6819,0,0,0,0,0
6820,1,1,950,1258,308
6821,0,0,0,0,0
6822,1,1,55,1351,1296
6823,1,1,680,1372,692
6824,0,0,44,0,-44
6825,1,0,24,0,-24
6826,1,1,358,1642,1284
6827,1,0,4,0,-4
6828,0,0,84,0,-84
6829,0,0,53,0,-53
6830,0,0,23,0,-23
6831,0,0,12,0,-12
6832,0,0,6,0,-6
6833,1,1,275,1618,1343
6834,1,1,1621,1551,-70
6835,1,1,206,1877,1671
6836,0,0,102,0,-102
6837,1,0,104,0,-104
6838,0,0,71,0,-71
6839,1,0,129,0,-129
6840,1,1,369,1845,1476
6841,1,0,15,0,-15
6842,0,0,26,0,-26
6843,1,0,13,0,-13
6844,0,0,31,0,-31
6845,1,0,20,0,-20
6846,1,0,167,0,-167
6847,0,0,7,0,-7
6848,1,0,75,0,-75
6849,1,0,37,0,-37
6850,1,1,583,1287,704
6851,1,1,169,1815,1646
6852,1,0,11,0,-11
6853,1,0,71,0,-71
6854,1,0,99,0,-99
6855,1,0,40,0,-40
6856,1,1,97,1420,1323
6857,1,0,73,0,-73
6858,1,1,37,1231,1194
6859,1,0,169,0,-169
6860,0,0,87,0,-87
6861,1,1,184,1691,1507
6862,1,1,750,1210,460
6863,1,0,242,0,-242
6864,1,0,125,0,-125
6865,0,0,23,0,-23
6866,1,0,180,0,-180
6867,1,1,336,1243,907
6868,0,0,2,0,-2
6869,1,1,655,1224,569
6870,0,0,17,0,-17
6871,1,1,1306,1495,189
6872,1,1,125,1397,1272
6873,0,0,49,0,-49
6874,1,0,123,0,-123
6875,1,1,706,1386,680
6876,0,0,6,0,-6
6877,0,0,13,0,-13
6878,0,0,66,0,-66
6879,0,0,49,0,-49
6880,1,1,637,1401,764
6881,0,0,78,0,-78
6882,0,0,10,0,-10
6883,1,1,1299,1252,-47
6884,1,0,45,0,-45
6885,0,0,27,0,-27
6886,1,0,8,0,-8
6887,1,0,22,0,-22
6888,1,0,77,0,-77
6889,1,0,91,0,-91
6890,0,0,11,0,-11
6891,0,0,152,0,-152
6892,1,0,71,0,-71
6893,0,0,23,0,-23
6894,0,0,59,0,-59
6895,1,0,131,0,-131
6896,0,0,94,0,-94
6897,1,1,308,1269,961
6898,0,0,89,0,-89
6899,0,0,6,0,-6
6900,1,0,44,0,-44
6901,1,1,1072,2081,1009
6902,1,0,37,0,-37
6903,1,0,9,0,-9
6904,0,0,86,0,-86
6905,1,1,1617,1442,-175
6906,1,0,10,0,-10
6907,1,1,84,2137,2053
6908,0,0,180,0,-180
6909,1,1,1129,4635,3506
6910,1,1,814,1607,793
6911,1,1,843,1232,389
6912,1,0,8,0,-8
6913,0,0,5,0,-5
6914,0,0,33,0,-33
6915,0,0,15,0,-15
6916,1,0,12,0,-12
6917,1,0,55,0,-55
6918,1,0,38,0,-38
6919,1,1,383,1216,833
6920,1,1,479,1728,1249
6921,1,0,77,0,-77
6922,0,0,22,0,-22
6923,0,0,3,0,-3
6924,1,0,6,0,-6
6925,0,0,21,0,-21
6926,0,0,22,0,-22
6927,1,1,80,1525,1445
6928,0,0,6,0,-6
6929,1,0,95,0,-95
6930,0,0,84,0,-84
6931,0,0,16,0,-16
6932,1,1,130,2272,2142
6933,1,0,5,0,-5
6934,0,0,86,0,-86
6935,1,0,55,0,-55
6936,1,0,56,0,-56
6937,1,1,541,1659,1118
6938,1,0,60,0,-60
6939,0,0,45,0,-45
6940,1,1,472,1833,1361
6941,1,0,21,0,-21
6942,0,0,10,0,-10
6943,0,0,6,0,-6
6944,0,0,8,0,-8
6945,0,0,103,0,-103
6946,1,1,360,1649,1289
6947,0,0,63,0,-63
6948,0,0,4,0,-4
6949,0,0,65,0,-65
6950,0,0,4,0,-4
6951,0,0,83,0,-83
6952,1,1,562,1329,767
6953,1,1,271,1351,1080
6954,1,0,192,0,-192
6955,0,0,44,0,-44
6956,1,1,173,1856,1683
6957,1,1,512,1387,875
6958,0,0,4,0,-4
6959,1,0,250,0,-250
6960,1,1,566,2506,1940
6961,1,1,1047,1297,250
6962,0,0,30,0,-30
6963,1,0,74,0,-74
6964,0,0,123,0,-123
6965,1,0,25,0,-25
6966,0,0,8,0,-8
6967,0,0,34,0,-34
6968,1,1,1265,1243,-22
6969,1,0,21,0,-21
6970,0,0,9,0,-9
6971,1,0,4,0,-4
6972,1,1,210,1260,1050
6973,1,0,41,0,-41
6974,1,1,656,1553,897
6975,0,0,15,0,-15
6976,0,0,11,0,-11
6977,0,0,6,0,-6
6978,1,0,32,0,-32
6979,1,0,43,0,-43
6980,1,0,31,0,-31
6981,1,0,68,0,-68
6982,0,0,31,0,-31
6983,1,1,213,1207,994
6984,1,1,286,1325,1039
6985,1,0,15,0,-15
6986,1,0,12,0,-12
6987,1,1,869,1463,594
6988,0,0,87,0,-87
6989,1,1,307,1207,900
6990,1,0,15,0,-15
6991,1,1,144,1289,1145
6992,0,0,32,0,-32
6993,1,1,1830,1835,5
6994,1,1,783,1220,437
6995,1,0,22,0,-22
6996,1,1,488,1825,1337
6997,1,1,355,1264,909
6998,1,1,192,1243,1051
6999,0,0,148,0,-148
7000,0,0,28,0,-28
7001,1,1,736,1400,664
7002,0,0,1,0,-1
7003,0,0,123,0,-123
7004,1,0,59,0,-59
7005,1,1,201,1262,1061
7006,1,0,109,0,-109
7007,1,1,45,2171,2126
7008,1,1,300,2971,2671
7009,0,0,56,0,-56
7010,0,0,92,0,-92
7011,1,0,39,0,-39
7012,0,0,11,0,-11
7013,0,0,81,0,-81
7014,1,1,787,1285,498
7015,1,0,58,0,-58
7016,0,0,15,0,-15
7017,0,0,53,0,-53
7018,1,0,5,0,-5
7019,1,0,1,0,-1
7020,1,1,460,1459,999
7021,1,0,37,0,-37
7022,1,0,97,0,-97
7023,1,0,24,0,-24
7024,1,1,944,1316,372
7025,1,1,379,1246,867
7026,1,0,35,0,-35
7027,0,0,21,0,-21
7028,0,0,9,0,-9
7029,1,0,55,0,-55
7030,1,1,1274,1518,244
7031,0,0,1,0,-1
7032,1,0,16,0,-16
7033,1,1,135,1350,1215
7034,1,0,0,0,0
7035,1,1,49,1510,1461
7036,1,0,31,0,-31
7037,0,0,30,0,-30
7038,1,1,571,1925,1354
7039,1,1,206,1281,1075
7040,1,1,169,1252,1083
7041,0,0,44,0,-44
7042,1,0,32,0,-32
7043,0,0,96,0,-96
7044,1,0,16,0,-16
7045,1,1,137,1491,1354
7046,0,0,165,0,-165
7047,0,0,6,0,-6
7048,1,1,1021,1245,224
7049,0,0,4,0,-4
7050,1,0,76,0,-76
7051,0,0,32,0,-32
7052,1,0,4,0,-4
7053,1,1,247,1483,1236
7054,1,1,318,1622,1304
7055,1,0,6,0,-6
7056,0,0,33,0,-33
7057,1,1,118,2674,2556
7058,1,0,61,0,-61
7059,1,0,59,0,-59
7060,1,0,30,0,-30
7061,0,0,11,0,-11
7062,0,0,36,0,-36
7063,0,0,37,0,-37
7064,1,1,270,1319,1049
7065,1,0,2,0,-2
7066,1,1,484,1202,718
7067,0,0,18,0,-18
7068,1,0,95,0,-95
7069,0,0,18,0,-18
7070,0,0,31,0,-31
7071,0,0,2,0,-2
7072,0,0,79,0,-79
7073,1,0,24,0,-24
7074,1,0,167,0,-167
7075,0,0,6,0,-6
7076,0,0,42,0,-42
7077,1,1,697,1227,530
7078,0,0,104,0,-104
7079,1,1,1439,1221,-218
7080,0,0,60,0,-60
7081,1,0,154,0,-154
7082,1,0,45,0,-45
7083,0,0,8,0,-8
7084,1,1,1159,1390,231
7085,1,1,164,1324,1160
7086,1,1,734,1503,769
7087,1,1,919,1568,649
7088,1,1,425,2060,1635
7089,0,0,20,0,-20
7090,0,0,9,0,-9
7091,0,0,49,0,-49
7092,1,0,136,0,-136
7093,1,0,1,0,-1
7094,0,0,10,0,-10
7095,0,0,9,0,-9
7096,1,0,3,0,-3
7097,1,1,398,1213,815
7098,0,0,38,0,-38
7099,0,0,81,0,-81
7100,1,0,0,0,0
7101,1,0,49,0,-49
7102,1,1,244,1870,1626
7103,0,0,131,0,-131
7104,0,0,25,0,-25
7105,1,0,20,0,-20
7106,1,1,190,1339,1149
7107,1,0,81,0,-81
7108,1,1,64,1210,1146
7109,0,0,43,0,-43
7110,0,0,54,0,-54
7111,1,0,8,0,-8
7112,0,0,15,0,-15
7113,0,0,8,0,-8
7114,1,0,123,0,-123
7115,1,0,15,0,-15
7116,1,0,113,0,-113
7117,1,0,27,0,-27
7118,0,0,16,0,-16
7119,0,0,18,0,-18
7120,1,1,33,1396,1363
7121,1,1,1492,1206,-286
7122,0,0,123,0,-123
7123,1,0,50,0,-50
7124,1,1,927,1330,403
7125,1,0,25,0,-25
7126,0,0,52,0,-52
7127,1,0,45,0,-45
7128,0,0,87,0,-87
7129,0,0,14,0,-14
7130,0,0,47,0,-47
7131,1,1,232,2995,2763
7132,1,1,230,1306,1076
7133,0,0,23,0,-23
7134,1,1,647,1780,1133
7135,0,0,20,0,-20
7136,1,1,698,2708,2010
7137,1,0,7,0,-7
7138,1,0,235,0,-235
7139,1,1,799,1229,430
7140,1,0,109,0,-109
7141,1,0,47,0,-47
7142,0,0,5,0,-5
7143,1,0,199,0,-199
7144,0,0,46,0,-46
7145,0,0,9,0,-9
7146,0,0,9,0,-9
7147,1,1,842,1658,816
7148,1,0,34,0,-34
7149,0,0,1,0,-1
7150,1,1,379,1539,1160
7151,1,0,147,0,-147
7152,1,0,14,0,-14
7153,1,0,31,0,-31
7154,1,0,4,0,-4
7155,0,0,155,0,-155
7156,1,1,1028,1339,311
7157,0,0,48,0,-48
7158,1,0,5,0,-5
7159,1,1,434,1499,1065
7160,0,0,12,0,-12
7161,0,0,31,0,-31
7162,1,1,144,1270,1126
7163,1,0,29,0,-29
7164,1,0,22,0,-22
7165,0,0,80,0,-80
7166,0,0,89,0,-89
7167,1,1,259,1242,983
7168,1,0,0,0,0
7169,1,0,35,0,-35
7170,1,0,24,0,-24
7171,1,1,642,1306,664
7172,1,0,24,0,-24
7173,0,0,69,0,-69
7174,1,1,747,1349,602
7175,0,0,27,0,-27
7176,1,0,4,0,-4
7177,1,0,24,0,-24
7178,0,0,26,0,-26
7179,0,0,91,0,-91
7180,1,0,7,0,-7
7181,0,0,115,0,-115
7182,1,1,249,1602,1353
7183,1,0,5,0,-5
7184,1,1,227,1723,1496
7185,1,1,745,1382,637
7186,1,1,358,1264,906
7187,1,1,1501,1425,-76
7188,1,1,325,1388,1063
7189,0,0,1,0,-1
7190,1,1,231,1312,1081
7191,1,1,389,1314,925
7192,1,0,22,0,-22
7193,1,1,634,1207,573
7194,0,0,12,0,-12
7195,1,0,33,0,-33
7196,0,0,85,0,-85
7197,0,0,121,0,-121
7198,1,1,95,3633,3538
7199,1,1,1059,1359,300
7200,1,0,2,0,-2
7201,1,1,44,1460,1416
7202,1,1,772,1627,855
7203,1,1,1029,1586,557
7204,1,0,41,0,-41
7205,1,0,20,0,-20
7206,1,1,235,2799,2564
7207,1,1,1443,1540,97
7208,1,0,75,0,-75
7209,1,0,58,0,-58
7210,0,0,21,0,-21
7211,1,1,281,1445,1164
7212,1,1,332,1639,1307
7213,0,0,74,0,-74
7214,1,0,175,0,-175
7215,0,0,11,0,-11
7216,0,0,33,0,-33
7217,0,0,32,0,-32
7218,1,1,342,1568,1226
7219,1,1,572,2245,1673
7220,1,0,85,0,-85
7221,1,0,42,0,-42
7222,1,1,220,2355,2135
7223,1,0,11,0,-11
7224,1,1,811,1589,778
7225,1,0,12,0,-12
7226,1,1,240,1241,1001
7227,1,1,1697,1334,-363
7228,1,1,1102,1470,368
7229,0,0,59,0,-59
7230,1,1,434,1280,846
7231,0,0,12,0,-12
7232,1,1,393,1796,1403
7233,1,1,362,1344,982
7234,1,1,1236,1602,366
7235,0,0,15,0,-15
7236,1,0,20,0,-20
7237,1,1,678,1368,690
7238,0,0,6,0,-6
7239,0,0,149,0,-149
7240,0,0,134,0,-134
7241,1,0,78,0,-78
7242,0,0,1,0,-1
7243,1,0,7,0,-7
7244,0,0,63,0,-63
7245,1,1,142,1525,1383
7246,1,0,141,0,-141
7247,1,0,34,0,-34
7248,0,0,2,0,-2
7249,1,1,110,1597,1487
7250,0,0,44,0,-44
7251,1,1,713,1586,873
7252,1,1,1253,1223,-30
7253,0,0,1,0,-1
7254,0,0,79,0,-79
7255,1,0,8,0,-8
7256,0,0,82,0,-82
7257,0,0,24,0,-24
7258,1,0,27,0,-27
7259,1,1,221,2687,2466
7260,1,1,3514,1505,-2009
7261,1,0,87,0,-87
7262,1,0,152,0,-152
7263,0,0,36,0,-36
7264,1,1,1053,1872,819
7265,1,1,174,1885,1711
7266,1,0,73,0,-73
7267,1,1,547,1483,936
7268,0,0,30,0,-30
7269,0,0,10,0,-10
7270,1,1,715,3031,2316
7271,1,0,20,0,-20
7272,0,0,32,0,-32
7273,1,0,18,0,-18
7274,1,0,77,0,-77
7275,1,1,505,1396,891
7276,0,0,203,0,-203
7277,1,1,213,1655,1442
7278,0,0,1,0,-1
7279,0,0,36,0,-36
7280,1,1,715,1567,852
7281,1,1,224,1810,1586
7282,0,0,127,0,-127
7283,1,0,4,0,-4
7284,1,0,6,0,-6
7285,1,0,60,0,-60
7286,1,0,6,0,-6
7287,1,1,1793,1247,-546
7288,1,0,22,0,-22
7289,1,0,22,0,-22
7290,0,0,20,0,-20
7291,1,1,147,1950,1803
7292,1,0,39,0,-39
7293,1,1,501,2122,1621
7294,0,0,38,0,-38
7295,1,1,182,1281,1099
7296,1,0,5,0,-5
7297,1,1,71,1242,1171
7298,1,0,43,0,-43
7299,1,1,131,1233,1102
7300,0,0,31,0,-31
7301,0,0,113,0,-113
7302,0,0,26,0,-26
7303,1,0,54,0,-54
7304,0,0,65,0,-65
7305,0,0,15,0,-15
7306,1,1,211,1528,1317
7307,1,1,234,3470,3236
7308,0,0,0,0,0
7309,0,0,20,0,-20
7310,0,0,45,0,-45
7311,1,1,238,1385,1147
7312,1,1,2714,1478,-1236
7313,0,0,42,0,-42
7314,0,0,16,0,-16
7315,0,0,29,0,-29
7316,0,0,20,0,-20
7317,0,0,0,0,0
7318,0,0,77,0,-77
7319,1,1,454,2850,2396
7320,0,0,38,0,-38
7321,1,0,108,0,-108
7322,1,0,58,0,-58
7323,1,1,860,1326,466
7324,1,1,248,1433,1185
7325,1,0,44,0,-44
7326,0,0,27,0,-27
7327,1,0,39,0,-39
7328,1,1,130,4093,3963
7329,1,0,21,0,-21
7330,1,0,41,0,-41
7331,1,1,531,8399,7868
7332,1,0,24,0,-24
7333,1,1,389,1566,1177
7334,0,0,9,0,-9
7335,1,1,119,2481,2362
7336,1,1,224,2777,2553
7337,1,0,14,0,-14
7338,1,1,1088,1244,156
7339,1,1,1332,1545,213
7340,1,1,152,1868,1716
7341,1,1,102,1208,1106
7342,1,0,15,0,-15
7343,1,1,475,1362,887
7344,1,0,381,0,-381
7345,1,1,1222,2753,1531
7346,1,0,169,0,-169
7347,1,1,821,1365,544
7348,0,0,5,0,-5
7349,1,0,7,0,-7
7350,0,0,95,0,-95
7351,0,0,55,0,-55
7352,0,0,5,0,-5
7353,1,0,102,0,-102
7354,1,1,2160,1233,-927
7355,1,1,554,1390,836
7356,1,1,353,1384,1031
7357,0,0,31,0,-31
7358,0,0,175,0,-175
7359,0,0,69,0,-69
7360,0,0,56,0,-56
7361,1,1,651,1295,644
7362,1,0,2,0,-2
7363,1,0,1,0,-1
7364,1,0,20,0,-20
7365,0,0,6,0,-6
7366,0,0,143,0,-143
7367,0,0,50,0,-50
7368,0,0,8,0,-8
7369,1,1,959,1458,499
7370,0,0,26,0,-26
7371,1,0,71,0,-71
7372,1,0,20,0,-20
7373,1,0,75,0,-75
7374,0,0,64,0,-64
7375,1,0,60,0,-60
7376,0,0,10,0,-10
7377,0,0,28,0,-28
7378,0,0,108,0,-108
7379,0,0,32,0,-32
7380,1,1,555,1991,1436
7381,0,0,3,0,-3
7382,1,1,367,1845,1478
7383,1,0,66,0,-66
7384,0,0,100,0,-100
7385,0,0,102,0,-102
7386,1,0,87,0,-87
7387,1,0,85,0,-85
7388,1,0,7,0,-7
7389,1,1,145,1478,1333
7390,0,0,101,0,-101
7391,1,0,35,0,-35
7392,0,0,91,0,-91
7393,0,0,55,0,-55
7394,1,1,329,1414,1085
7395,0,0,4,0,-4
7396,1,1,446,1626,1180
7397,0,0,39,0,-39
7398,1,1,170,1225,1055
7399,1,0,32,0,-32
7400,0,0,10,0,-10
7401,1,0,43,0,-43
7402,1,0,14,0,-14
7403,1,1,962,1736,774
7404,0,0,5,0,-5
7405,0,0,6,0,-6
7406,1,1,268,1576,1308
7407,1,0,240,0,-240
7408,1,0,41,0,-41
7409,1,0,33,0,-33
7410,1,0,16,0,-16
7411,1,0,213,0,-213
7412,1,1,1606,1315,-291
7413,1,1,487,1378,891
7414,1,0,8,0,-8
7415,0,0,17,0,-17
7416,0,0,28,0,-28
7417,1,0,35,0,-35
7418,1,1,89,2109,2020
7419,1,0,33,0,-33
7420,1,0,54,0,-54
7421,1,1,305,1289,984
7422,0,0,51,0,-51
7423,1,1,542,1301,759
7424,1,0,25,0,-25
7425,0,0,0,0,0
7426,0,0,49,0,-49
7427,1,1,123,1241,1118
7428,0,0,15,0,-15
7429,1,0,3,0,-3
7430,1,0,82,0,-82
7431,1,0,19,0,-19
7432,1,0,6,0,-6
7433,0,0,3,0,-3
7434,1,1,613,2152,1539
7435,1,0,3,0,-3
7436,1,0,0,0,0
7437,1,1,63,1590,1527
7438,1,0,2,0,-2
7439,1,0,18,0,-18
7440,1,1,121,1525,1404
7441,1,1,340,2031,1691
7442,1,0,26,0,-26
7443,1,1,328,2548,2220
7444,1,1,93,1462,1369
7445,1,1,383,1931,1548
7446,1,1,157,1252,1095
7447,1,1,134,1317,1183
7448,1,1,426,2216,1790
7449,1,1,97,1414,1317
7450,1,0,77,0,-77
7451,1,1,1120,1238,118
7452,0,0,25,0,-25
7453,1,0,6,0,-6
7454,0,0,72,0,-72
7455,1,0,111,0,-111
7456,1,0,46,0,-46
7457,0,0,32,0,-32
7458,0,0,29,0,-29
7459,1,1,351,1682,1331
7460,1,1,567,1829,1262
7461,1,0,86,0,-86
7462,1,0,11,0,-11
7463,1,0,30,0,-30
7464,1,1,417,1316,899
7465,1,0,37,0,-37
7466,0,0,27,0,-27
7467,1,1,409,1272,863
7468,0,0,44,0,-44
7469,0,0,75,0,-75
7470,0,0,14,0,-14
7471,1,0,19,0,-19
7472,1,1,478,1835,1357
7473,1,1,272,1200,928
7474,0,0,54,0,-54
7475,1,0,28,0,-28
7476,1,1,1981,1371,-610
7477,0,0,67,0,-67
7478,1,0,1,0,-1
7479,0,0,20,0,-20
7480,0,0,55,0,-55
7481,0,0,38,0,-38
7482,1,1,397,1647,1250
7483,0,0,60,0,-60
7484,0,0,21,0,-21
7485,1,0,26,0,-26
7486,1,1,1183,1231,48
7487,0,0,150,0,-150
7488,0,0,2,0,-2
7489,1,0,38,0,-38
7490,1,0,88,0,-88
7491,0,0,30,0,-30
7492,0,0,48,0,-48
7493,0,0,22,0,-22
7494,1,0,58,0,-58
7495,0,0,20,0,-20
7496,1,0,52,0,-52
7497,1,0,56,0,-56
7498,0,0,23,0,-23
7499,0,0,91,0,-91
7500,0,0,47,0,-47
7501,1,0,58,0,-58
7502,1,1,130,1473,1343
7503,0,0,43,0,-43
7504,1,0,93,0,-93
7505,0,0,4,0,-4
7506,0,0,102,0,-102
7507,0,0,82,0,-82
7508,1,0,31,0,-31
7509,1,0,110,0,-110
7510,1,0,44,0,-44
7511,0,0,0,0,0
7512,1,0,34,0,-34
7513,1,1,560,1522,962
7514,1,1,164,1335,1171
7515,0,0,73,0,-73
7516,0,0,8,0,-8
7517,1,1,265,3028,2763
7518,1,0,17,0,-17
7519,1,0,6,0,-6
7520,0,0,14,0,-14
7521,1,0,11,0,-11
7522,0,0,58,0,-58
7523,1,1,418,1398,980
7524,1,1,179,1255,1076
7525,0,0,12,0,-12
7526,1,1,868,1630,762
7527,0,0,44,0,-44
7528,0,0,25,0,-25
7529,1,0,518,0,-518
7530,0,0,69,0,-69
7531,1,0,75,0,-75
7532,1,1,265,1509,1244
7533,0,0,57,0,-57
7534,1,1,407,1277,870
7535,0,0,35,0,-35
7536,1,1,971,1388,417
7537,1,1,175,1311,1136
7538,1,0,16,0,-16
7539,0,0,94,0,-94
7540,1,1,265,1693,1428
7541,0,0,83,0,-83
7542,1,1,428,1209,781
7543,1,1,428,1536,1108
7544,0,0,57,0,-57
7545,0,0,13,0,-13
7546,1,1,1069,1474,405
7547,1,0,8,0,-8
7548,0,0,24,0,-24
7549,1,1,923,1222,299
7550,0,0,51,0,-51
7551,1,0,10,0,-10
7552,1,0,9,0,-9
7553,1,0,40,0,-40
7554,1,1,640,1237,597
7555,0,0,15,0,-15
7556,0,0,24,0,-24
7557,1,1,183,2078,1895
7558,1,0,17,0,-17
7559,0,0,1,0,-1
7560,1,1,888,1501,613
7561,1,1,356,1624,1268
7562,1,1,435,2157,1722
7563,1,1,792,2132,1340
7564,1,1,1031,1389,358
7565,1,0,10,0,-10
7566,0,0,55,0,-55
7567,0,0,12,0,-12
7568,0,0,48,0,-48
7569,1,1,676,1677,1001
7570,1,1,985,1468,483
7571,1,1,444,1333,889
7572,0,0,211,0,-211
7573,1,0,17,0,-17
7574,1,1,520,1222,702
7575,1,0,18,0,-18
7576,0,0,85,0,-85
7577,1,1,773,3645,2872
7578,1,0,88,0,-88
7579,1,1,651,1259,608
7580,0,0,370,0,-370
7581,0,0,5,0,-5
7582,0,0,29,0,-29
7583,1,0,7,0,-7
7584,1,1,415,1659,1244
7585,0,0,16,0,-16
7586,1,1,1176,1504,328
7587,1,1,191,1326,1135
7588,1,0,38,0,-38
7589,0,0,44,0,-44
7590,1,1,513,1542,1029
7591,1,1,647,1365,718
7592,0,0,26,0,-26
7593,0,0,14,0,-14
7594,1,1,60,3533,3473
7595,1,0,31,0,-31
7596,1,0,61,0,-61
7597,1,0,24,0,-24
7598,1,0,123,0,-123
7599,1,1,656,1349,693
7600,0,0,53,0,-53
7601,1,1,369,1527,1158
7602,1,1,159,1494,1335
7603,0,0,41,0,-41
7604,0,0,166,0,-166
7605,0,0,8,0,-8
7606,0,0,11,0,-11
7607,1,0,54,0,-54
7608,1,0,53,0,-53
7609,1,0,170,0,-170
7610,1,1,535,1344,809
7611,0,0,27,0,-27
7612,1,1,523,1754,1231
7613,0,0,13,0,-13
7614,0,0,56,0,-56
7615,0,0,11,0,-11
7616,0,0,171,0,-171
7617,1,1,420,1931,1511
7618,0,0,113,0,-113
7619,1,1,308,1349,1041
7620,1,1,392,1371,979
7621,1,0,33,0,-33
7622,1,1,414,1616,1202
7623,0,0,52,0,-52
7624,0,0,6,0,-6
7625,0,0,24,0,-24
7626,1,1,610,1564,954
7627,0,0,59,0,-59
7628,1,0,155,0,-155
7629,1,1,1175,1353,178
7630,0,0,48,0,-48
7631,0,0,3,0,-3
7632,0,0,10,0,-10
7633,1,1,663,1970,1307
7634,0,0,100,0,-100
7635,1,1,458,1217,759
7636,1,0,48,0,-48
7637,0,0,44,0,-44
7638,0,0,51,0,-51
7639,1,1,267,1268,1001
7640,1,0,6,0,-6
7641,1,0,1,0,-1
7642,1,0,9,0,-9
7643,0,0,4,0,-4
7644,1,1,472,1308,836
7645,1,0,74,0,-74
7646,1,1,516,1686,1170
7647,0,0,127,0,-127
7648,0,0,33,0,-33
7649,1,0,57,0,-57
7650,0,0,16,0,-16
7651,0,0,394,0,-394
7652,1,0,51,0,-51
7653,0,0,103,0,-103
7654,0,0,15,0,-15
7655,1,1,222,3005,2783
7656,0,0,154,0,-154
7657,1,0,11,0,-11
7658,0,0,13,0,-13
7659,1,1,167,1491,1324
7660,1,0,24,0,-24
7661,0,0,20,0,-20
7662,1,0,19,0,-19
7663,0,0,28,0,-28
7664,0,0,38,0,-38
7665,1,1,1166,1218,52
7666,1,0,62,0,-62
7667,1,0,2,0,-2
7668,1,0,24,0,-24
7669,1,1,492,1501,1009
7670,0,0,98,0,-98
7671,0,0,21,0,-21
7672,1,1,2668,1386,-1282
7673,1,1,702,1822,1120
7674,1,0,41,0,-41
7675,1,0,51,0,-51
7676,1,1,2123,1862,-261
7677,1,0,67,0,-67
7678,1,1,697,1758,1061
7679,1,0,133,0,-133
7680,1,1,624,1227,603
7681,1,0,53,0,-53
7682,1,0,6,0,-6
7683,0,0,50,0,-50
7684,0,0,39,0,-39
7685,0,0,211,0,-211
7686,0,0,44,0,-44
7687,1,1,208,1942,1734
7688,1,1,614,2025,1411
7689,1,1,1747,1257,-490
7690,1,0,49,0,-49
7691,0,0,11,0,-11
7692,0,0,135,0,-135
7693,0,0,29,0,-29
7694,1,0,70,0,-70
7695,1,0,21,0,-21
7696,0,0,48,0,-48
7697,0,0,10,0,-10
7698,1,1,713,1220,507
7699,1,0,68,0,-68
7700,1,0,7,0,-7
7701,1,1,311,1472,1161
7702,0,0,57,0,-57
7703,1,1,186,1246,1060
7704,1,0,15,0,-15
7705,1,1,1268,1350,82
7706,1,0,5,0,-5
7707,0,0,42,0,-42
7708,0,0,21,0,-21
7709,1,1,185,1388,1203
7710,1,0,15,0,-15
7711,1,1,472,1202,730
7712,1,0,49,0,-49
7713,0,0,28,0,-28
7714,1,0,1,0,-1
7715,1,0,4,0,-4
7716,1,1,536,2211,1675
7717,0,0,3,0,-3
7718,0,0,9,0,-9
7719,0,0,77,0,-77
7720,0,0,14,0,-14
7721,1,0,104,0,-104
7722,0,0,57,0,-57
7723,0,0,8,0,-8
7724,0,0,2,0,-2
7725,0,0,58,0,-58
7726,1,1,109,1228,1119
7727,1,0,16,0,-16
7728,1,0,280,0,-280
7729,1,0,21,0,-21
7730,1,1,1477,1933,456
7731,1,0,11,0,-11
7732,1,1,1459,1424,-35
7733,1,1,124,1325,1201
7734,1,0,35,0,-35
7735,0,0,47,0,-47
7736,1,0,10,0,-10
7737,1,0,62,0,-62
7738,0,0,61,0,-61
7739,0,0,19,0,-19
7740,0,0,26,0,-26
7741,0,0,153,0,-153
7742,1,0,52,0,-52
7743,0,0,9,0,-9
7744,1,1,248,1371,1123
7745,1,0,119,0,-119
7746,0,0,58,0,-58
7747,1,1,937,1652,715
7748,1,0,25,0,-25
7749,1,1,354,1977,1623
7750,1,0,7,0,-7
7751,1,1,851,1231,380
7752,0,0,86,0,-86
7753,1,1,405,1266,861
7754,0,0,12,0,-12
7755,1,1,636,1447,811
7756,1,1,282,1334,1052
7757,1,1,117,1263,1146
7758,1,1,242,1483,1241
7759,1,0,35,0,-35
7760,0,0,37,0,-37
7761,1,0,1,0,-1
7762,1,1,38,1308,1270
7763,1,1,1212,1674,462
7764,0,0,6,0,-6
7765,1,1,77,1582,1505
7766,1,0,0,0,0
7767,0,0,23,0,-23
7768,1,0,11,0,-11
7769,1,1,1205,2003,798
7770,1,1,21,1837,1816
7771,1,0,352,0,-352
7772,1,0,54,0,-54
7773,1,1,260,1242,982
7774,1,0,42,0,-42
7775,1,1,72,1207,1135
7776,0,0,187,0,-187
7777,0,0,2,0,-2
7778,0,0,5,0,-5
7779,1,0,9,0,-9
7780,0,0,60,0,-60
7781,1,0,82,0,-82
7782,0,0,16,0,-16
7783,0,0,59,0,-59
7784,0,0,120,0,-120
7785,1,0,38,0,-38
7786,1,1,860,1784,924
7787,1,0,59,0,-59
7788,0,0,5,0,-5
7789,0,0,24,0,-24
7790,0,0,1,0,-1
7791,0,0,18,0,-18
7792,0,0,16,0,-16
7793,1,0,149,0,-149
7794,0,0,53,0,-53
7795,1,1,817,1385,568
7796,0,0,25,0,-25
7797,1,0,25,0,-25
7798,0,0,22,0,-22
7799,0,0,15,0,-15
7800,0,0,81,0,-81
7801,1,0,102,0,-102
7802,0,0,75,0,-75
7803,1,0,83,0,-83
7804,0,0,19,0,-19
7805,0,0,15,0,-15
7806,0,0,51,0,-51
7807,1,0,71,0,-71
7808,0,0,63,0,-63
7809,1,0,58,0,-58
7810,1,0,140,0,-140
7811,0,0,151,0,-151
7812,0,0,17,0,-17
7813,0,0,29,0,-29
7814,1,1,307,1201,894
7815,1,0,33,0,-33
7816,1,0,32,0,-32
7817,1,1,442,3248,2806
7818,1,0,45,0,-45
7819,1,0,28,0,-28
7820,1,1,931,1518,587
7821,1,1,908,1563,655
7822,0,0,42,0,-42
7823,1,0,174,0,-174
7824,0,0,88,0,-88
7825,0,0,26,0,-26
7826,1,1,1783,1260,-523
7827,0,0,114,0,-114
7828,1,1,201,1386,1185
7829,1,1,544,1303,759
7830,1,1,857,1904,1047
7831,0,0,117,0,-117
7832,1,1,1263,2388,1125
7833,1,0,35,0,-35
7834,0,0,99,0,-99
7835,0,0,102,0,-102
7836,1,0,98,0,-98
7837,1,1,174,1352,1178
7838,0,0,13,0,-13
7839,1,1,636,1263,627
7840,0,0,70,0,-70
7841,1,1,248,2536,2288
7842,1,1,609,1268,659
7843,1,1,476,1392,916
7844,0,0,23,0,-23
7845,1,0,4,0,-4
7846,1,0,22,0,-22
7847,0,0,38,0,-38
7848,1,0,30,0,-30
7849,0,0,43,0,-43
7850,0,0,59,0,-59
7851,0,0,21,0,-21
7852,1,0,33,0,-33
7853,1,1,184,1356,1172
7854,1,0,6,0,-6
7855,1,1,633,1487,854
7856,1,0,24,0,-24
7857,0,0,28,0,-28
7858,1,1,222,1233,1011
7859,0,0,6,0,-6
7860,1,1,445,1349,904
7861,0,0,9,0,-9
7862,0,0,24,0,-24
7863,1,0,7,0,-7
7864,1,1,247,7873,7626
7865,1,1,102,1549,1447
7866,1,0,24,0,-24
7867,1,0,146,0,-146
7868,0,0,31,0,-31
7869,1,1,282,1422,1140
7870,1,0,15,0,-15
7871,0,0,182,0,-182
7872,1,0,71,0,-71
7873,0,0,8,0,-8
7874,1,1,344,2276,1932
7875,0,0,42,0,-42
7876,1,0,16,0,-16
7877,1,1,1553,1351,-202
7878,1,1,527,1263,736
7879,1,1,1282,1594,312
7880,0,0,55,0,-55
7881,1,1,263,1269,1006
7882,1,0,42,0,-42
7883,1,1,258,2259,2001
7884,1,1,922,1265,343
7885,0,0,38,0,-38
7886,0,0,7,0,-7
7887,1,0,35,0,-35
7888,0,0,73,0,-73
7889,1,0,84,0,-84
7890,0,0,32,0,-32
7891,1,0,2,0,-2
7892,1,0,34,0,-34
7893,1,0,49,0,-49
7894,0,0,148,0,-148
7895,1,1,47,1469,1422
7896,0,0,19,0,-19
7897,0,0,31,0,-31
7898,0,0,55,0,-55
7899,0,0,30,0,-30
7900,0,0,40,0,-40
7901,1,0,44,0,-44
7902,1,1,1245,1754,509
7903,1,0,256,0,-256
7904,1,0,93,0,-93
7905,1,0,33,0,-33
7906,0,0,33,0,-33
7907,1,0,20,0,-20
7908,1,0,16,0,-16
7909,0,0,34,0,-34
7910,1,0,5,0,-5
7911,1,1,171,1972,1801
7912,1,0,110,0,-110
7913,0,0,21,0,-21
7914,0,0,1,0,-1
7915,1,1,219,2634,2415
7916,1,0,13,0,-13
7917,1,1,1875,1359,-516
7918,0,0,13,0,-13
7919,1,0,3,0,-3
7920,1,1,821,1242,421
7921,0,0,43,0,-43
7922,0,0,25,0,-25
7923,0,0,47,0,-47
7924,0,0,33,0,-33
7925,1,1,50,1450,1400
7926,0,0,111,0,-111
7927,0,0,211,0,-211
7928,1,1,1060,1300,240
7929,1,1,174,1325,1151
7930,1,1,409,1362,953
7931,0,0,28,0,-28
7932,0,0,10,0,-10
7933,1,1,55,1308,1253
7934,1,1,247,1279,1032
7935,1,1,2154,1352,-802
7936,0,0,20,0,-20
7937,1,0,12,0,-12
7938,0,0,13,0,-13
7939,0,0,84,0,-84
7940,1,0,11,0,-11
7941,1,0,23,0,-23
7942,0,0,2,0,-2
7943,0,0,115,0,-115
7944,0,0,8,0,-8
7945,1,0,12,0,-12
7946,1,1,109,1386,1277
7947,1,0,37,0,-37
7948,0,0,118,0,-118
7949,0,0,15,0,-15
7950,1,0,15,0,-15
7951,1,1,306,1622,1316
7952,1,0,122,0,-122
7953,1,1,770,1250,480
7954,1,0,9,0,-9
7955,0,0,54,0,-54
7956,0,0,166,0,-166
7957,1,0,27,0,-27
7958,1,1,50,1242,1192
7959,0,0,32,0,-32
7960,0,0,58,0,-58
7961,0,0,36,0,-36
7962,1,1,134,2183,2049
7963,0,0,31,0,-31
7964,0,0,15,0,-15
7965,0,0,71,0,-71
7966,0,0,99,0,-99
7967,0,0,17,0,-17
7968,1,0,7,0,-7
7969,0,0,69,0,-69
7970,1,1,582,1218,636
7971,0,0,33,0,-33
7972,0,0,36,0,-36
7973,1,0,37,0,-37
7974,1,0,39,0,-39
7975,1,1,3411,1431,-1980
7976,0,0,112,0,-112
7977,0,0,49,0,-49
7978,1,0,90,0,-90
7979,0,0,8,0,-8
7980,0,0,70,0,-70
7981,0,0,129,0,-129
7982,0,0,4,0,-4
7983,1,1,1322,1316,-6
7984,1,1,1162,1330,168
7985,1,0,43,0,-43
7986,0,0,23,0,-23
7987,0,0,6,0,-6
7988,1,0,35,0,-35
7989,1,0,5,0,-5
7990,1,0,6,0,-6
7991,1,0,28,0,-28
7992,0,0,39,0,-39
7993,0,0,33,0,-33
7994,0,0,101,0,-101
7995,1,0,7,0,-7
7996,0,0,108,0,-108
7997,1,0,22,0,-22
7998,1,0,50,0,-50
7999,1,0,18,0,-18
8000,1,1,310,1755,1445
8001,1,1,1042,3703,2661
8002,1,1,827,1458,631
8003,0,0,20,0,-20
8004,1,1,2283,1334,-949
8005,0,0,5,0,-5
8006,0,0,29,0,-29
8007,0,0,34,0,-34
8008,0,0,21,0,-21
8009,0,0,58,0,-58
8010,0,0,13,0,-13
8011,0,0,15,0,-15
8012,0,0,63,0,-63
8013,0,0,15,0,-15
8014,1,1,70,1506,1436
8015,1,1,169,1299,1130
8016,1,1,767,1633,866
8017,1,0,24,0,-24
8018,1,0,16,0,-16
8019,1,0,5,0,-5
8020,0,0,16,0,-16
8021,1,1,149,1220,1071
8022,1,1,44,2748,2704
8023,0,0,14,0,-14
8024,0,0,5,0,-5
8025,0,0,37,0,-37
8026,1,1,252,1300,1048
8027,0,0,38,0,-38
8028,1,1,62,1332,1270
8029,1,1,147,1274,1127
8030,0,0,144,0,-144
8031,1,0,11,0,-11
8032,0,0,9,0,-9
8033,1,0,29,0,-29
8034,0,0,30,0,-30
8035,0,0,49,0,-49
8036,0,0,43,0,-43
8037,0,0,62,0,-62
8038,1,1,499,1580,1081
8039,0,0,51,0,-51
8040,0,0,24,0,-24
8041,1,1,440,1634,1194
8042,0,0,9,0,-9
8043,0,0,356,0,-356
8044,0,0,55,0,-55
8045,1,0,13,0,-13
8046,1,1,194,1430,1236
8047,0,0,77,0,-77
8048,1,0,19,0,-19
8049,1,0,30,0,-30
8050,0,0,31,0,-31
8051,1,1,343,1202,859
8052,0,0,119,0,-119
8053,1,1,479,1584,1105
8054,0,0,14,0,-14
8055,1,1,463,1239,776
8056,1,1,179,1245,1066
8057,1,1,2801,1635,-1166
8058,1,0,11,0,-11
8059,1,1,656,1233,577
8060,1,0,7,0,-7
8061,1,1,511,1516,1005
8062,1,1,197,1255,1058
8063,0,0,22,0,-22
8064,0,0,29,0,-29
8065,0,0,9,0,-9
8066,0,0,7,0,-7
8067,0,0,23,0,-23
8068,1,1,639,2247,1608
8069,0,0,107,0,-107
8070,0,0,2,0,-2
8071,1,1,247,1473,1226
8072,1,0,216,0,-216
8073,0,0,28,0,-28
8074,1,0,20,0,-20
8075,1,0,42,0,-42
8076,0,0,72,0,-72
8077,1,0,30,0,-30
8078,0,0,155,0,-155
8079,1,1,766,2583,1817
8080,1,0,51,0,-51
8081,0,0,19,0,-19
8082,0,0,3,0,-3
8083,0,0,3,0,-3
8084,1,1,1082,1869,787
8085,1,0,28,0,-28
8086,1,0,48,0,-48
8087,1,0,31,0,-31
8088,0,0,14,0,-14
8089,1,1,364,1503,1139
8090,1,0,71,0,-71
8091,1,0,191,0,-191
8092,1,0,2,0,-2
8093,1,0,53,0,-53
8094,0,0,19,0,-19
8095,1,1,604,1237,633
8096,1,1,205,1348,1143
8097,1,1,170,1831,1661
8098,1,1,243,2418,2175
8099,0,0,38,0,-38
8100,0,0,109,0,-109
8101,1,0,16,0,-16
8102,1,1,377,1293,916
8103,1,0,8,0,-8
8104,0,0,101,0,-101
8105,1,0,145,0,-145
8106,1,0,73,0,-73
8107,0,0,25,0,-25
8108,1,0,33,0,-33
8109,0,0,82,0,-82
8110,1,0,60,0,-60
8111,1,1,802,1471,669
8112,0,0,1,0,-1
8113,0,0,12,0,-12
8114,1,0,5,0,-5
8115,1,0,6,0,-6
8116,1,1,142,1209,1067
8117,0,0,42,0,-42
8118,0,0,33,0,-33
8119,1,0,3,0,-3
8120,1,1,606,1224,618
8121,1,1,11,1722,1711
8122,0,0,6,0,-6
8123,0,0,106,0,-106
8124,1,0,31,0,-31
8125,1,1,190,1711,1521
8126,0,0,17,0,-17
8127,0,0,60,0,-60
8128,1,0,97,0,-97
8129,1,1,34,1497,1463
8130,0,0,41,0,-41
8131,1,0,33,0,-33
8132,1,0,100,0,-100
8133,1,1,462,3816,3354
8134,1,1,483,1214,731
8135,1,0,85,0,-85
8136,1,1,221,1394,1173
8137,1,0,49,0,-49
8138,1,0,16,0,-16
8139,1,0,8,0,-8
8140,1,1,666,2059,1393
8141,1,0,84,0,-84
8142,1,0,15,0,-15
8143,1,1,163,1252,1089
8144,0,0,65,0,-65
8145,1,1,365,1317,952
8146,1,0,27,0,-27
8147,0,0,18,0,-18
8148,1,1,588,1512,924
8149,1,1,474,1949,1475
8150,0,0,1,0,-1
8151,0,0,30,0,-30
8152,1,0,10,0,-10
8153,0,0,50,0,-50
8154,0,0,40,0,-40
8155,0,0,3,0,-3
8156,0,0,175,0,-175
8157,0,0,35,0,-35
8158,1,1,302,1642,1340
8159,0,0,7,0,-7
8160,0,0,35,0,-35
8161,0,0,58,0,-58
8162,1,1,206,1531,1325
8163,1,1,165,1806,1641
8164,0,0,2,0,-2
8165,1,1,29,1683,1654
8166,0,0,30,0,-30
8167,0,0,6,0,-6
8168,0,0,12,0,-12
8169,1,1,15,1215,1200
8170,1,0,20,0,-20
8171,0,0,41,0,-41
8172,1,0,28,0,-28
8173,0,0,139,0,-139
8174,0,0,108,0,-108
8175,0,0,14,0,-14
8176,1,1,161,1371,1210
8177,0,0,70,0,-70
8178,0,0,31,0,-31
8179,0,0,139,0,-139
8180,1,1,219,1419,1200
8181,1,1,1653,1594,-59
8182,0,0,153,0,-153
8183,1,1,1057,1281,224
8184,0,0,18,0,-18
8185,1,0,11,0,-11
8186,1,1,113,1293,1180
8187,1,0,1,0,-1
8188,1,1,355,1294,939
8189,1,1,218,1796,1578
8190,0,0,17,0,-17
8191,1,1,138,1659,1521
8192,1,0,72,0,-72
8193,0,0,72,0,-72
8194,1,1,539,2070,1531
8195,1,1,731,1340,609
8196,1,0,20,0,-20
8197,1,1,699,1529,830
8198,1,0,36,0,-36
8199,1,0,0,0,0
8200,0,0,7,0,-7
8201,0,0,106,0,-106
8202,1,1,169,2162,1993
8203,1,1,82,1340,1258
8204,1,0,517,0,-517
8205,0,0,39,0,-39
8206,1,1,118,1562,1444
8207,0,0,55,0,-55
8208,1,1,35,1347,1312
8209,1,0,2,0,-2
8210,0,0,8,0,-8
8211,0,0,6,0,-6
8212,1,0,37,0,-37
8213,1,0,98,0,-98
8214,1,0,43,0,-43
8215,1,0,42,0,-42
8216,0,0,14,0,-14
8217,0,0,260,0,-260
8218,0,0,80,0,-80
8219,0,0,1,0,-1
8220,1,0,21,0,-21
8221,1,1,569,1529,960
8222,1,0,122,0,-122
8223,1,1,87,1322,1235
8224,0,0,41,0,-41
8225,0,0,0,0,0
8226,1,0,0,0,0
8227,0,0,10,0,-10
8228,0,0,4,0,-4
8229,0,0,2,0,-2
8230,0,0,75,0,-75
8231,0,0,61,0,-61
8232,1,1,668,1699,1031
8233,1,0,6,0,-6
8234,1,1,1181,1268,87
8235,1,0,62,0,-62
8236,1,1,206,2995,2789
8237,0,0,7,0,-7
8238,1,0,3,0,-3
8239,0,0,110,0,-110
8240,1,0,64,0,-64
8241,1,0,6,0,-6
8242,1,0,28,0,-28
8243,1,0,49,0,-49
8244,1,0,161,0,-161
8245,1,0,140,0,-140
8246,1,1,561,1323,762
8247,1,1,1020,2619,1599
8248,1,1,146,1245,1099
8249,1,1,257,2283,2026
8250,1,0,15,0,-15
8251,0,0,236,0,-236
8252,0,0,28,0,-28
8253,1,0,88,0,-88
8254,1,0,239,0,-239
8255,0,0,65,0,-65
8256,0,0,92,0,-92
8257,1,0,36,0,-36
8258,1,1,89,2434,2345
8259,1,1,280,1221,941
8260,1,1,830,1686,856
8261,1,0,7,0,-7
8262,1,0,32,0,-32
8263,0,0,34,0,-34
8264,0,0,43,0,-43
8265,1,0,23,0,-23
8266,1,1,81,1581,1500
8267,0,0,86,0,-86
8268,1,0,35,0,-35
8269,1,0,144,0,-144
8270,1,0,35,0,-35
8271,0,0,48,0,-48
8272,1,0,50,0,-50
8273,0,0,2,0,-2
8274,1,1,862,1381,519
8275,0,0,1,0,-1
8276,0,0,98,0,-98
8277,1,0,94,0,-94
8278,1,0,86,0,-86
8279,1,1,350,2065,1715
8280,1,0,39,0,-39
8281,0,0,69,0,-69
8282,0,0,41,0,-41
8283,1,0,69,0,-69
8284,1,0,45,0,-45
8285,0,0,57,0,-57
8286,1,1,767,1547,780
8287,1,1,333,2081,1748
8288,1,1,581,1677,1096
8289,1,1,222,1206,984
8290,1,0,82,0,-82
8291,1,1,88,3431,3343
8292,1,0,13,0,-13
8293,1,0,21,0,-21
8294,1,1,2206,1235,-971
8295,1,0,7,0,-7
8296,1,1,798,1393,595
8297,0,0,13,0,-13
8298,0,0,30,0,-30
8299,1,1,617,1650,1033
8300,0,0,51,0,-51
8301,0,0,71,0,-71
8302,1,1,92,1203,1111
8303,1,0,82,0,-82
8304,1,1,348,1613,1265
8305,1,1,1512,1535,23
8306,1,0,27,0,-27
8307,0,0,70,0,-70
8308,0,0,1,0,-1
8309,1,0,76,0,-76
8310,0,0,53,0,-53
8311,1,1,445,1458,1013
8312,1,0,46,0,-46
8313,0,0,226,0,-226
8314,0,0,18,0,-18
8315,0,0,39,0,-39
8316,1,0,57,0,-57
8317,1,0,126,0,-126
8318,1,0,8,0,-8
8319,0,0,21,0,-21
8320,0,0,1,0,-1
8321,1,0,18,0,-18
8322,1,1,130,1651,1521
8323,0,0,25,0,-25
8324,0,0,13,0,-13
8325,1,0,42,0,-42
8326,0,0,10,0,-10
8327,1,0,16,0,-16
8328,1,0,75,0,-75
8329,1,0,3,0,-3
8330,1,1,1792,1940,148
8331,1,0,65,0,-65
8332,0,0,25,0,-25
8333,1,0,17,0,-17
8334,0,0,165,0,-165
8335,0,0,68,0,-68
8336,0,0,12,0,-12
8337,0,0,131,0,-131
8338,1,0,69,0,-69
8339,0,0,62,0,-62
8340,1,1,398,1356,958
8341,0,0,18,0,-18
8342,1,1,445,1446,1001
8343,1,1,82,1596,1514
8344,0,0,20,0,-20
8345,1,0,54,0,-54
8346,1,0,68,0,-68
8347,1,0,226,0,-226
8348,0,0,37,0,-37
8349,1,1,1228,1486,258
8350,1,0,103,0,-103
8351,1,0,28,0,-28
8352,1,1,620,1930,1310
8353,1,1,135,1220,1085
8354,0,0,16,0,-16
8355,0,0,152,0,-152
8356,0,0,24,0,-24
8357,0,0,37,0,-37
8358,1,1,286,2743,2457
8359,0,0,47,0,-47
8360,0,0,100,0,-100
8361,1,0,0,0,0
8362,1,1,1247,1285,38
8363,1,1,757,1566,809
8364,1,1,995,1267,272
8365,1,0,56,0,-56
8366,1,0,20,0,-20
8367,1,1,67,1239,1172
8368,1,1,1920,2839,919
8369,0,0,104,0,-104
8370,1,1,104,1294,1190
8371,1,1,2762,3332,570
8372,1,1,51,1360,1309
8373,1,0,37,0,-37
8374,0,0,3,0,-3
8375,1,0,94,0,-94
8376,0,0,80,0,-80
8377,0,0,31,0,-31
8378,0,0,26,0,-26
8379,1,0,64,0,-64
8380,0,0,0,0,0
8381,0,0,144,0,-144
8382,1,1,1157,1476,319
8383,0,0,10,0,-10
8384,0,0,31,0,-31
8385,0,0,26,0,-26
8386,1,1,350,1377,1027
8387,1,0,31,0,-31
8388,1,0,63,0,-63
8389,1,0,13,0,-13
8390,0,0,12,0,-12
8391,0,0,66,0,-66
8392,1,0,3,0,-3
8393,0,0,15,0,-15
8394,0,0,74,0,-74
8395,1,0,2,0,-2
8396,1,1,246,2592,2346
8397,0,0,249,0,-249
8398,0,0,19,0,-19
8399,0,0,22,0,-22
8400,1,1,198,1359,1161
8401,0,0,47,0,-47
8402,1,1,961,1625,664
8403,0,0,27,0,-27
8404,0,0,27,0,-27
8405,1,0,34,0,-34
8406,0,0,110,0,-110
8407,0,0,28,0,-28
8408,0,0,83,0,-83
8409,0,0,52,0,-52
8410,1,0,164,0,-164
8411,1,1,423,1308,885
8412,0,0,7,0,-7
8413,1,1,480,1397,917
8414,0,0,65,0,-65
8415,0,0,102,0,-102
8416,0,0,9,0,-9
8417,1,1,993,1327,334
8418,0,0,10,0,-10
8419,1,1,328,2661,2333
8420,1,0,16,0,-16
8421,1,1,82,1339,1257
8422,0,0,158,0,-158
8423,1,1,385,1289,904
8424,0,0,43,0,-43
8425,1,1,1173,1860,687
8426,1,0,150,0,-150
8427,0,0,8,0,-8
8428,1,1,272,2150,1878
8429,1,1,523,1206,683
8430,1,0,39,0,-39
8431,1,1,525,4954,4429
8432,1,1,342,1200,858
8433,0,0,17,0,-17
8434,0,0,102,0,-102
8435,1,0,75,0,-75
8436,1,1,576,1202,626
8437,0,0,17,0,-17
8438,1,1,410,1949,1539
8439,0,0,210,0,-210
8440,0,0,41,0,-41
8441,0,0,65,0,-65
8442,0,0,3,0,-3
8443,1,1,436,1496,1060
8444,1,0,160,0,-160
8445,0,0,28,0,-28
8446,0,0,61,0,-61
8447,0,0,118,0,-118
8448,0,0,20,0,-20
8449,0,0,54,0,-54
8450,1,0,181,0,-181
8451,1,0,60,0,-60
8452,1,0,7,0,-7
8453,1,0,113,0,-113
8454,1,0,45,0,-45
8455,1,1,1230,1406,176
8456,0,0,26,0,-26
8457,1,0,81,0,-81
8458,0,0,75,0,-75
8459,1,0,45,0,-45
8460,0,0,1,0,-1
8461,1,0,29,0,-29
8462,0,0,33,0,-33
8463,1,0,3,0,-3
8464,1,1,334,1475,1141
8465,1,1,131,1276,1145
8466,0,0,2,0,-2
8467,0,0,66,0,-66
8468,1,1,1440,1613,173
8469,1,1,729,1382,653
8470,1,1,189,1239,1050
8471,1,1,152,1230,1078
8472,0,0,10,0,-10
8473,1,0,53,0,-53
8474,1,0,15,0,-15
8475,1,0,107,0,-107
8476,1,0,46,0,-46
8477,0,0,68,0,-68
8478,1,0,31,0,-31
8479,1,1,322,1265,943
8480,1,1,59,1410,1351
8481,1,0,48,0,-48
8482,0,0,3,0,-3
8483,1,0,156,0,-156
8484,1,0,51,0,-51
8485,1,1,1077,1344,267
8486,1,0,23,0,-23
8487,0,0,68,0,-68
8488,1,0,38,0,-38
8489,1,0,12,0,-12
8490,1,0,44,0,-44
8491,1,0,51,0,-51
8492,0,0,39,0,-39
8493,0,0,42,0,-42
8494,0,0,24,0,-24
8495,0,0,77,0,-77
8496,0,0,91,0,-91
8497,1,1,351,1247,896
8498,0,0,20,0,-20
8499,1,1,270,1260,990
8500,0,0,26,0,-26
8501,0,0,68,0,-68
8502,0,0,34,0,-34
8503,1,0,119,0,-119
8504,1,1,98,1348,1250
8505,0,0,55,0,-55
8506,1,0,123,0,-123
8507,0,0,57,0,-57
8508,1,0,36,0,-36
8509,1,0,45,0,-45
8510,0,0,71,0,-71
8511,1,1,848,1503,655
8512,0,0,41,0,-41
8513,1,0,13,0,-13
8514,1,1,51,1242,1191
8515,1,0,7,0,-7
8516,1,0,39,0,-39
8517,0,0,72,0,-72
8518,1,1,676,1556,880
8519,0,0,160,0,-160
8520,1,0,41,0,-41
8521,1,0,150,0,-150
8522,1,0,185,0,-185
8523,1,0,12,0,-12
8524,0,0,99,0,-99
8525,0,0,59,0,-59
8526,0,0,10,0,-10
8527,0,0,89,0,-89
8528,1,1,651,1261,610
8529,1,0,81,0,-81
8530,1,1,678,1708,1030
8531,1,0,10,0,-10
8532,1,1,817,1355,538
8533,1,0,6,0,-6
8534,1,1,169,2041,1872
8535,1,0,11,0,-11
8536,1,0,52,0,-52
8537,0,0,84,0,-84
8538,1,1,1014,1428,414
8539,0,0,44,0,-44
8540,0,0,49,0,-49
8541,0,0,69,0,-69
8542,0,0,3,0,-3
8543,0,0,21,0,-21
8544,0,0,49,0,-49
8545,0,0,154,0,-154
8546,0,0,10,0,-10
8547,1,0,7,0,-7
8548,1,0,73,0,-73
8549,1,1,181,1509,1328
8550,1,0,180,0,-180
8551,1,1,104,1208,1104
8552,0,0,136,0,-136
8553,1,0,51,0,-51
8554,1,1,861,1248,387
8555,0,0,27,0,-27
8556,1,0,15,0,-15
8557,1,0,63,0,-63
8558,0,0,19,0,-19
8559,1,1,644,1211,567
8560,0,0,39,0,-39
8561,1,1,575,1607,1032
8562,1,1,458,1535,1077
8563,0,0,4,0,-4
8564,0,0,12,0,-12
8565,1,0,61,0,-61
8566,0,0,49,0,-49
8567,1,0,26,0,-26
8568,1,1,202,2433,2231
8569,1,0,1,0,-1
8570,1,0,120,0,-120
8571,1,0,4,0,-4
8572,1,1,2318,1354,-964
8573,0,0,13,0,-13
8574,0,0,76,0,-76
8575,0,0,76,0,-76
8576,0,0,27,0,-27
8577,1,0,0,0,0
8578,1,0,115,0,-115
8579,0,0,71,0,-71
8580,0,0,112,0,-112
8581,1,0,4,0,-4
8582,0,0,59,0,-59
8583,1,1,1217,1332,115
8584,0,0,23,0,-23
8585,0,0,115,0,-115
8586,0,0,138,0,-138
8587,1,0,19,0,-19
8588,1,1,218,1351,1133
8589,1,0,53,0,-53
8590,0,0,4,0,-4
8591,0,0,31,0,-31
8592,1,1,211,1393,1182
8593,1,0,49,0,-49
8594,1,1,423,1587,1164
8595,0,0,42,0,-42
8596,1,0,83,0,-83
8597,1,0,40,0,-40
8598,0,0,23,0,-23
8599,1,0,98,0,-98
8600,1,1,29,1973,1944
8601,1,1,354,1226,872
8602,0,0,123,0,-123
8603,1,0,61,0,-61
8604,1,1,126,1243,1117
8605,1,0,17,0,-17
8606,1,1,92,1319,1227
8607,0,0,15,0,-15
8608,0,0,28,0,-28
8609,0,0,52,0,-52
8610,0,0,0,0,0
8611,0,0,186,0,-186
8612,1,0,87,0,-87
8613,0,0,120,0,-120
8614,0,0,26,0,-26
8615,0,0,31,0,-31
8616,1,1,274,1733,1459
8617,1,1,213,1204,991
8618,1,0,57,0,-57
8619,1,0,79,0,-79
8620,1,0,56,0,-56
8621,1,0,20,0,-20
8622,1,1,1092,1214,122
8623,1,1,689,1913,1224
8624,0,0,0,0,0
8625,1,1,255,1402,1147
8626,0,0,86,0,-86
8627,1,0,11,0,-11
8628,1,1,349,1796,1447
8629,0,0,20,0,-20
8630,0,0,3,0,-3
8631,0,0,13,0,-13
8632,1,1,744,1247,503
8633,1,1,679,1282,603
8634,1,0,11,0,-11
8635,0,0,104,0,-104
8636,1,1,223,1901,1678
8637,0,0,7,0,-7
8638,1,1,319,1400,1081
8639,0,0,94,0,-94
8640,1,0,7,0,-7
8641,0,0,93,0,-93
8642,1,1,10,1496,1486
8643,0,0,52,0,-52
8644,0,0,68,0,-68
8645,1,1,1948,1369,-579
8646,1,1,538,1250,712
8647,1,1,877,1428,551
8648,1,0,41,0,-41
8649,1,0,40,0,-40
8650,1,0,14,0,-14
8651,1,1,846,1340,494
8652,1,1,153,1569,1416
8653,0,0,60,0,-60
8654,0,0,18,0,-18
8655,0,0,26,0,-26
8656,1,1,620,1441,821
8657,1,0,15,0,-15
8658,0,0,51,0,-51
8659,0,0,68,0,-68
8660,0,0,11,0,-11
8661,1,0,290,0,-290
8662,0,0,14,0,-14
8663,1,0,89,0,-89
8664,0,0,68,0,-68
8665,1,0,92,0,-92
8666,0,0,30,0,-30
8667,1,0,43,0,-43
8668,1,0,59,0,-59
8669,0,0,94,0,-94
8670,0,0,13,0,-13
8671,0,0,17,0,-17
8672,0,0,21,0,-21
8673,1,1,482,1326,844
8674,1,1,375,1559,1184
8675,0,0,10,0,-10
8676,1,1,357,1655,1298
8677,1,1,187,1200,1013
8678,0,0,29,0,-29
8679,1,0,49,0,-49
8680,0,0,58,0,-58
8681,0,0,120,0,-120
8682,1,0,14,0,-14
8683,0,0,113,0,-113
8684,1,0,117,0,-117
8685,0,0,76,0,-76
8686,1,0,39,0,-39
8687,0,0,37,0,-37
8688,0,0,21,0,-21
8689,1,1,749,4507,3758
8690,1,0,30,0,-30
8691,0,0,271,0,-271
8692,0,0,179,0,-179
8693,1,1,194,1501,1307
8694,1,1,127,1271,1144
8695,0,0,42,0,-42
8696,0,0,52,0,-52
8697,1,0,34,0,-34
8698,0,0,10,0,-10
8699,0,0,109,0,-109
8700,1,1,426,1706,1280
8701,0,0,44,0,-44
8702,1,0,75,0,-75
8703,0,0,65,0,-65
8704,1,1,116,1207,1091
8705,0,0,2,0,-2
8706,1,0,32,0,-32
8707,0,0,48,0,-48
8708,0,0,30,0,-30
8709,0,0,62,0,-62
8710,1,1,739,1359,620
8711,1,1,921,1203,282
8712,1,0,17,0,-17
8713,1,1,382,2045,1663
8714,0,0,95,0,-95
8715,1,1,411,1986,1575
8716,1,1,1468,1243,-225
8717,0,0,27,0,-27
8718,1,1,121,1528,1407
8719,1,1,197,1315,1118
8720,0,0,7,0,-7
8721,0,0,3,0,-3
8722,0,0,11,0,-11
8723,1,0,37,0,-37
8724,0,0,20,0,-20
8725,0,0,20,0,-20
8726,1,1,383,1456,1073
8727,1,0,25,0,-25
8728,1,1,256,1305,1049
8729,0,0,123,0,-123
8730,1,1,92,1475,1383
8731,1,0,5,0,-5
8732,1,0,119,0,-119
8733,1,0,44,0,-44
8734,0,0,60,0,-60
8735,1,1,223,1436,1213
8736,1,1,172,2511,2339
8737,1,1,1814,1294,-520
8738,1,0,53,0,-53
8739,1,0,39,0,-39
8740,1,1,929,1886,957
8741,0,0,6,0,-6
8742,0,0,75,0,-75
8743,0,0,14,0,-14
8744,1,1,403,1648,1245
8745,0,0,14,0,-14
8746,1,1,234,1684,1450
8747,1,1,2318,1294,-1024
8748,1,0,3,0,-3
8749,0,0,65,0,-65
8750,1,0,39,0,-39
8751,0,0,86,0,-86
8752,0,0,44,0,-44
8753,1,0,120,0,-120
8754,0,0,44,0,-44
8755,1,0,60,0,-60
8756,0,0,0,0,0
8757,1,1,1313,1260,-53
8758,1,0,41,0,-41
8759,1,0,80,0,-80
8760,0,0,180,0,-180
8761,0,0,78,0,-78
8762,0,0,5,0,-5
8763,1,1,612,1221,609
8764,0,0,7,0,-7
8765,1,1,762,2009,1247
8766,1,1,588,1381,793
8767,0,0,62,0,-62
8768,0,0,80,0,-80
8769,0,0,13,0,-13
8770,1,1,183,1369,1186
8771,1,1,374,1416,1042
8772,1,1,179,1332,1153
8773,1,1,448,1432,984
8774,1,1,754,1570,816
8775,1,0,57,0,-57
8776,1,0,30,0,-30
8777,1,0,25,0,-25
8778,1,0,25,0,-25
8779,1,0,32,0,-32
8780,1,1,265,1556,1291
8781,1,1,173,1934,1761
8782,1,0,17,0,-17
8783,1,0,45,0,-45
8784,1,1,635,1553,918
8785,1,0,61,0,-61
8786,1,1,458,1291,833
8787,1,0,62,0,-62
8788,1,0,107,0,-107
8789,1,0,35,0,-35
8790,0,0,88,0,-88
8791,0,0,3,0,-3
8792,1,1,494,1382,888
8793,0,0,81,0,-81
8794,1,0,51,0,-51
8795,0,0,27,0,-27
8796,1,0,112,0,-112
8797,1,1,112,1344,1232
8798,1,0,32,0,-32
8799,1,0,8,0,-8
8800,1,0,115,0,-115
8801,0,0,12,0,-12
8802,0,0,3,0,-3
8803,1,0,9,0,-9
8804,1,1,488,1250,762
8805,0,0,19,0,-19
8806,0,0,153,0,-153
8807,1,0,43,0,-43
8808,0,0,41,0,-41
8809,1,1,3247,2639,-608
8810,1,1,591,1314,723
8811,0,0,112,0,-112
8812,1,0,91,0,-91
8813,0,0,31,0,-31
8814,1,0,10,0,-10
8815,0,0,56,0,-56
8816,0,0,137,0,-137
8817,1,1,187,1800,1613
8818,0,0,102,0,-102
8819,0,0,52,0,-52
8820,1,0,30,0,-30
8821,1,1,214,1233,1019
8822,0,0,185,0,-185
8823,0,0,95,0,-95
8824,1,0,50,0,-50
8825,0,0,131,0,-131
8826,0,0,46,0,-46
8827,1,1,859,1398,539
8828,1,1,218,2416,2198
8829,0,0,14,0,-14
8830,0,0,33,0,-33
8831,1,0,0,0,0
8832,1,1,640,1212,572
8833,1,1,337,1217,880
8834,1,1,152,1263,1111
8835,0,0,14,0,-14
8836,1,0,22,0,-22
8837,1,1,372,1246,874
8838,0,0,4,0,-4
8839,1,1,57,2241,2184
8840,1,1,282,1269,987
8841,0,0,13,0,-13
8842,1,1,702,1261,559
8843,1,0,15,0,-15
8844,1,0,69,0,-69
8845,1,1,795,2303,1508
8846,1,1,1330,1254,-76
8847,0,0,1,0,-1
8848,1,1,211,1284,1073
8849,0,0,145,0,-145
8850,1,1,92,1256,1164
8851,1,1,107,1234,1127
8852,1,1,246,1577,1331
8853,1,1,1431,1284,-147
8854,0,0,59,0,-59
8855,0,0,5,0,-5
8856,1,1,1203,1739,536
8857,0,0,81,0,-81
8858,1,0,21,0,-21
8859,0,0,4,0,-4
8860,1,0,9,0,-9
8861,1,0,35,0,-35
8862,1,0,20,0,-20
8863,0,0,23,0,-23
8864,0,0,16,0,-16
8865,0,0,21,0,-21
8866,1,1,1717,2071,354
8867,1,1,168,1938,1770
8868,0,0,90,0,-90
8869,1,0,20,0,-20
8870,1,1,711,1881,1170
8871,0,0,129,0,-129
8872,1,1,22,1593,1571
8873,1,1,104,1224,1120
8874,1,0,197,0,-197
8875,1,0,71,0,-71
8876,1,0,163,0,-163
8877,0,0,48,0,-48
8878,1,1,158,1463,1305
8879,1,0,87,0,-87
8880,0,0,15,0,-15
8881,1,0,91,0,-91
8882,0,0,0,0,0
8883,1,1,329,4348,4019
8884,0,0,38,0,-38
8885,1,0,70,0,-70
8886,0,0,87,0,-87
8887,1,1,53,1734,1681
8888,1,0,74,0,-74
8889,0,0,18,0,-18
8890,0,0,79,0,-79
8891,1,0,45,0,-45
8892,0,0,90,0,-90
8893,0,0,48,0,-48
8894,0,0,11,0,-11
8895,1,1,2090,1539,-551
8896,0,0,79,0,-79
8897,0,0,41,0,-41
8898,0,0,50,0,-50
8899,1,1,290,1455,1165
8900,0,0,69,0,-69
8901,1,1,220,1329,1109
8902,1,1,148,1282,1134
8903,0,0,38,0,-38
8904,1,1,2205,2109,-96
8905,1,0,20,0,-20
8906,0,0,71,0,-71
8907,0,0,66,0,-66
8908,1,1,210,1768,1558
8909,1,0,2,0,-2
8910,0,0,36,0,-36
8911,0,0,90,0,-90
8912,1,1,742,1212,470
8913,1,1,1120,1333,213
8914,0,0,35,0,-35
8915,1,1,51,1257,1206
8916,0,0,9,0,-9
8917,0,0,85,0,-85
8918,1,0,51,0,-51
8919,0,0,45,0,-45
8920,1,1,1807,1337,-470
8921,0,0,17,0,-17
8922,1,0,134,0,-134
8923,0,0,78,0,-78
8924,1,1,170,2012,1842
8925,1,0,3,0,-3
8926,0,0,138,0,-138
8927,1,1,142,1679,1537
8928,1,0,29,0,-29
8929,1,0,15,0,-15
8930,1,0,131,0,-131
8931,1,1,315,1509,1194
8932,0,0,80,0,-80
8933,1,0,88,0,-88
8934,0,0,109,0,-109
8935,0,0,92,0,-92
8936,0,0,46,0,-46
8937,0,0,35,0,-35
8938,0,0,5,0,-5
8939,0,0,31,0,-31
8940,1,0,70,0,-70
8941,1,1,136,1873,1737
8942,1,0,7,0,-7
8943,0,0,52,0,-52
8944,1,1,1257,1739,482
8945,0,0,8,0,-8
8946,1,0,54,0,-54
8947,0,0,23,0,-23
8948,1,0,59,0,-59
8949,1,0,33,0,-33
8950,0,0,21,0,-21
8951,1,1,278,1692,1414
8952,0,0,9,0,-9
8953,0,0,66,0,-66
8954,1,0,23,0,-23
8955,1,0,51,0,-51
8956,1,0,9,0,-9
8957,1,1,140,1212,1072
8958,1,0,57,0,-57
8959,1,0,35,0,-35
8960,0,0,39,0,-39
8961,1,0,24,0,-24
8962,0,0,5,0,-5
8963,1,1,505,1579,1074
8964,1,0,3,0,-3
8965,0,0,70,0,-70
8966,0,0,106,0,-106
8967,1,1,451,1411,960
8968,0,0,41,0,-41
8969,0,0,25,0,-25
8970,1,0,6,0,-6
8971,1,0,13,0,-13
8972,0,0,17,0,-17
8973,1,1,1607,1205,-402
8974,1,0,88,0,-88
8975,0,0,136,0,-136
8976,1,1,654,1231,577
8977,0,0,179,0,-179
8978,1,1,1671,1217,-454
8979,1,1,402,1221,819
8980,1,1,326,1259,933
8981,0,0,1,0,-1
8982,1,1,74,1344,1270
8983,1,0,22,0,-22
8984,0,0,6,0,-6
8985,1,1,112,1248,1136
8986,1,0,0,0,0
8987,1,1,205,1428,1223
8988,1,1,1279,1629,350
8989,1,1,81,1440,1359
8990,1,0,24,0,-24
8991,1,1,487,2040,1553
8992,1,0,1,0,-1
8993,1,0,166,0,-166
8994,0,0,119,0,-119
8995,1,1,402,1554,1152
8996,1,0,10,0,-10
8997,0,0,1,0,-1
8998,1,1,346,1213,867
8999,1,1,330,2127,1797
9000,0,0,4,0,-4
9001,0,0,7,0,-7
9002,1,1,354,1614,1260
9003,1,0,136,0,-136
9004,1,1,345,1299,954
9005,1,1,2391,1461,-930
9006,1,0,0,0,0
9007,0,0,128,0,-128
9008,0,0,147,0,-147
9009,0,0,7,0,-7
9010,1,0,26,0,-26
9011,1,1,76,1559,1483
9012,1,1,65,1549,1484
9013,1,0,19,0,-19
9014,0,0,157,0,-157
9015,0,0,7,0,-7
9016,1,0,42,0,-42
9017,0,0,212,0,-212
9018,0,0,21,0,-21
9019,0,0,42,0,-42
9020,1,1,28,1217,1189
9021,1,0,39,0,-39
9022,1,0,54,0,-54
9023,0,0,77,0,-77
9024,1,0,35,0,-35
9025,1,1,271,1582,1311
9026,0,0,2,0,-2
9027,0,0,17,0,-17
9028,0,0,162,0,-162
9029,1,0,107,0,-107
9030,0,0,80,0,-80
9031,1,0,9,0,-9
9032,1,0,179,0,-179
9033,0,0,82,0,-82
9034,1,0,6,0,-6
9035,0,0,59,0,-59
9036,1,0,9,0,-9
9037,0,0,60,0,-60
9038,1,1,219,1804,1585
9039,1,0,7,0,-7
9040,1,1,541,1997,1456
9041,0,0,66,0,-66
9042,1,1,118,1235,1117
9043,0,0,130,0,-130
9044,1,1,764,2069,1305
9045,1,0,59,0,-59
9046,1,0,31,0,-31
9047,1,1,1041,3016,1975
9048,1,0,28,0,-28
9049,1,0,87,0,-87
9050,0,0,206,0,-206
9051,1,0,96,0,-96
9052,1,1,460,1330,870
9053,1,0,45,0,-45
9054,0,0,41,0,-41
9055,1,0,4,0,-4
9056,1,0,0,0,0
9057,1,1,597,1481,884
9058,0,0,134,0,-134
9059,1,1,53,1549,1496
9060,1,1,274,1431,1157
9061,1,0,82,0,-82
9062,0,0,7,0,-7
9063,0,0,69,0,-69
9064,0,0,16,0,-16
9065,1,0,56,0,-56
9066,0,0,35,0,-35
9067,1,0,190,0,-190
9068,1,0,29,0,-29
9069,1,0,20,0,-20
9070,1,0,29,0,-29
9071,0,0,28,0,-28
9072,1,1,536,1236,700
9073,0,0,12,0,-12
9074,0,0,64,0,-64
9075,1,1,1549,1661,112
9076,0,0,217,0,-217
9077,0,0,44,0,-44
9078,1,1,1498,1200,-298
9079,1,0,27,0,-27
9080,1,0,64,0,-64
9081,1,0,9,0,-9
9082,1,0,7,0,-7
9083,1,1,590,1219,629
9084,1,0,197,0,-197
9085,1,0,24,0,-24
9086,1,0,24,0,-24
9087,0,0,69,0,-69
9088,1,1,397,2199,1802
9089,1,0,166,0,-166
9090,0,0,53,0,-53
9091,1,1,886,1242,356
9092,0,0,7,0,-7
9093,1,0,58,0,-58
9094,0,0,222,0,-222
9095,1,1,44,1257,1213
9096,1,1,373,1668,1295
9097,1,0,55,0,-55
9098,1,1,286,1204,918
9099,0,0,24,0,-24
9100,1,0,15,0,-15
9101,1,0,76,0,-76
9102,0,0,14,0,-14
9103,0,0,64,0,-64
9104,0,0,104,0,-104
9105,1,0,30,0,-30
9106,1,0,17,0,-17
9107,1,0,24,0,-24
9108,0,0,3,0,-3
9109,1,0,18,0,-18
9110,1,0,197,0,-197
9111,0,0,41,0,-41
9112,0,0,13,0,-13
9113,0,0,40,0,-40
9114,0,0,70,0,-70
9115,0,0,171,0,-171
9116,1,0,15,0,-15
9117,1,0,11,0,-11
9118,1,1,632,1575,943
9119,0,0,197,0,-197
9120,1,1,440,1272,832
9121,1,1,22,1338,1316
9122,1,1,181,1505,1324
9123,1,1,64,1260,1196
9124,1,1,755,2333,1578
9125,0,0,102,0,-102
9126,1,0,3,0,-3
9127,1,0,26,0,-26
9128,0,0,13,0,-13
9129,1,0,19,0,-19
9130,1,1,391,1207,816
9131,1,1,275,1654,1379
9132,0,0,143,0,-143
9133,1,0,27,0,-27
9134,0,0,22,0,-22
9135,0,0,31,0,-31
9136,1,0,32,0,-32
9137,0,0,2,0,-2
9138,1,1,102,1230,1128
9139,1,0,34,0,-34
9140,0,0,7,0,-7
9141,0,0,1,0,-1
9142,1,0,206,0,-206
9143,1,0,0,0,0
9144,0,0,125,0,-125
9145,1,1,209,1215,1006
9146,0,0,84,0,-84
9147,1,0,7,0,-7
9148,1,0,30,0,-30
9149,1,0,5,0,-5
9150,0,0,45,0,-45
9151,0,0,8,0,-8
9152,1,1,259,1409,1150
9153,0,0,33,0,-33
9154,1,1,2744,1395,-1349
9155,1,0,19,0,-19
9156,1,0,31,0,-31
9157,0,0,124,0,-124
9158,0,0,56,0,-56
9159,1,1,614,2821,2207
9160,1,1,829,1217,388
9161,0,0,15,0,-15
9162,1,0,24,0,-24
9163,1,1,1094,1204,110
9164,0,0,42,0,-42
9165,0,0,5,0,-5
9166,1,1,1510,1206,-304
9167,1,0,79,0,-79
9168,1,0,45,0,-45
9169,1,1,134,1219,1085
9170,1,1,762,1337,575
9171,1,1,204,1675,1471
9172,1,1,1001,1226,225
9173,0,0,31,0,-31
9174,1,1,322,1241,919
9175,1,0,62,0,-62
9176,1,0,36,0,-36
9177,1,0,23,0,-23
9178,0,0,20,0,-20
9179,1,0,117,0,-117
9180,0,0,28,0,-28
9181,1,1,1492,1220,-272
9182,1,0,46,0,-46
9183,1,1,844,1252,408
9184,0,0,98,0,-98
9185,0,0,131,0,-131
9186,0,0,121,0,-121
9187,0,0,20,0,-20
9188,0,0,27,0,-27
9189,1,1,574,1400,826
9190,1,0,31,0,-31
9191,1,0,68,0,-68
9192,0,0,41,0,-41
9193,0,0,38,0,-38
9194,1,0,64,0,-64
9195,1,1,1155,1247,92
9196,1,0,13,0,-13
9197,1,0,92,0,-92
9198,0,0,16,0,-16
9199,1,1,105,1231,1126
9200,1,1,1069,1313,244
9201,1,1,271,1380,1109
9202,1,0,139,0,-139
9203,1,1,292,1689,1397
9204,0,0,5,0,-5
9205,1,1,521,1806,1285
9206,0,0,42,0,-42
9207,1,1,1230,1424,194
9208,1,1,420,1205,785
9209,1,0,134,0,-134
9210,1,0,49,0,-49
9211,1,0,109,0,-109
9212,0,0,31,0,-31
9213,0,0,30,0,-30
9214,0,0,11,0,-11
9215,0,0,155,0,-155
9216,0,0,5,0,-5
9217,1,0,15,0,-15
9218,1,0,77,0,-77
9219,0,0,7,0,-7
9220,1,0,6,0,-6
9221,1,0,145,0,-145
9222,1,0,38,0,-38
9223,1,0,42,0,-42
9224,0,0,124,0,-124
9225,1,1,1130,1436,306
9226,0,0,4,0,-4
9227,1,1,954,1215,261
9228,0,0,65,0,-65
9229,1,1,254,3147,2893
9230,0,0,54,0,-54
9231,0,0,162,0,-162
9232,0,0,86,0,-86
9233,1,0,26,0,-26
9234,0,0,3,0,-3
9235,1,1,1225,1944,719
9236,1,0,29,0,-29
9237,0,0,58,0,-58
9238,0,0,77,0,-77
9239,0,0,52,0,-52
9240,1,0,65,0,-65
9241,1,1,1203,1219,16
9242,1,1,552,1984,1432
9243,1,1,403,1267,864
9244,1,0,56,0,-56
9245,1,1,1021,1573,552
9246,0,0,69,0,-69
9247,1,0,152,0,-152
9248,1,1,593,1301,708
9249,1,0,56,0,-56
9250,1,1,227,1221,994
9251,0,0,4,0,-4
9252,1,1,634,1508,874
9253,0,0,17,0,-17
9254,1,1,522,3905,3383
9255,0,0,3,0,-3
9256,1,1,1376,1318,-58
9257,1,0,49,0,-49
9258,1,1,652,1299,647
9259,1,1,485,1316,831
9260,1,1,197,1229,1032
9261,1,0,233,0,-233
9262,1,1,331,1373,1042
9263,0,0,0,0,0
9264,0,0,8,0,-8
9265,1,1,840,1375,535
9266,1,0,38,0,-38
9267,0,0,9,0,-9
9268,0,0,37,0,-37
9269,0,0,3,0,-3
9270,0,0,104,0,-104
9271,0,0,26,0,-26
9272,1,1,357,1474,1117
9273,1,0,122,0,-122
9274,0,0,31,0,-31
9275,0,0,30,0,-30
9276,1,1,112,3462,3350
9277,1,1,316,1396,1080
9278,1,0,72,0,-72
9279,0,0,136,0,-136
9280,1,1,98,2052,1954
9281,0,0,24,0,-24
9282,0,0,28,0,-28
9283,1,1,90,1211,1121
9284,0,0,16,0,-16
9285,0,0,38,0,-38
9286,0,0,20,0,-20
9287,0,0,64,0,-64
9288,1,0,11,0,-11
9289,1,1,1112,1242,130
9290,0,0,45,0,-45
9291,0,0,68,0,-68
9292,1,1,43,1948,1905
9293,0,0,9,0,-9
9294,0,0,73,0,-73
9295,1,1,941,1785,844
9296,1,1,749,1711,962
9297,0,0,52,0,-52
9298,0,0,23,0,-23
9299,1,0,49,0,-49
9300,0,0,101,0,-101
9301,1,0,62,0,-62
9302,1,1,311,1774,1463
9303,0,0,28,0,-28
9304,0,0,1,0,-1
9305,1,0,26,0,-26
9306,1,1,1585,1704,119
9307,1,1,225,1633,1408
9308,0,0,10,0,-10
9309,0,0,25,0,-25
9310,0,0,25,0,-25
9311,0,0,6,0,-6
9312,1,1,922,1669,747
9313,0,0,31,0,-31
9314,0,0,205,0,-205
9315,1,0,16,0,-16
9316,0,0,174,0,-174
9317,1,1,623,1638,1015
9318,1,1,1173,1268,95
9319,0,0,31,0,-31
9320,1,0,0,0,0
9321,0,0,70,0,-70
9322,1,1,160,1230,1070
9323,1,1,363,1395,1032
9324,1,0,96,0,-96
9325,1,1,458,1887,1429
9326,0,0,83,0,-83
9327,1,1,191,2572,2381
9328,1,0,41,0,-41
9329,1,1,187,1945,1758
9330,0,0,40,0,-40
9331,1,1,146,2065,1919
9332,1,0,44,0,-44
9333,1,1,209,1266,1057
9334,0,0,33,0,-33
9335,1,0,44,0,-44
9336,1,0,78,0,-78
9337,0,0,141,0,-141
9338,1,1,414,1223,809
9339,0,0,22,0,-22
9340,0,0,45,0,-45
9341,0,0,15,0,-15
9342,1,0,126,0,-126
9343,1,1,492,1240,748
9344,0,0,54,0,-54
9345,0,0,35,0,-35
9346,1,1,754,1408,654
9347,1,1,644,1209,565
9348,1,1,132,1241,1109
9349,0,0,27,0,-27
9350,0,0,16,0,-16
9351,0,0,44,0,-44
9352,1,1,121,1704,1583
9353,0,0,82,0,-82
9354,1,1,174,1334,1160
9355,0,0,62,0,-62
9356,1,1,786,1507,721
9357,1,1,388,1342,954
9358,0,0,0,0,0
9359,0,0,67,0,-67
9360,1,0,0,0,0
9361,1,1,365,1365,1000
9362,1,0,72,0,-72
9363,0,0,144,0,-144
9364,1,1,55,1399,1344
9365,0,0,40,0,-40
9366,0,0,141,0,-141
9367,1,1,313,1512,1199
9368,1,0,10,0,-10
9369,0,0,74,0,-74
9370,1,1,395,2659,2264
9371,0,0,4,0,-4
9372,0,0,36,0,-36
9373,0,0,26,0,-26
9374,0,0,4,0,-4
9375,1,1,477,1878,1401
9376,0,0,22,0,-22
9377,0,0,30,0,-30
9378,1,1,120,1293,1173
9379,0,0,74,0,-74
9380,1,1,79,1259,1180
9381,1,0,15,0,-15
9382,0,0,172,0,-172
9383,1,1,315,1265,950
9384,1,0,25,0,-25
9385,1,0,20,0,-20
9386,1,1,87,1338,1251
9387,1,1,136,1275,1139
9388,1,1,284,1319,1035
9389,1,0,4,0,-4
9390,1,1,534,1246,712
9391,1,1,80,1696,1616
9392,1,1,108,1327,1219
9393,1,1,611,4041,3430
9394,1,0,14,0,-14
9395,0,0,47,0,-47
9396,0,0,6,0,-6
9397,0,0,12,0,-12
9398,0,0,19,0,-19
9399,1,0,95,0,-95
9400,1,0,4,0,-4
9401,0,0,32,0,-32
9402,1,1,731,2076,1345
9403,1,0,11,0,-11
9404,1,0,149,0,-149
9405,1,0,80,0,-80
9406,0,0,151,0,-151
9407,0,0,48,0,-48
9408,1,0,23,0,-23
9409,0,0,83,0,-83
9410,1,0,54,0,-54
9411,0,0,2,0,-2
9412,0,0,30,0,-30
9413,1,0,17,0,-17
9414,0,0,20,0,-20
9415,1,1,128,1419,1291
9416,1,0,47,0,-47
9417,1,1,956,1316,360
9418,1,1,629,1553,924
9419,0,0,46,0,-46
9420,1,0,155,0,-155
9421,0,0,16,0,-16
9422,1,1,84,1604,1520
9423,1,1,187,1257,1070
9424,1,1,188,1217,1029
9425,1,1,389,1263,874
9426,1,0,37,0,-37
9427,1,0,179,0,-179
9428,1,0,14,0,-14
9429,1,0,43,0,-43
9430,1,0,46,0,-46
9431,0,0,10,0,-10
9432,1,0,81,0,-81
9433,0,0,70,0,-70
9434,0,0,142,0,-142
9435,0,0,27,0,-27
9436,0,0,35,0,-35
9437,1,0,51,0,-51
9438,0,0,34,0,-34
9439,0,0,6,0,-6
9440,1,0,20,0,-20
9441,1,1,2243,1331,-912
9442,0,0,203,0,-203
9443,1,0,79,0,-79
9444,1,1,364,1252,888
9445,1,1,936,1665,729
9446,0,0,107,0,-107
9447,0,0,38,0,-38
9448,1,1,526,1882,1356
9449,1,0,27,0,-27
9450,0,0,8,0,-8
9451,0,0,9,0,-9
9452,1,0,21,0,-21
9453,0,0,144,0,-144
9454,1,1,455,1330,875
9455,1,0,84,0,-84
9456,1,0,27,0,-27
9457,0,0,27,0,-27
9458,1,1,714,1502,788
9459,0,0,23,0,-23
9460,0,0,25,0,-25
9461,0,0,78,0,-78
9462,1,0,14,0,-14
9463,1,1,142,1596,1454
9464,0,0,94,0,-94
9465,1,1,252,1928,1676
9466,1,0,52,0,-52
9467,0,0,168,0,-168
9468,0,0,9,0,-9
9469,1,0,39,0,-39
9470,1,1,149,1323,1174
9471,1,1,651,1317,666
9472,1,0,67,0,-67
9473,1,1,1477,1801,324
9474,1,0,88,0,-88
9475,0,0,112,0,-112
9476,1,1,56,1210,1154
9477,0,0,40,0,-40
9478,1,0,24,0,-24
9479,0,0,0,0,0
9480,1,1,23,1833,1810
9481,1,0,107,0,-107
9482,0,0,49,0,-49
9483,1,1,169,2250,2081
9484,1,0,3,0,-3
9485,0,0,31,0,-31
9486,0,0,59,0,-59
9487,1,1,384,1275,891
9488,1,0,9,0,-9
9489,0,0,11,0,-11
9490,0,0,13,0,-13
9491,0,0,104,0,-104
9492,0,0,125,0,-125
9493,1,1,221,1229,1008
9494,1,0,19,0,-19
9495,1,1,426,1372,946
9496,0,0,8,0,-8
9497,1,1,1061,1542,481
9498,0,0,71,0,-71
9499,1,0,57,0,-57
9500,1,0,0,0,0
9501,1,1,252,1351,1099
9502,0,0,23,0,-23
9503,1,1,217,2023,1806
9504,0,0,33,0,-33
9505,0,0,46,0,-46
9506,1,0,63,0,-63
9507,0,0,15,0,-15
9508,1,0,35,0,-35
9509,1,1,748,2084,1336
9510,0,0,23,0,-23
9511,0,0,59,0,-59
9512,1,1,286,1709,1423
9513,1,1,113,1592,1479
9514,0,0,64,0,-64
9515,0,0,96,0,-96
9516,1,1,159,1205,1046
9517,0,0,40,0,-40
9518,0,0,170,0,-170
9519,0,0,52,0,-52
9520,0,0,80,0,-80
9521,1,0,12,0,-12
9522,1,1,651,1298,647
9523,1,0,114,0,-114
9524,1,0,62,0,-62
9525,1,1,271,2003,1732
9526,1,0,58,0,-58
9527,0,0,63,0,-63
9528,0,0,157,0,-157
9529,0,0,175,0,-175
9530,1,0,86,0,-86
9531,1,1,774,1411,637
9532,0,0,6,0,-6
9533,0,0,32,0,-32
9534,1,1,466,1265,799
9535,0,0,99,0,-99
9536,1,0,227,0,-227
9537,1,0,74,0,-74
9538,1,1,50,1444,1394
9539,1,1,902,1783,881
9540,1,1,403,1817,1414
9541,0,0,59,0,-59
9542,1,0,66,0,-66
9543,1,1,379,1942,1563
9544,0,0,33,0,-33
9545,1,0,46,0,-46
9546,0,0,72,0,-72
9547,1,1,439,1472,1033
9548,0,0,87,0,-87
9549,1,0,31,0,-31
9550,1,1,453,1473,1020
9551,1,1,174,1375,1201
9552,1,1,92,1200,1108
9553,0,0,70,0,-70
9554,1,0,184,0,-184
9555,0,0,98,0,-98
9556,1,1,410,1622,1212
9557,1,0,34,0,-34
9558,0,0,3,0,-3
9559,0,0,78,0,-78
9560,1,0,40,0,-40
9561,0,0,50,0,-50
9562,0,0,22,0,-22
9563,0,0,11,0,-11
9564,0,0,19,0,-19
9565,1,0,32,0,-32
9566,0,0,1,0,-1
9567,0,0,6,0,-6
9568,1,0,146,0,-146
9569,0,0,98,0,-98
9570,0,0,24,0,-24
9571,0,0,88,0,-88
9572,1,0,32,0,-32
9573,0,0,12,0,-12
9574,1,0,20,0,-20
9575,0,0,16,0,-16
9576,1,0,183,0,-183
9577,1,1,44,1252,1208
9578,1,1,176,1859,1683
9579,1,1,505,1923,1418
9580,0,0,50,0,-50
9581,0,0,240,0,-240
9582,1,0,130,0,-130
9583,1,1,161,1440,1279
9584,1,1,914,1266,352
9585,0,0,116,0,-116
9586,1,1,215,1284,1069
9587,0,0,116,0,-116
9588,0,0,64,0,-64
9589,1,1,99,1315,1216
9590,0,0,36,0,-36
9591,1,0,15,0,-15
9592,0,0,2,0,-2
9593,1,1,435,1619,1184
9594,1,0,152,0,-152
9595,1,0,0,0,0
9596,1,1,121,1265,1144
9597,1,0,20,0,-20
9598,1,1,926,1276,350
9599,0,0,13,0,-13
9600,0,0,17,0,-17
9601,1,1,1247,1277,30
9602,0,0,220,0,-220
9603,1,0,13,0,-13
9604,1,1,358,1246,888
9605,1,1,194,2462,2268
9606,0,0,0,0,0
9607,1,0,10,0,-10
9608,1,0,4,0,-4
9609,1,1,469,1780,1311
9610,1,0,5,0,-5
9611,1,1,145,1434,1289
9612,0,0,67,0,-67
9613,1,0,112,0,-112
9614,0,0,13,0,-13
9615,1,1,1111,1582,471
9616,1,0,76,0,-76
9617,0,0,62,0,-62
9618,0,0,76,0,-76
9619,0,0,96,0,-96
9620,1,1,385,1268,883
9621,1,1,213,1289,1076
9622,0,0,20,0,-20
9623,1,0,50,0,-50
9624,0,0,35,0,-35
9625,0,0,1,0,-1
9626,1,0,10,0,-10
9627,0,0,19,0,-19
9628,1,0,23,0,-23
9629,1,1,77,1324,1247
9630,1,1,872,1403,531
9631,1,1,211,1252,1041
9632,0,0,2,0,-2
9633,1,0,4,0,-4
9634,1,1,475,1985,1510
9635,1,1,227,1362,1135
9636,1,1,268,1486,1218
9637,0,0,15,0,-15
9638,1,0,181,0,-181
9639,0,0,87,0,-87
9640,1,0,26,0,-26
9641,1,0,1,0,-1
9642,1,0,0,0,0
9643,1,0,13,0,-13
9644,1,1,394,1336,942
9645,1,0,74,0,-74
9646,1,1,3213,1215,-1998
9647,1,0,30,0,-30
9648,1,0,21,0,-21
9649,1,0,32,0,-32
9650,0,0,83,0,-83
9651,1,0,27,0,-27
9652,1,0,9,0,-9
9653,1,1,781,1460,679
9654,1,1,116,1519,1403
9655,1,0,13,0,-13
9656,1,1,355,2574,2219
9657,0,0,47,0,-47
9658,0,0,62,0,-62
9659,1,1,2,1270,1268
9660,1,1,1584,1254,-330
9661,0,0,127,0,-127
9662,1,1,596,1661,1065
9663,0,0,120,0,-120
9664,1,0,111,0,-111
9665,1,1,453,1259,806
9666,1,0,32,0,-32
9667,1,1,302,2467,2165
9668,1,1,607,1772,1165
9669,1,0,16,0,-16
9670,0,0,21,0,-21
9671,1,0,3,0,-3
9672,0,0,25,0,-25
9673,0,0,40,0,-40
9674,1,0,95,0,-95
9675,0,0,62,0,-62
9676,1,0,120,0,-120
9677,0,0,9,0,-9
9678,1,1,234,1232,998
9679,1,0,16,0,-16
9680,0,0,16,0,-16
9681,1,0,2,0,-2
9682,0,0,6,0,-6
9683,1,1,283,1634,1351
9684,0,0,49,0,-49
9685,1,0,5,0,-5
9686,1,0,112,0,-112
9687,0,0,20,0,-20
9688,1,1,1470,1309,-161
9689,0,0,27,0,-27
9690,1,0,63,0,-63
9691,1,0,11,0,-11
9692,1,0,155,0,-155
9693,1,1,400,1289,889
9694,1,0,91,0,-91
9695,0,0,21,0,-21
9696,0,0,55,0,-55
9697,1,1,703,1529,826
9698,1,0,75,0,-75
9699,0,0,237,0,-237
9700,1,1,241,1211,970
9701,1,1,269,2119,1850
9702,1,1,907,1448,541
9703,0,0,8,0,-8
9704,1,0,56,0,-56
9705,0,0,37,0,-37
9706,1,0,91,0,-91
9707,0,0,46,0,-46
9708,1,0,20,0,-20
9709,1,0,50,0,-50
9710,0,0,1,0,-1
9711,0,0,22,0,-22
9712,0,0,26,0,-26
9713,1,0,63,0,-63
9714,0,0,18,0,-18
9715,0,0,154,0,-154
9716,0,0,14,0,-14
9717,0,0,8,0,-8
9718,0,0,68,0,-68
9719,0,0,32,0,-32
9720,0,0,131,0,-131
9721,1,0,232,0,-232
9722,0,0,2,0,-2
9723,0,0,46,0,-46
9724,1,0,77,0,-77
9725,0,0,25,0,-25
9726,1,0,113,0,-113
9727,1,1,824,1325,501
9728,0,0,117,0,-117
9729,0,0,304,0,-304
9730,0,0,14,0,-14
9731,1,0,35,0,-35
9732,1,1,1867,1310,-557
9733,1,0,44,0,-44
9734,0,0,55,0,-55
9735,0,0,2,0,-2
9736,1,1,98,1247,1149
9737,0,0,15,0,-15
9738,1,0,5,0,-5
9739,0,0,18,0,-18
9740,1,0,3,0,-3
9741,0,0,100,0,-100
9742,1,1,313,2038,1725
9743,0,0,98,0,-98
9744,1,1,71,2007,1936
9745,1,1,307,1428,1121
9746,1,0,13,0,-13
9747,0,0,94,0,-94
9748,1,1,814,1716,902
9749,1,1,1106,1386,280
9750,1,0,39,0,-39
9751,1,1,190,1342,1152
9752,1,1,23,1281,1258
9753,1,1,67,1750,1683
9754,0,0,69,0,-69
9755,1,1,359,1448,1089
9756,0,0,9,0,-9
9757,1,1,937,1250,313
9758,1,0,5,0,-5
9759,1,0,31,0,-31
9760,0,0,54,0,-54
9761,1,1,75,1809,1734
9762,0,0,8,0,-8
9763,1,1,172,1323,1151
9764,0,0,5,0,-5
9765,1,0,72,0,-72
9766,0,0,14,0,-14
9767,0,0,39,0,-39
9768,0,0,12,0,-12
9769,1,0,5,0,-5
9770,1,0,27,0,-27
9771,0,0,56,0,-56
9772,1,1,1138,2573,1435
9773,0,0,14,0,-14
9774,0,0,21,0,-21
9775,0,0,104,0,-104
9776,1,0,79,0,-79
9777,0,0,11,0,-11
9778,0,0,73,0,-73
9779,1,0,71,0,-71
9780,1,1,621,1508,887
9781,0,0,5,0,-5
9782,1,0,1,0,-1
9783,1,0,43,0,-43
9784,0,0,5,0,-5
9785,0,0,105,0,-105
9786,1,1,1427,1297,-130
9787,1,0,4,0,-4
9788,0,0,55,0,-55
9789,1,0,69,0,-69
9790,0,0,39,0,-39
9791,1,0,15,0,-15
9792,1,0,48,0,-48
9793,0,0,7,0,-7
9794,0,0,6,0,-6
9795,1,0,35,0,-35
9796,1,0,77,0,-77
9797,0,0,36,0,-36
9798,0,0,60,0,-60
9799,0,0,169,0,-169
9800,1,0,94,0,-94
9801,1,1,1495,1506,11
9802,1,1,672,1421,749
9803,0,0,63,0,-63
9804,1,0,6,0,-6
9805,0,0,31,0,-31
9806,1,0,114,0,-114
9807,1,1,453,1291,838
9808,0,0,152,0,-152
9809,1,0,186,0,-186
9810,1,0,122,0,-122
9811,1,0,91,0,-91
9812,1,0,8,0,-8
9813,1,0,108,0,-108
9814,1,0,36,0,-36
9815,0,0,138,0,-138
9816,0,0,15,0,-15
9817,1,1,58,1215,1157
9818,1,1,497,1764,1267
9819,1,0,29,0,-29
9820,1,1,593,1347,754
9821,0,0,34,0,-34
9822,1,1,747,1668,921
9823,1,1,1017,1499,482
9824,0,0,16,0,-16
9825,0,0,23,0,-23
9826,1,0,110,0,-110
9827,0,0,18,0,-18
9828,1,1,949,1876,927
9829,1,1,158,1330,1172
9830,1,1,420,1267,847
9831,1,1,329,1321,992
9832,0,0,115,0,-115
9833,1,0,15,0,-15
9834,0,0,53,0,-53
9835,1,1,1283,2171,888
9836,0,0,173,0,-173
9837,0,0,1,0,-1
9838,0,0,10,0,-10
9839,0,0,11,0,-11
9840,1,1,579,1459,880
9841,0,0,32,0,-32
9842,0,0,17,0,-17
9843,0,0,20,0,-20
9844,1,0,73,0,-73
9845,0,0,60,0,-60
9846,1,0,61,0,-61
9847,1,1,815,1244,429
9848,1,0,39,0,-39
9849,1,1,389,1601,1212
9850,0,0,19,0,-19
9851,0,0,99,0,-99
9852,1,0,39,0,-39
9853,1,1,1093,1433,340
9854,1,0,40,0,-40
9855,0,0,93,0,-93
9856,1,0,104,0,-104
9857,1,1,593,1600,1007
9858,0,0,76,0,-76
9859,0,0,42,0,-42
9860,0,0,27,0,-27
9861,1,0,54,0,-54
9862,0,0,34,0,-34
9863,1,0,34,0,-34
9864,1,1,443,1246,803
9865,0,0,11,0,-11
9866,0,0,54,0,-54
9867,1,1,140,1737,1597
9868,1,0,29,0,-29
9869,1,0,151,0,-151
9870,0,0,26,0,-26
9871,1,0,39,0,-39
9872,1,1,379,2583,2204
9873,1,0,59,0,-59
9874,1,0,12,0,-12
9875,1,1,313,1266,953
9876,1,1,614,1435,821
9877,1,1,260,1982,1722
9878,0,0,58,0,-58
9879,1,1,557,2502,1945
9880,1,0,37,0,-37
9881,0,0,12,0,-12
9882,1,0,20,0,-20
9883,0,0,33,0,-33
9884,0,0,197,0,-197
9885,0,0,42,0,-42
9886,0,0,35,0,-35
9887,1,1,361,1623,1262
9888,1,0,3,0,-3
9889,1,0,0,0,0
9890,0,0,80,0,-80
9891,0,0,23,0,-23
9892,0,0,101,0,-101
9893,0,0,7,0,-7
9894,1,0,77,0,-77
9895,1,0,64,0,-64
9896,0,0,18,0,-18
9897,0,0,90,0,-90
9898,0,0,99,0,-99
9899,0,0,47,0,-47
9900,0,0,16,0,-16
9901,0,0,4,0,-4
9902,0,0,36,0,-36
9903,1,1,373,2060,1687
9904,1,1,500,2591,2091
9905,0,0,23,0,-23
9906,1,1,150,1265,1115
9907,0,0,55,0,-55
9908,1,0,45,0,-45
9909,0,0,26,0,-26
9910,1,1,695,1248,553
9911,0,0,13,0,-13
9912,1,1,449,1411,962
9913,1,0,12,0,-12
9914,1,1,312,1753,1441
9915,0,0,107,0,-107
9916,0,0,32,0,-32
9917,0,0,51,0,-51
9918,0,0,68,0,-68
9919,0,0,0,0,0
9920,1,1,422,2220,1798
9921,1,1,534,1595,1061
9922,1,0,39,0,-39
9923,1,1,817,1210,393
9924,1,0,4,0,-4
9925,0,0,97,0,-97
9926,1,1,77,1392,1315
9927,1,0,50,0,-50
9928,1,1,107,1831,1724
9929,1,1,841,1432,591
9930,1,1,214,1741,1527
9931,0,0,24,0,-24
9932,0,0,1,0,-1
9933,0,0,39,0,-39
9934,1,1,396,1227,831
9935,1,0,103,0,-103
9936,1,1,1403,1256,-147
9937,1,0,17,0,-17
9938,0,0,44,0,-44
9939,0,0,116,0,-116
9940,1,1,697,1300,603
9941,0,0,6,0,-6
9942,0,0,5,0,-5
9943,1,0,81,0,-81
9944,1,0,40,0,-40
9945,0,0,63,0,-63
9946,1,1,186,1298,1112
9947,1,0,40,0,-40
9948,1,1,1138,1254,116
9949,0,0,6,0,-6
9950,1,1,617,1211,594
9951,1,0,4,0,-4
9952,1,1,379,1259,880
9953,1,1,2215,1344,-871
9954,0,0,4,0,-4
9955,1,0,25,0,-25
9956,0,0,34,0,-34
9957,1,0,33,0,-33
9958,0,0,40,0,-40
9959,1,0,178,0,-178
9960,1,1,122,1227,1105
9961,0,0,23,0,-23
9962,1,0,47,0,-47
9963,0,0,38,0,-38
9964,1,1,1522,1417,-105
9965,1,0,15,0,-15
9966,1,0,314,0,-314
9967,0,0,37,0,-37
9968,0,0,36,0,-36
9969,1,0,133,0,-133
9970,1,1,421,1479,1058
9971,0,0,6,0,-6
9972,0,0,16,0,-16
9973,1,1,1911,1927,16
9974,0,0,78,0,-78
9975,1,1,150,1256,1106
9976,1,0,4,0,-4
9977,0,0,65,0,-65
9978,1,0,209,0,-209
9979,1,0,28,0,-28
9980,0,0,11,0,-11
9981,1,1,468,1772,1304
9982,0,0,3,0,-3
9983,1,0,13,0,-13
9984,1,0,32,0,-32
9985,1,0,21,0,-21
9986,0,0,113,0,-113
9987,1,0,44,0,-44
9988,0,0,2,0,-2
9989,0,0,36,0,-36
9990,1,0,32,0,-32
9991,1,0,4,0,-4
9992,0,0,52,0,-52
9993,1,0,70,0,-70
9994,0,0,77,0,-77
9995,0,0,20,0,-20
9996,1,1,321,1968,1647
9997,0,0,40,0,-40
9998,1,0,38,0,-38
9999,1,1,190,1771,1581
10000,0,0,12,0,-12
10001,0,0,7,0,-7
10002,1,0,42,0,-42
10003,1,1,264,1247,983
10004,1,0,54,0,-54
10005,0,0,14,0,-14
10006,1,1,949,1273,324
10007,1,0,115,0,-115
10008,1,1,571,1446,875
10009,1,0,43,0,-43
10010,1,1,130,2046,1916
10011,1,0,36,0,-36
10012,1,0,8,0,-8
10013,1,0,19,0,-19
10014,1,0,17,0,-17
10015,0,0,41,0,-41
10016,1,0,76,0,-76
10017,0,0,40,0,-40
10018,1,1,512,1974,1462
10019,0,0,15,0,-15
10020,1,1,1529,1399,-130
10021,0,0,16,0,-16
10022,1,0,55,0,-55
10023,0,0,94,0,-94
10024,0,0,66,0,-66
10025,0,0,170,0,-170
10026,1,1,109,1229,1120
10027,1,1,182,1395,1213
10028,1,0,22,0,-22
10029,0,0,16,0,-16
10030,1,1,115,1217,1102
10031,1,0,187,0,-187
10032,0,0,28,0,-28
10033,0,0,0,0,0
10034,1,0,19,0,-19
10035,1,1,184,1271,1087
10036,0,0,59,0,-59
10037,1,0,43,0,-43
10038,0,0,9,0,-9
10039,0,0,117,0,-117
10040,1,1,234,1292,1058
10041,1,1,98,1305,1207
10042,0,0,45,0,-45
10043,1,1,555,1739,1184
10044,1,1,99,1452,1353
10045,1,0,17,0,-17
10046,1,1,644,1355,711
10047,1,1,149,1789,1640
10048,1,1,1765,2054,289
10049,1,1,573,1270,697
10050,1,1,923,1584,661
10051,0,0,17,0,-17
10052,1,0,18,0,-18
10053,0,0,45,0,-45
10054,0,0,41,0,-41
10055,1,1,840,1772,932
10056,0,0,63,0,-63
10057,1,0,39,0,-39
10058,0,0,28,0,-28
10059,1,0,113,0,-113
10060,0,0,5,0,-5
10061,1,0,85,0,-85
10062,1,1,414,1671,1257
10063,0,0,56,0,-56
10064,1,0,22,0,-22
10065,0,0,67,0,-67
10066,0,0,150,0,-150
10067,0,0,100,0,-100
10068,1,1,85,1475,1390
10069,1,1,1362,2061,699
10070,0,0,9,0,-9
10071,1,0,25,0,-25
10072,1,1,589,1269,680
10073,1,0,20,0,-20
10074,1,0,131,0,-131
10075,0,0,69,0,-69
10076,0,0,3,0,-3
10077,1,0,49,0,-49
10078,1,1,550,2163,1613
10079,1,1,1069,1222,153
10080,0,0,30,0,-30
10081,1,1,456,1268,812
10082,1,1,1362,1682,320
10083,1,1,161,1283,1122
10084,0,0,72,0,-72
10085,1,1,59,1214,1155
10086,1,0,8,0,-8
10087,1,1,643,1599,956
10088,0,0,102,0,-102
10089,0,0,133,0,-133
10090,1,0,45,0,-45
10091,1,0,4,0,-4
10092,1,1,382,1613,1231
10093,1,0,58,0,-58
10094,1,1,821,1412,591
10095,0,0,41,0,-41
10096,1,0,67,0,-67
10097,1,0,93,0,-93
10098,1,0,127,0,-127
10099,1,0,6,0,-6
10100,1,1,202,1292,1090
10101,1,1,729,1670,941
10102,1,1,644,2074,1430
10103,1,1,105,4240,4135
10104,1,1,255,1358,1103
10105,0,0,96,0,-96
10106,1,0,53,0,-53
10107,0,0,15,0,-15
10108,1,0,80,0,-80
10109,1,1,871,3095,2224
10110,1,0,10,0,-10
10111,1,0,113,0,-113
10112,0,0,26,0,-26
10113,0,0,56,0,-56
10114,1,0,4,0,-4
10115,1,1,771,1538,767
10116,1,1,282,1440,1158
10117,0,0,97,0,-97
10118,0,0,10,0,-10
10119,0,0,17,0,-17
10120,1,0,1,0,-1
10121,1,0,8,0,-8
10122,1,0,46,0,-46
10123,0,0,47,0,-47
10124,1,0,13,0,-13
10125,1,0,4,0,-4
10126,1,1,359,1235,876
10127,0,0,56,0,-56
10128,1,1,213,1446,1233
10129,1,1,284,1984,1700
10130,0,0,4,0,-4
10131,1,0,12,0,-12
10132,1,1,86,1242,1156
10133,1,1,795,1503,708
10134,0,0,15,0,-15
10135,1,0,27,0,-27
10136,1,1,1123,1202,79
10137,1,1,166,1321,1155
10138,1,0,85,0,-85
10139,1,1,1881,1238,-643
10140,1,0,47,0,-47
10141,0,0,18,0,-18
10142,0,0,27,0,-27
10143,1,0,6,0,-6
10144,1,0,51,0,-51
10145,0,0,38,0,-38
10146,0,0,279,0,-279
10147,1,1,1522,1225,-297
10148,1,0,236,0,-236
10149,1,1,1068,1201,133
10150,0,0,150,0,-150
10151,0,0,22,0,-22
10152,1,1,41,1412,1371
10153,1,0,26,0,-26
10154,1,1,808,1532,724
10155,1,1,166,1210,1044
10156,0,0,5,0,-5
10157,0,0,16,0,-16
10158,1,1,376,1255,879
10159,1,1,1113,1579,466
10160,1,1,1935,1682,-253
10161,1,1,31,1811,1780
10162,0,0,14,0,-14
10163,1,1,198,1274,1076
10164,1,1,104,1206,1102
10165,0,0,0,0,0
10166,1,0,5,0,-5
10167,1,1,6,2145,2139
10168,1,0,32,0,-32
10169,1,1,433,2107,1674
10170,1,0,51,0,-51
10171,1,1,254,1305,1051
10172,1,0,32,0,-32
10173,0,0,8,0,-8
10174,1,1,760,1285,525
10175,0,0,30,0,-30
10176,1,1,715,1487,772
10177,1,0,24,0,-24
10178,1,0,55,0,-55
10179,1,0,17,0,-17
10180,1,0,8,0,-8
10181,0,0,85,0,-85
10182,0,0,25,0,-25
10183,1,1,566,1466,900
10184,1,0,2,0,-2
10185,0,0,50,0,-50
10186,1,1,423,1324,901
10187,1,1,289,1656,1367
10188,1,0,32,0,-32
10189,1,0,54,0,-54
10190,0,0,10,0,-10
10191,1,0,26,0,-26
10192,1,1,133,1681,1548
10193,1,1,271,1370,1099
10194,0,0,61,0,-61
10195,1,1,793,1218,425
10196,0,0,71,0,-71
10197,1,1,398,1402,1004
10198,0,0,1,0,-1
10199,1,0,32,0,-32
10200,1,1,2988,1338,-1650
10201,0,0,39,0,-39
10202,0,0,130,0,-130
10203,1,0,74,0,-74
10204,1,0,106,0,-106
10205,0,0,44,0,-44
10206,0,0,186,0,-186
10207,0,0,68,0,-68
10208,1,1,1289,1834,545
10209,1,1,701,1210,509
10210,1,1,1255,1217,-38
10211,0,0,32,0,-32
10212,0,0,8,0,-8
10213,1,1,731,1852,1121
10214,0,0,46,0,-46
10215,0,0,13,0,-13
10216,0,0,38,0,-38
10217,0,0,50,0,-50
10218,1,1,87,1219,1132
10219,1,1,587,3405,2818
10220,1,0,101,0,-101
10221,0,0,3,0,-3
10222,1,1,640,1778,1138
10223,1,1,247,1530,1283
10224,1,0,96,0,-96
10225,1,1,431,1763,1332
10226,1,0,13,0,-13
10227,1,0,34,0,-34
10228,1,1,342,1320,978
10229,1,0,17,0,-17
10230,0,0,22,0,-22
10231,0,0,153,0,-153
10232,1,1,936,1317,381
10233,0,0,0,0,0
10234,1,1,305,1833,1528
10235,1,0,7,0,-7
10236,1,0,1,0,-1
10237,1,1,440,1274,834
10238,0,0,47,0,-47
10239,1,0,4,0,-4
10240,1,1,144,1708,1564
10241,0,0,123,0,-123
10242,0,0,51,0,-51
10243,1,0,100,0,-100
10244,0,0,16,0,-16
10245,0,0,6,0,-6
10246,1,0,192,0,-192
10247,1,1,18,2040,2022
10248,1,1,56,1295,1239
10249,1,1,329,2155,1826
10250,0,0,9,0,-9
10251,1,0,73,0,-73
10252,0,0,33,0,-33
10253,0,0,23,0,-23
10254,1,1,64,1313,1249
10255,1,1,491,2004,1513
10256,1,0,101,0,-101
10257,1,1,1184,1975,791
10258,0,0,28,0,-28
10259,1,0,5,0,-5
10260,0,0,47,0,-47
10261,1,1,248,1885,1637
10262,0,0,20,0,-20
10263,1,0,89,0,-89
10264,1,1,90,1507,1417
10265,0,0,86,0,-86
10266,0,0,107,0,-107
10267,1,1,337,1214,877
10268,1,1,582,1213,631
10269,1,0,1,0,-1
10270,1,1,1272,1396,124
10271,1,0,11,0,-11
10272,0,0,86,0,-86
10273,0,0,52,0,-52
10274,0,0,17,0,-17
10275,0,0,78,0,-78
10276,1,1,950,1442,492
10277,1,1,990,1346,356
10278,1,1,584,1472,888
10279,1,1,302,1669,1367
10280,1,0,87,0,-87
10281,1,0,31,0,-31
10282,1,1,611,3056,2445
10283,0,0,16,0,-16
10284,1,1,163,1232,1069
10285,0,0,20,0,-20
10286,1,1,233,1401,1168
10287,1,1,315,1359,1044
10288,1,0,12,0,-12
10289,0,0,3,0,-3
10290,1,1,1104,1248,144
10291,1,1,629,1690,1061
10292,1,1,996,1423,427
10293,1,0,29,0,-29
10294,1,0,2,0,-2
10295,0,0,69,0,-69
10296,1,1,506,1228,722
10297,1,1,520,1572,1052
10298,1,1,15,1252,1237
10299,1,1,28,1410,1382
10300,1,1,199,1270,1071
10301,0,0,11,0,-11
10302,1,1,1026,1260,234
10303,0,0,190,0,-190
10304,1,0,34,0,-34
10305,0,0,47,0,-47
10306,0,0,9,0,-9
10307,1,1,155,1586,1431
10308,1,1,271,1587,1316
10309,1,0,83,0,-83
10310,1,0,18,0,-18
10311,1,1,1086,1305,219
10312,0,0,74,0,-74
10313,1,1,3409,1340,-2069
10314,1,1,371,1230,859
10315,0,0,68,0,-68
10316,1,1,743,1314,571
10317,0,0,46,0,-46
10318,1,0,0,0,0
10319,1,0,21,0,-21
10320,1,1,332,1890,1558
10321,1,1,76,2693,2617
10322,1,0,13,0,-13
10323,1,1,231,5053,4822
10324,1,0,60,0,-60
10325,0,0,22,0,-22
10326,0,0,102,0,-102
10327,1,1,111,1603,1492
10328,0,0,4,0,-4
10329,1,1,1115,1264,149
10330,1,0,117,0,-117
10331,1,0,137,0,-137
10332,1,0,15,0,-15
10333,1,0,3,0,-3
10334,1,1,499,1343,844
10335,0,0,14,0,-14
10336,1,1,1462,1712,250
10337,0,0,78,0,-78
10338,0,0,74,0,-74
10339,1,1,300,1687,1387
10340,1,0,20,0,-20
10341,0,0,94,0,-94
10342,1,0,7,0,-7
10343,1,0,304,0,-304
10344,0,0,124,0,-124
10345,0,0,11,0,-11
10346,1,1,890,1635,745
10347,1,1,576,1227,651
10348,0,0,76,0,-76
10349,0,0,13,0,-13
10350,1,1,295,1609,1314
10351,1,0,4,0,-4
10352,1,0,86,0,-86
10353,1,0,3,0,-3
10354,1,1,187,2245,2058
10355,0,0,86,0,-86
10356,1,1,614,1342,728
10357,1,0,0,0,0
10358,1,1,363,1289,926
10359,1,0,21,0,-21
10360,1,0,86,0,-86
10361,0,0,172,0,-172
10362,1,0,19,0,-19
10363,0,0,20,0,-20
10364,0,0,34,0,-34
10365,1,0,88,0,-88
10366,1,0,35,0,-35
10367,1,1,191,1210,1019
10368,0,0,0,0,0
10369,0,0,58,0,-58
10370,1,1,784,1239,455
10371,1,1,674,1213,539
10372,1,0,6,0,-6
10373,1,0,13,0,-13
10374,1,1,180,2095,1915
10375,0,0,63,0,-63
10376,1,1,295,2163,1868
10377,0,0,127,0,-127
10378,0,0,2,0,-2
10379,0,0,64,0,-64
10380,1,0,2,0,-2
10381,0,0,52,0,-52
10382,0,0,38,0,-38
10383,1,1,628,1251,623
10384,0,0,201,0,-201
10385,0,0,124,0,-124
10386,1,1,249,1216,967
10387,1,1,221,4100,3879
10388,1,1,1389,2807,1418
10389,1,1,458,1720,1262
10390,1,0,171,0,-171
10391,1,1,177,1667,1490
10392,1,1,383,1290,907
10393,1,0,129,0,-129
10394,1,1,263,1636,1373
10395,1,1,332,1490,1158
10396,1,1,559,1344,785
10397,1,0,31,0,-31
10398,1,0,211,0,-211
10399,1,1,14,1329,1315
10400,1,0,19,0,-19
10401,1,0,54,0,-54
10402,1,1,625,1621,996
10403,1,0,64,0,-64
10404,1,1,496,1344,848
10405,0,0,88,0,-88
10406,0,0,37,0,-37
10407,0,0,77,0,-77
10408,0,0,6,0,-6
10409,1,1,1468,1478,10
10410,1,1,993,1548,555
10411,1,1,914,1252,338
10412,1,1,294,1214,920
10413,1,0,48,0,-48
10414,1,0,9,0,-9
10415,1,0,37,0,-37
10416,1,1,212,1321,1109
10417,0,0,22,0,-22
10418,0,0,189,0,-189
10419,0,0,4,0,-4
10420,1,0,84,0,-84
10421,1,0,0,0,0
10422,1,1,365,1445,1080
10423,1,1,198,1503,1305
10424,0,0,5,0,-5
10425,0,0,61,0,-61
10426,1,0,106,0,-106
10427,1,1,1651,2618,967
10428,0,0,48,0,-48
10429,1,1,430,1462,1032
10430,0,0,55,0,-55
10431,0,0,46,0,-46
10432,1,0,186,0,-186
10433,1,1,795,1346,551
10434,1,1,79,1725,1646
10435,1,0,33,0,-33
10436,0,0,5,0,-5
10437,1,0,31,0,-31
10438,1,0,112,0,-112
10439,1,0,6,0,-6
10440,0,0,90,0,-90
10441,1,0,31,0,-31
10442,1,1,982,1374,392
10443,0,0,89,0,-89
10444,1,0,27,0,-27
10445,1,0,5,0,-5
10446,1,0,40,0,-40
10447,0,0,25,0,-25
10448,0,0,17,0,-17
10449,0,0,107,0,-107
10450,1,1,565,1928,1363
10451,1,1,715,1694,979
10452,1,1,424,1356,932
10453,1,0,338,0,-338
10454,0,0,58,0,-58
10455,0,0,14,0,-14
10456,0,0,101,0,-101
10457,0,0,12,0,-12
10458,1,0,23,0,-23
10459,0,0,27,0,-27
10460,1,1,179,1420,1241
10461,1,1,505,1264,759
10462,1,0,3,0,-3
10463,1,1,1678,1797,119
10464,1,1,251,1455,1204
10465,1,1,368,1635,1267
10466,1,0,39,0,-39
10467,1,1,1361,1250,-111
10468,0,0,16,0,-16
10469,1,0,126,0,-126
10470,1,0,72,0,-72
10471,1,0,86,0,-86
10472,0,0,92,0,-92
10473,1,1,326,1894,1568
10474,1,1,777,2052,1275
10475,1,1,799,1374,575
10476,1,0,1,0,-1
10477,1,1,70,1240,1170
10478,1,0,39,0,-39
10479,1,1,620,2161,1541
10480,1,1,73,1265,1192
10481,1,0,2,0,-2
10482,0,0,4,0,-4
10483,0,0,4,0,-4
10484,1,0,29,0,-29
10485,1,1,388,1552,1164
10486,1,0,2,0,-2
10487,1,1,303,1431,1128
10488,1,0,47,0,-47
10489,0,0,2,0,-2
10490,0,0,7,0,-7
10491,0,0,47,0,-47
10492,1,0,37,0,-37
10493,0,0,38,0,-38
10494,0,0,85,0,-85
10495,1,1,532,1292,760
10496,1,1,537,1564,1027
10497,1,1,62,2450,2388
10498,1,1,221,2012,1791
10499,0,0,7,0,-7
10500,1,1,239,1281,1042
10501,0,0,91,0,-91
10502,1,1,275,1297,1022
10503,0,0,40,0,-40
10504,1,1,290,1487,1197
10505,0,0,0,0,0
10506,1,0,16,0,-16
10507,1,0,110,0,-110
10508,1,1,261,1286,1025
10509,1,0,15,0,-15
10510,1,0,192,0,-192
10511,1,1,1157,1405,248
10512,0,0,77,0,-77
10513,1,1,59,1674,1615
10514,1,1,410,1212,802
10515,1,1,1429,1458,29
10516,1,0,4,0,-4
10517,1,0,68,0,-68
10518,0,0,57,0,-57
10519,0,0,59,0,-59
10520,1,1,186,1821,1635
10521,0,0,76,0,-76
10522,1,0,144,0,-144
10523,1,0,6,0,-6
10524,1,0,51,0,-51
10525,1,0,146,0,-146
10526,0,0,14,0,-14
10527,0,0,62,0,-62
10528,0,0,27,0,-27
10529,1,0,31,0,-31
10530,0,0,18,0,-18
10531,1,1,238,1544,1306
10532,1,0,74,0,-74
10533,0,0,30,0,-30
10534,0,0,13,0,-13
10535,1,1,916,1587,671
10536,0,0,56,0,-56
10537,1,0,28,0,-28
10538,0,0,4,0,-4
10539,1,0,13,0,-13
10540,0,0,2,0,-2
10541,0,0,14,0,-14
10542,0,0,97,0,-97
10543,0,0,7,0,-7
10544,0,0,88,0,-88
10545,1,0,1,0,-1
10546,1,0,31,0,-31
10547,1,1,1040,1325,285
10548,1,1,514,3886,3372
10549,0,0,0,0,0
10550,1,1,154,1264,1110
10551,0,0,154,0,-154
10552,1,0,115,0,-115
10553,1,0,72,0,-72
10554,1,1,1167,1200,33
10555,0,0,10,0,-10
10556,0,0,10,0,-10
10557,1,1,588,1842,1254
10558,1,0,196,0,-196
10559,1,1,402,1793,1391
10560,1,1,124,1633,1509
10561,1,1,280,1243,963
10562,1,1,481,2432,1951
10563,1,0,36,0,-36
10564,0,0,72,0,-72
10565,1,1,2671,1499,-1172
10566,1,1,5330,1382,-3948
10567,1,0,10,0,-10
10568,1,1,534,1401,867
10569,0,0,0,0,0
10570,1,0,1,0,-1
10571,1,0,47,0,-47
10572,0,0,7,0,-7
10573,1,1,127,1436,1309
10574,1,0,8,0,-8
10575,1,0,32,0,-32
10576,1,1,269,4511,4242
10577,0,0,20,0,-20
10578,0,0,13,0,-13
10579,0,0,7,0,-7
10580,0,0,72,0,-72
10581,0,0,0,0,0
10582,1,1,353,1502,1149
10583,1,1,356,1688,1332
10584,1,1,843,1310,467
10585,1,0,67,0,-67
10586,0,0,111,0,-111
10587,1,1,782,1463,681
10588,0,0,94,0,-94
10589,1,1,555,1425,870
10590,1,0,17,0,-17
10591,1,1,97,2272,2175
10592,1,0,25,0,-25
10593,1,0,58,0,-58
10594,1,0,42,0,-42
10595,0,0,11,0,-11
10596,1,1,256,1677,1421
10597,1,1,361,1445,1084
10598,1,1,692,1308,616
10599,1,1,2811,1429,-1382
10600,1,0,84,0,-84
10601,1,1,664,1232,568
10602,0,0,3,0,-3
10603,0,0,10,0,-10
10604,0,0,24,0,-24
10605,1,1,1836,1675,-161
10606,1,1,534,2328,1794
10607,1,0,24,0,-24
10608,1,1,82,1265,1183
10609,1,1,363,2325,1962
10610,1,0,14,0,-14
10611,1,0,42,0,-42
10612,0,0,55,0,-55
10613,0,0,5,0,-5
10614,0,0,0,0,0
10615,1,0,12,0,-12
10616,1,0,15,0,-15
10617,0,0,37,0,-37
10618,0,0,66,0,-66
10619,1,1,134,1404,1270
10620,1,0,53,0,-53
10621,1,1,433,1675,1242
10622,0,0,16,0,-16
10623,0,0,107,0,-107
10624,1,1,228,2174,1946
10625,1,0,89,0,-89
10626,1,1,374,1584,1210
10627,1,0,40,0,-40
10628,1,0,56,0,-56
10629,0,0,116,0,-116
10630,1,1,172,1427,1255
10631,0,0,119,0,-119
10632,1,0,4,0,-4
10633,1,1,358,1295,937
10634,1,1,499,1241,742
10635,1,1,1664,1284,-380
10636,0,0,90,0,-90
10637,0,0,97,0,-97
10638,0,0,1,0,-1
10639,1,0,35,0,-35
10640,1,1,1430,1820,390
10641,1,0,2,0,-2
10642,1,1,96,1380,1284
10643,0,0,65,0,-65
10644,0,0,55,0,-55
10645,1,0,28,0,-28
10646,0,0,49,0,-49
10647,1,0,70,0,-70
10648,1,0,6,0,-6
10649,1,1,309,1239,930
10650,0,0,190,0,-190
10651,0,0,97,0,-97
10652,1,1,283,1702,1419
10653,0,0,23,0,-23
10654,1,0,145,0,-145
10655,0,0,48,0,-48
10656,1,1,171,1358,1187
10657,0,0,130,0,-130
10658,0,0,52,0,-52
10659,0,0,43,0,-43
10660,0,0,15,0,-15
10661,1,1,118,1573,1455
10662,0,0,1,0,-1
10663,0,0,74,0,-74
10664,0,0,22,0,-22
10665,0,0,48,0,-48
10666,0,0,62,0,-62
10667,1,1,1357,1359,2
10668,1,1,539,1668,1129
10669,1,1,238,1242,1004
10670,0,0,7,0,-7
10671,0,0,1,0,-1
10672,0,0,42,0,-42
10673,0,0,36,0,-36
10674,1,1,232,1629,1397
10675,0,0,35,0,-35
10676,1,0,39,0,-39
10677,0,0,4,0,-4
10678,1,1,1073,1496,423
10679,0,0,55,0,-55
10680,1,0,8,0,-8
10681,1,0,118,0,-118
10682,1,1,827,1276,449
10683,0,0,24,0,-24
10684,1,0,30,0,-30
10685,1,0,4,0,-4
10686,0,0,0,0,0
10687,0,0,27,0,-27
10688,1,1,478,1298,820
10689,1,1,560,1293,733
10690,1,0,3,0,-3
10691,1,0,10,0,-10
10692,1,0,155,0,-155
10693,1,0,9,0,-9
10694,1,1,492,1457,965
10695,1,1,925,1212,287
10696,0,0,38,0,-38
10697,1,0,87,0,-87
10698,0,0,156,0,-156
10699,0,0,34,0,-34
10700,1,0,66,0,-66
10701,1,0,19,0,-19
10702,1,0,24,0,-24
10703,1,0,145,0,-145
10704,1,0,1,0,-1
10705,0,0,46,0,-46
10706,1,0,49,0,-49
10707,1,0,23,0,-23
10708,1,1,1486,1323,-163
10709,0,0,134,0,-134
10710,1,1,701,1816,1115
10711,1,0,83,0,-83
10712,1,0,16,0,-16
10713,1,0,99,0,-99
10714,1,0,50,0,-50
10715,1,0,55,0,-55
10716,1,1,284,1305,1021
10717,0,0,45,0,-45
10718,1,0,15,0,-15
10719,0,0,24,0,-24
10720,1,0,21,0,-21
10721,1,1,295,1360,1065
10722,1,0,1,0,-1
10723,1,1,68,1553,1485
10724,0,0,55,0,-55
10725,0,0,19,0,-19
10726,1,1,27,1436,1409
10727,1,1,711,1571,860
10728,0,0,50,0,-50
10729,0,0,26,0,-26
10730,1,0,232,0,-232
10731,1,1,444,1271,827
10732,1,0,159,0,-159
10733,0,0,53,0,-53
10734,0,0,18,0,-18
10735,0,0,100,0,-100
10736,1,1,256,1271,1015
10737,1,0,120,0,-120
10738,1,1,921,1404,483
10739,1,1,713,2022,1309
10740,1,1,242,1221,979
10741,0,0,7,0,-7
10742,1,0,100,0,-100
10743,0,0,8,0,-8
10744,0,0,116,0,-116
10745,1,1,841,1461,620
10746,1,0,178,0,-178
10747,0,0,14,0,-14
10748,1,1,364,1512,1148
10749,0,0,23,0,-23
10750,1,0,27,0,-27
10751,0,0,23,0,-23
10752,1,0,1,0,-1
10753,1,1,452,1335,883
10754,0,0,21,0,-21
10755,0,0,46,0,-46
10756,1,0,0,0,0
10757,0,0,127,0,-127
10758,0,0,97,0,-97
10759,0,0,85,0,-85
10760,1,0,94,0,-94
10761,1,0,95,0,-95
10762,1,0,70,0,-70
10763,1,1,324,1866,1542
10764,0,0,37,0,-37
10765,1,1,36,1317,1281
10766,1,0,87,0,-87
10767,0,0,53,0,-53
10768,1,1,275,1275,1000
10769,0,0,64,0,-64
10770,1,1,493,1347,854
10771,0,0,4,0,-4
10772,0,0,31,0,-31
10773,0,0,110,0,-110
10774,1,0,165,0,-165
10775,0,0,20,0,-20
10776,0,0,5,0,-5
10777,1,1,558,1671,1113
10778,1,0,35,0,-35
10779,0,0,78,0,-78
10780,0,0,1,0,-1
10781,1,0,53,0,-53
10782,0,0,64,0,-64
10783,1,0,56,0,-56
10784,0,0,105,0,-105
10785,1,0,63,0,-63
10786,0,0,179,0,-179
10787,0,0,13,0,-13
10788,1,1,525,2213,1688
10789,1,1,89,1678,1589
10790,1,0,2,0,-2
10791,1,0,118,0,-118
10792,1,0,42,0,-42
10793,1,0,126,0,-126
10794,1,0,33,0,-33
10795,1,0,50,0,-50
10796,0,0,58,0,-58
10797,1,1,289,1782,1493
10798,1,1,888,1289,401
10799,0,0,31,0,-31
10800,0,0,139,0,-139
10801,0,0,23,0,-23
10802,0,0,55,0,-55
10803,1,0,5,0,-5
10804,0,0,68,0,-68
10805,0,0,2,0,-2
10806,0,0,94,0,-94
10807,1,0,108,0,-108
10808,0,0,14,0,-14
10809,0,0,10,0,-10
10810,0,0,6,0,-6
10811,1,0,43,0,-43
10812,0,0,70,0,-70
10813,1,1,1457,1997,540
10814,1,1,523,1411,888
10815,0,0,75,0,-75
10816,0,0,53,0,-53
10817,1,1,79,1262,1183
10818,0,0,32,0,-32
10819,1,1,1095,1665,570
10820,1,0,155,0,-155
10821,0,0,44,0,-44
10822,1,1,203,1688,1485
10823,0,0,0,0,0
10824,0,0,136,0,-136
10825,1,0,78,0,-78
10826,1,0,86,0,-86
10827,0,0,54,0,-54
10828,1,0,7,0,-7
10829,1,1,224,1954,1730
10830,1,1,235,1265,1030
10831,1,1,263,1653,1390
10832,1,1,349,1371,1022
10833,1,1,1584,2014,430
10834,0,0,146,0,-146
10835,0,0,172,0,-172
10836,1,0,44,0,-44
10837,1,1,1789,1213,-576
10838,1,0,151,0,-151
10839,1,1,291,1288,997
10840,0,0,19,0,-19
10841,1,0,28,0,-28
10842,1,1,558,1712,1154
10843,1,1,954,1598,644
10844,0,0,32,0,-32
10845,0,0,151,0,-151
10846,0,0,13,0,-13
10847,1,0,114,0,-114
10848,0,0,19,0,-19
10849,1,0,33,0,-33
10850,1,0,49,0,-49
10851,0,0,57,0,-57
10852,0,0,199,0,-199
10853,0,0,12,0,-12
10854,1,1,508,1376,868
10855,1,0,15,0,-15
10856,0,0,2,0,-2
10857,0,0,1,0,-1
10858,1,1,65,1410,1345
10859,1,1,927,1277,350
10860,0,0,12,0,-12
10861,0,0,29,0,-29
10862,1,0,75,0,-75
10863,0,0,36,0,-36
10864,1,1,617,2639,2022
10865,1,1,813,1273,460
10866,1,0,102,0,-102
10867,1,0,12,0,-12
10868,0,0,4,0,-4
10869,1,1,624,1882,1258
10870,0,0,48,0,-48
10871,0,0,17,0,-17
10872,1,1,522,1388,866
10873,1,1,313,1448,1135
10874,0,0,8,0,-8
10875,0,0,32,0,-32
10876,1,0,130,0,-130
10877,0,0,85,0,-85
10878,1,1,602,1374,772
10879,0,0,21,0,-21
10880,1,0,97,0,-97
10881,1,1,1247,1758,511
10882,1,1,798,1242,444
10883,0,0,22,0,-22
10884,1,1,618,1210,592
10885,1,1,553,1557,1004
10886,1,1,435,1605,1170
10887,1,1,58,1814,1756
10888,1,0,85,0,-85
10889,0,0,2,0,-2
10890,1,1,1739,1344,-395
10891,1,0,111,0,-111
10892,1,0,15,0,-15
10893,0,0,7,0,-7
10894,1,1,1134,1427,293
10895,0,0,11,0,-11
10896,1,1,268,1962,1694
10897,0,0,9,0,-9
10898,0,0,9,0,-9
10899,0,0,116,0,-116
10900,1,1,702,1498,796
10901,0,0,15,0,-15
10902,1,0,131,0,-131
10903,1,1,1271,4383,3112
10904,1,1,57,1212,1155
10905,1,1,144,1351,1207
10906,0,0,24,0,-24
10907,0,0,98,0,-98
10908,0,0,16,0,-16
10909,1,0,29,0,-29
10910,0,0,152,0,-152
10911,0,0,7,0,-7
10912,0,0,54,0,-54
10913,1,1,448,1498,1050
10914,0,0,22,0,-22
10915,1,1,691,1358,667
10916,1,1,910,1258,348
10917,0,0,4,0,-4
10918,0,0,25,0,-25
10919,1,0,95,0,-95
10920,1,0,14,0,-14
10921,0,0,4,0,-4
10922,0,0,5,0,-5
10923,1,0,7,0,-7
10924,1,0,29,0,-29
10925,0,0,51,0,-51
10926,0,0,48,0,-48
10927,0,0,150,0,-150
10928,1,1,123,1386,1263
10929,1,0,3,0,-3
10930,0,0,169,0,-169
10931,1,1,689,1447,758
10932,1,0,4,0,-4
10933,0,0,55,0,-55
10934,1,0,151,0,-151
10935,0,0,2,0,-2
10936,0,0,8,0,-8
10937,0,0,63,0,-63
10938,0,0,26,0,-26
10939,1,1,1764,1711,-53
10940,1,1,604,1340,736
10941,1,1,2047,1705,-342
10942,1,1,2021,1215,-806
10943,1,0,4,0,-4
10944,1,1,660,1468,808
10945,1,0,19,0,-19
10946,0,0,1,0,-1
10947,1,0,47,0,-47
10948,1,1,214,1201,987
10949,1,1,212,1397,1185
10950,1,0,162,0,-162
10951,1,0,4,0,-4
10952,0,0,74,0,-74
10953,0,0,12,0,-12
10954,0,0,52,0,-52
10955,1,0,5,0,-5
10956,0,0,37,0,-37
10957,1,0,28,0,-28
10958,1,1,241,2375,2134
10959,1,0,30,0,-30
10960,0,0,7,0,-7
10961,1,0,56,0,-56
10962,0,0,102,0,-102
10963,1,0,78,0,-78
10964,1,1,251,2182,1931
10965,1,1,1591,1322,-269
10966,1,1,142,1457,1315
10967,0,0,113,0,-113
10968,1,1,872,1756,884
10969,1,1,719,1245,526
10970,1,0,17,0,-17
10971,0,0,63,0,-63
10972,1,0,4,0,-4
10973,0,0,23,0,-23
10974,1,1,37,1223,1186
10975,1,0,31,0,-31
10976,1,0,13,0,-13
10977,1,1,1206,2651,1445
10978,0,0,85,0,-85
10979,1,0,56,0,-56
10980,0,0,19,0,-19
10981,1,0,3,0,-3
10982,1,0,35,0,-35
10983,1,1,219,1618,1399
10984,1,1,383,2494,2111
10985,1,0,86,0,-86
10986,0,0,27,0,-27
10987,0,0,28,0,-28
10988,0,0,2,0,-2
10989,1,0,14,0,-14
10990,1,0,14,0,-14
10991,0,0,88,0,-88
10992,1,0,39,0,-39
10993,1,0,97,0,-97
10994,1,1,220,1296,1076
10995,0,0,41,0,-41
10996,1,0,25,0,-25
10997,1,0,13,0,-13
10998,1,1,100,1540,1440
10999,0,0,1,0,-1
11000,1,1,581,1389,808
11001,1,1,595,1219,624
11002,1,0,30,0,-30
11003,0,0,37,0,-37
11004,1,1,364,1552,1188
11005,1,0,28,0,-28
11006,1,1,1345,1270,-75
11007,0,0,92,0,-92
11008,1,0,14,0,-14
11009,0,0,21,0,-21
11010,1,1,230,1682,1452
11011,1,1,448,1500,1052
11012,0,0,18,0,-18
11013,1,1,78,1380,1302
11014,0,0,16,0,-16
11015,1,1,1498,1257,-241
11016,1,1,265,1542,1277
11017,1,1,10,1245,1235
11018,1,1,286,1734,1448
11019,1,0,93,0,-93
11020,0,0,36,0,-36
11021,1,1,1585,1346,-239
11022,1,1,326,1359,1033
11023,1,1,441,2848,2407
11024,1,0,96,0,-96
11025,1,1,47,1494,1447
11026,1,1,493,1768,1275
11027,1,1,324,1936,1612
11028,1,0,20,0,-20
11029,0,0,34,0,-34
11030,0,0,33,0,-33
11031,1,0,45,0,-45
11032,1,1,533,1253,720
11033,1,1,27,1590,1563
11034,1,0,22,0,-22
11035,0,0,7,0,-7
11036,1,0,58,0,-58
11037,0,0,87,0,-87
11038,1,1,2160,1269,-891
11039,1,0,94,0,-94
11040,1,0,103,0,-103
11041,1,0,59,0,-59
11042,0,0,71,0,-71
11043,1,1,1045,1242,197
11044,0,0,43,0,-43
11045,0,0,41,0,-41
11046,1,1,355,1417,1062
11047,0,0,117,0,-117
11048,1,0,52,0,-52
11049,0,0,129,0,-129
11050,0,0,26,0,-26
11051,1,0,90,0,-90
11052,1,1,149,1274,1125
11053,0,0,5,0,-5
11054,1,0,116,0,-116
11055,1,0,71,0,-71
11056,0,0,18,0,-18
11057,1,0,2,0,-2
11058,1,1,465,1418,953
11059,1,1,411,1441,1030
11060,0,0,117,0,-117
11061,0,0,93,0,-93
11062,1,0,26,0,-26
11063,0,0,77,0,-77
11064,0,0,4,0,-4
11065,0,0,2,0,-2
11066,1,0,4,0,-4
11067,0,0,9,0,-9
11068,0,0,0,0,0
11069,0,0,27,0,-27
11070,0,0,56,0,-56
11071,1,1,1798,1357,-441
11072,1,1,585,2159,1574
11073,0,0,6,0,-6
11074,1,1,113,1219,1106
11075,0,0,32,0,-32
11076,1,0,5,0,-5
11077,1,1,462,1384,922
11078,1,0,0,0,0
11079,1,0,160,0,-160
11080,0,0,21,0,-21
11081,1,0,4,0,-4
11082,1,1,1420,1310,-110
11083,0,0,90,0,-90
11084,1,0,71,0,-71
11085,1,0,167,0,-167
11086,1,1,279,1725,1446
11087,0,0,30,0,-30
11088,1,1,1511,1569,58
11089,1,0,40,0,-40
11090,1,1,1704,1417,-287
11091,1,1,1017,1943,926
11092,0,0,29,0,-29
11093,1,0,1,0,-1
11094,1,1,781,1265,484
11095,0,0,95,0,-95
11096,1,1,514,1637,1123
11097,1,0,63,0,-63
11098,0,0,90,0,-90
11099,1,0,30,0,-30
11100,1,1,1048,1814,766
11101,0,0,68,0,-68
11102,1,1,96,1392,1296
11103,1,1,735,1714,979
11104,1,0,59,0,-59
11105,1,1,420,1294,874
11106,1,0,62,0,-62
11107,1,0,56,0,-56
11108,0,0,56,0,-56
11109,1,1,563,1360,797
11110,0,0,75,0,-75
11111,1,0,177,0,-177
11112,0,0,48,0,-48
11113,0,0,120,0,-120
11114,1,0,43,0,-43
11115,0,0,73,0,-73
11116,0,0,50,0,-50
11117,0,0,35,0,-35
11118,1,0,13,0,-13
11119,0,0,71,0,-71
11120,0,0,124,0,-124
11121,1,1,429,1700,1271
11122,1,0,96,0,-96
11123,1,1,777,1331,554
11124,0,0,20,0,-20
11125,0,0,16,0,-16
11126,1,0,18,0,-18
11127,1,1,612,1274,662
11128,0,0,43,0,-43
11129,1,0,121,0,-121
11130,1,0,31,0,-31
11131,1,1,239,1448,1209
11132,0,0,57,0,-57
11133,0,0,4,0,-4
11134,1,0,22,0,-22
11135,0,0,0,0,0
11136,0,0,14,0,-14
11137,1,0,18,0,-18
11138,1,0,10,0,-10
11139,0,0,26,0,-26
11140,0,0,16,0,-16
11141,1,0,13,0,-13
11142,0,0,31,0,-31
11143,0,0,82,0,-82
11144,0,0,81,0,-81
11145,1,1,704,1279,575
11146,0,0,36,0,-36
11147,0,0,1,0,-1
11148,0,0,102,0,-102
11149,1,1,151,1712,1561
11150,1,1,761,1788,1027
11151,1,0,23,0,-23
11152,1,0,36,0,-36
11153,0,0,69,0,-69
11154,1,0,96,0,-96
11155,1,1,216,2288,2072
11156,0,0,5,0,-5
11157,1,0,38,0,-38
11158,1,0,31,0,-31
11159,0,0,15,0,-15
11160,0,0,31,0,-31
11161,1,1,346,1563,1217
11162,1,1,198,1456,1258
11163,1,1,1640,1304,-336
11164,0,0,2,0,-2
11165,1,0,74,0,-74
11166,0,0,16,0,-16
11167,0,0,0,0,0
11168,1,1,158,1241,1083
11169,1,1,331,1545,1214
11170,0,0,66,0,-66
11171,1,0,6,0,-6
11172,1,1,108,1218,1110
11173,0,0,10,0,-10
11174,0,0,46,0,-46
11175,0,0,26,0,-26
11176,1,1,424,1257,833
11177,1,0,141,0,-141
11178,0,0,6,0,-6
11179,0,0,49,0,-49
11180,0,0,25,0,-25
11181,1,1,797,1324,527
11182,0,0,33,0,-33
11183,1,0,50,0,-50
11184,0,0,7,0,-7
11185,1,1,187,1743,1556
11186,0,0,13,0,-13
11187,1,1,310,1851,1541
11188,0,0,38,0,-38
11189,1,0,163,0,-163
11190,0,0,17,0,-17
11191,0,0,7,0,-7
11192,1,0,106,0,-106
11193,1,0,59,0,-59
11194,0,0,90,0,-90
11195,1,1,34,2898,2864
11196,0,0,81,0,-81
11197,1,1,840,1275,435
11198,1,1,643,1369,726
11199,0,0,25,0,-25
11200,1,0,60,0,-60
11201,1,1,680,1484,804
11202,0,0,52,0,-52
11203,1,0,44,0,-44
11204,0,0,17,0,-17
11205,0,0,1,0,-1
11206,1,0,18,0,-18
11207,0,0,33,0,-33
11208,0,0,9,0,-9
11209,1,0,56,0,-56
11210,1,1,1322,1422,100
11211,1,1,354,1498,1144
11212,1,0,31,0,-31
11213,1,0,68,0,-68
11214,0,0,107,0,-107
11215,1,1,1514,1387,-127
11216,0,0,85,0,-85
11217,0,0,61,0,-61
11218,1,1,101,1262,1161
11219,1,1,148,1261,1113
11220,1,1,451,1539,1088
11221,1,1,340,1240,900
11222,0,0,50,0,-50
11223,1,1,55,1591,1536
11224,0,0,24,0,-24
11225,1,1,50,1507,1457
11226,0,0,105,0,-105
11227,0,0,32,0,-32
11228,0,0,42,0,-42
11229,0,0,52,0,-52
11230,1,1,305,1760,1455
11231,0,0,26,0,-26
11232,1,0,54,0,-54
11233,1,0,4,0,-4
11234,0,0,53,0,-53
11235,0,0,9,0,-9
11236,1,0,84,0,-84
11237,1,0,10,0,-10
11238,0,0,162,0,-162
11239,0,0,8,0,-8
11240,1,0,0,0,0
11241,1,1,1243,1386,143
11242,1,0,32,0,-32
11243,1,0,204,0,-204
11244,0,0,43,0,-43
11245,0,0,94,0,-94
11246,1,0,16,0,-16
11247,1,0,13,0,-13
11248,1,0,53,0,-53
11249,1,1,736,1420,684
11250,1,0,3,0,-3
11251,1,1,403,1494,1091
11252,1,1,221,1431,1210
11253,0,0,4,0,-4
11254,0,0,19,0,-19
11255,1,0,61,0,-61
11256,0,0,76,0,-76
11257,1,1,167,1418,1251
11258,1,0,20,0,-20
11259,0,0,25,0,-25
11260,1,0,206,0,-206
11261,0,0,18,0,-18
11262,0,0,60,0,-60
11263,1,1,948,1522,574
11264,1,1,473,1803,1330
11265,0,0,20,0,-20
11266,1,0,45,0,-45
11267,0,0,46,0,-46
11268,1,1,431,1336,905
11269,0,0,173,0,-173
11270,0,0,124,0,-124
11271,1,1,569,1458,889
11272,1,1,812,1752,940
11273,1,0,77,0,-77
11274,0,0,0,0,0
11275,1,0,192,0,-192
11276,0,0,46,0,-46
11277,1,0,37,0,-37
11278,1,1,1218,1943,725
11279,1,1,136,1402,1266
11280,1,1,328,1440,1112
11281,1,0,29,0,-29
11282,1,0,5,0,-5
11283,0,0,8,0,-8
11284,1,1,344,1239,895
11285,1,0,98,0,-98
11286,1,0,53,0,-53
11287,1,0,55,0,-55
11288,1,1,367,1217,850
11289,0,0,17,0,-17
11290,1,1,660,1261,601
11291,0,0,33,0,-33
11292,0,0,108,0,-108
11293,0,0,85,0,-85
11294,1,1,112,1325,1213
11295,0,0,57,0,-57
11296,1,0,108,0,-108
11297,0,0,23,0,-23
11298,1,0,10,0,-10
11299,0,0,53,0,-53
11300,0,0,56,0,-56
11301,1,1,58,1353,1295
11302,1,1,954,1683,729
11303,0,0,82,0,-82
11304,1,0,227,0,-227
11305,1,1,653,2587,1934
11306,1,1,1327,2604,1277
11307,0,0,2,0,-2
11308,1,0,1,0,-1
11309,1,0,5,0,-5
11310,1,0,18,0,-18
11311,0,0,4,0,-4
11312,0,0,66,0,-66
11313,1,0,2,0,-2
11314,0,0,85,0,-85
11315,1,1,1322,1567,245
11316,1,0,0,0,0
11317,0,0,72,0,-72
11318,1,0,16,0,-16
11319,1,0,13,0,-13
11320,0,0,57,0,-57
11321,0,0,57,0,-57
11322,1,0,25,0,-25
11323,0,0,72,0,-72
11324,1,0,117,0,-117
11325,1,0,9,0,-9
11326,0,0,52,0,-52
11327,0,0,140,0,-140
11328,0,0,41,0,-41
11329,1,1,166,1268,1102
11330,1,0,31,0,-31
11331,0,0,64,0,-64
11332,0,0,12,0,-12
11333,1,0,16,0,-16
11334,1,1,1601,1236,-365
11335,0,0,7,0,-7
11336,0,0,36,0,-36
11337,1,0,30,0,-30
11338,1,1,800,1229,429
11339,1,0,100,0,-100
11340,1,0,149,0,-149
11341,1,0,97,0,-97
11342,0,0,21,0,-21
11343,1,0,7,0,-7
11344,1,0,93,0,-93
11345,0,0,57,0,-57
11346,0,0,11,0,-11
11347,1,0,34,0,-34
11348,1,1,748,1269,521
11349,1,0,10,0,-10
11350,0,0,32,0,-32
11351,0,0,31,0,-31
11352,0,0,49,0,-49
11353,1,0,34,0,-34
11354,0,0,76,0,-76
11355,0,0,26,0,-26
11356,1,1,80,1238,1158
11357,0,0,45,0,-45
11358,1,0,17,0,-17
11359,1,0,14,0,-14
11360,0,0,4,0,-4
11361,0,0,38,0,-38
11362,1,0,81,0,-81
11363,0,0,108,0,-108
11364,1,0,53,0,-53
11365,0,0,40,0,-40
11366,0,0,212,0,-212
11367,1,1,381,1470,1089
11368,0,0,47,0,-47
11369,1,0,51,0,-51
11370,1,0,14,0,-14
11371,0,0,62,0,-62
11372,0,0,12,0,-12
11373,1,1,469,1476,1007
11374,1,1,211,2486,2275
11375,0,0,107,0,-107
11376,1,1,101,1566,1465
11377,0,0,4,0,-4
11378,0,0,57,0,-57
11379,1,0,22,0,-22
11380,0,0,46,0,-46
11381,1,1,898,1413,515
11382,0,0,20,0,-20
11383,0,0,13,0,-13
11384,1,0,58,0,-58
11385,1,1,958,3461,2503
11386,1,0,5,0,-5
11387,0,0,49,0,-49
11388,1,0,25,0,-25
11389,1,1,467,1273,806
11390,1,0,31,0,-31
11391,0,0,0,0,0
11392,0,0,104,0,-104
11393,1,0,31,0,-31
11394,0,0,40,0,-40
11395,0,0,65,0,-65
11396,1,0,219,0,-219
11397,1,0,5,0,-5
11398,0,0,98,0,-98
11399,1,0,181,0,-181
11400,0,0,73,0,-73
11401,1,1,454,1411,957
11402,1,1,106,1784,1678
11403,1,0,0,0,0
11404,1,1,166,1597,1431
11405,0,0,76,0,-76
11406,0,0,63,0,-63
11407,1,0,72,0,-72
11408,1,1,280,2232,1952
11409,0,0,76,0,-76
11410,0,0,40,0,-40
11411,1,0,207,0,-207
11412,1,0,23,0,-23
11413,1,1,1308,1406,98
11414,1,0,43,0,-43
11415,0,0,52,0,-52
11416,1,0,14,0,-14
11417,0,0,19,0,-19
11418,1,0,286,0,-286
11419,0,0,16,0,-16
11420,1,1,630,1292,662
11421,1,1,409,1440,1031
11422,1,1,694,1905,1211
11423,0,0,106,0,-106
11424,1,0,18,0,-18
11425,1,0,46,0,-46
11426,1,1,893,1349,456
11427,1,0,43,0,-43
11428,0,0,76,0,-76
11429,1,0,81,0,-81
11430,1,1,350,4143,3793
11431,0,0,115,0,-115
11432,1,0,9,0,-9
11433,1,0,210,0,-210
11434,0,0,148,0,-148
11435,0,0,57,0,-57
11436,0,0,2,0,-2
11437,1,1,153,1211,1058
11438,0,0,158,0,-158
11439,1,1,157,4131,3974
11440,0,0,10,0,-10
11441,1,0,47,0,-47
11442,1,0,66,0,-66
11443,0,0,47,0,-47
11444,0,0,19,0,-19
11445,1,1,420,1527,1107
11446,1,0,24,0,-24
11447,1,0,39,0,-39
11448,1,0,10,0,-10
11449,1,1,646,1423,777
11450,1,1,613,1299,686
11451,1,0,81,0,-81
11452,1,1,346,1796,1450
11453,1,1,835,1345,510
11454,1,0,39,0,-39
11455,1,0,96,0,-96
11456,0,0,80,0,-80
11457,1,1,841,1452,611
11458,0,0,53,0,-53
11459,0,0,21,0,-21
11460,1,0,5,0,-5
11461,0,0,52,0,-52
11462,1,0,6,0,-6
11463,0,0,33,0,-33
11464,1,1,58,2168,2110
11465,1,1,177,1412,1235
11466,0,0,6,0,-6
11467,1,0,86,0,-86
11468,1,0,2,0,-2
11469,1,1,723,1330,607
11470,1,0,170,0,-170
11471,1,0,87,0,-87
11472,1,1,460,1339,879
11473,1,1,102,2318,2216
11474,0,0,32,0,-32
11475,1,0,101,0,-101
11476,1,1,431,1284,853
11477,1,1,135,3259,3124
11478,1,1,357,1534,1177
11479,0,0,27,0,-27
11480,1,1,910,1382,472
11481,1,1,1679,1332,-347
11482,1,1,224,1344,1120
11483,0,0,31,0,-31
11484,0,0,30,0,-30
11485,1,1,549,1301,752
11486,1,1,145,1451,1306
11487,1,0,10,0,-10
11488,1,0,0,0,0
11489,1,0,17,0,-17
11490,1,0,61,0,-61
11491,1,0,4,0,-4
11492,0,0,72,0,-72
11493,1,0,88,0,-88
11494,1,0,63,0,-63
11495,1,0,53,0,-53
11496,1,1,58,1299,1241
11497,0,0,0,0,0
11498,0,0,13,0,-13
11499,0,0,237,0,-237
11500,1,0,2,0,-2
11501,0,0,37,0,-37
11502,1,0,7,0,-7
11503,1,0,195,0,-195
11504,1,1,930,4049,3119
11505,1,1,184,1228,1044
11506,0,0,36,0,-36
11507,0,0,12,0,-12
11508,0,0,74,0,-74
11509,0,0,12,0,-12
11510,0,0,0,0,0
11511,0,0,204,0,-204
11512,0,0,128,0,-128
11513,1,1,705,1297,592
11514,1,0,65,0,-65
11515,1,0,45,0,-45
11516,1,1,677,1318,641
11517,0,0,3,0,-3
11518,0,0,87,0,-87
11519,1,0,60,0,-60
11520,1,0,11,0,-11
11521,0,0,56,0,-56
11522,1,1,699,1214,515
11523,0,0,14,0,-14
11524,1,0,22,0,-22
11525,1,0,52,0,-52
11526,1,0,42,0,-42
11527,0,0,38,0,-38
11528,0,0,10,0,-10
11529,1,0,3,0,-3
11530,0,0,35,0,-35
11531,1,1,140,3615,3475
11532,1,0,17,0,-17
11533,1,0,63,0,-63
11534,1,0,39,0,-39
11535,0,0,16,0,-16
11536,1,0,49,0,-49
11537,0,0,22,0,-22
11538,0,0,4,0,-4
11539,1,0,1,0,-1
11540,0,0,5,0,-5
11541,0,0,6,0,-6
11542,1,0,5,0,-5
11543,0,0,23,0,-23
11544,1,1,912,1488,576
11545,1,1,96,1586,1490
11546,0,0,32,0,-32
11547,1,1,1900,1315,-585
11548,1,0,35,0,-35
11549,1,1,657,1227,570
11550,1,0,79,0,-79
11551,0,0,80,0,-80
11552,1,0,49,0,-49
11553,1,0,14,0,-14
11554,0,0,0,0,0
11555,1,1,494,1219,725
11556,1,0,55,0,-55
11557,1,1,1023,1241,218
11558,1,1,141,3241,3100
11559,1,0,12,0,-12
11560,1,1,70,1272,1202
11561,1,1,650,1461,811
11562,0,0,36,0,-36
11563,0,0,26,0,-26
11564,0,0,7,0,-7
11565,1,0,6,0,-6
11566,0,0,30,0,-30
11567,0,0,11,0,-11
11568,0,0,4,0,-4
11569,0,0,132,0,-132
11570,0,0,110,0,-110
11571,0,0,27,0,-27
11572,0,0,114,0,-114
11573,1,1,263,1295,1032
11574,0,0,69,0,-69
11575,1,0,42,0,-42
11576,1,1,953,3106,2153
11577,1,1,864,1209,345
11578,1,0,196,0,-196
11579,1,1,457,1417,960
11580,1,0,29,0,-29
11581,1,0,109,0,-109
11582,0,0,3,0,-3
11583,0,0,18,0,-18
11584,0,0,0,0,0
11585,1,1,961,1277,316
11586,1,0,12,0,-12
11587,0,0,15,0,-15
11588,1,1,359,1481,1122
11589,1,1,1001,1770,769
11590,0,0,218,0,-218
11591,0,0,34,0,-34
11592,1,0,40,0,-40
11593,1,1,468,1415,947
11594,1,1,314,1340,1026
11595,1,0,153,0,-153
11596,1,0,50,0,-50
11597,1,1,518,1804,1286
11598,0,0,53,0,-53
11599,0,0,33,0,-33
11600,1,0,44,0,-44
11601,1,0,24,0,-24
11602,1,1,152,1438,1286
11603,1,1,438,1386,948
11604,0,0,16,0,-16
11605,0,0,5,0,-5
11606,1,1,1030,1598,568
11607,0,0,98,0,-98
11608,1,1,351,1436,1085
11609,1,1,1142,1251,109
11610,1,0,38,0,-38
11611,1,1,452,1591,1139
11612,1,1,20,1620,1600
11613,1,0,39,0,-39
11614,0,0,9,0,-9
11615,0,0,14,0,-14
11616,0,0,61,0,-61
11617,1,1,418,1682,1264
11618,1,0,12,0,-12
11619,1,1,777,1781,1004
11620,1,1,1178,1681,503
11621,1,1,140,1616,1476
11622,0,0,19,0,-19
11623,1,1,1064,1240,176
11624,1,0,11,0,-11
11625,1,1,65,1526,1461
11626,0,0,108,0,-108
11627,1,0,27,0,-27
11628,1,0,27,0,-27
11629,1,0,110,0,-110
11630,1,0,129,0,-129
11631,0,0,81,0,-81
11632,1,1,1274,1725,451
11633,0,0,110,0,-110
11634,1,0,12,0,-12
11635,0,0,6,0,-6
11636,1,0,24,0,-24
11637,1,0,6,0,-6
11638,1,1,615,1428,813
11639,1,0,23,0,-23
11640,0,0,1,0,-1
11641,1,1,2058,1241,-817
11642,0,0,14,0,-14
11643,1,1,530,1742,1212
11644,1,0,90,0,-90
11645,1,1,26,1979,1953
11646,1,0,7,0,-7
11647,1,1,1216,1556,340
11648,1,0,90,0,-90
11649,1,0,89,0,-89
11650,1,1,329,1425,1096
11651,1,0,15,0,-15
11652,1,1,215,2308,2093
11653,1,1,442,2015,1573
11654,0,0,5,0,-5
11655,0,0,74,0,-74
11656,1,1,172,1464,1292
11657,1,0,107,0,-107
11658,1,1,492,1582,1090
11659,1,0,26,0,-26
11660,0,0,174,0,-174
11661,1,0,2,0,-2
11662,0,0,60,0,-60
11663,1,0,82,0,-82
11664,0,0,11,0,-11
11665,0,0,80,0,-80
11666,1,0,3,0,-3
11667,0,0,6,0,-6
11668,1,1,176,1669,1493
11669,1,1,433,1202,769
11670,1,0,1,0,-1
11671,0,0,49,0,-49
11672,0,0,26,0,-26
11673,1,1,380,1469,1089
11674,0,0,137,0,-137
11675,0,0,32,0,-32
11676,1,0,32,0,-32
11677,1,0,40,0,-40
11678,0,0,12,0,-12
11679,0,0,25,0,-25
11680,1,0,20,0,-20
11681,1,0,1,0,-1
11682,0,0,8,0,-8
11683,1,0,49,0,-49
11684,0,0,144,0,-144
11685,1,1,471,2244,1773
11686,1,1,210,1287,1077
11687,0,0,66,0,-66
11688,1,1,465,1225,760
11689,1,1,159,2395,2236
11690,1,1,1214,1275,61
11691,1,0,1,0,-1
11692,1,0,45,0,-45
11693,0,0,62,0,-62
11694,1,0,91,0,-91
11695,0,0,8,0,-8
11696,1,0,0,0,0
11697,1,1,879,1979,1100
11698,1,1,328,1546,1218
11699,1,0,261,0,-261
11700,1,1,838,1524,686
11701,0,0,6,0,-6
11702,0,0,24,0,-24
11703,0,0,32,0,-32
11704,1,0,0,0,0
11705,1,1,554,1737,1183
11706,1,0,107,0,-107
11707,1,1,2265,2539,274
11708,1,0,30,0,-30
11709,0,0,1,0,-1
11710,0,0,69,0,-69
11711,0,0,5,0,-5
11712,0,0,79,0,-79
11713,1,1,653,1655,1002
11714,0,0,1,0,-1
11715,0,0,44,0,-44
11716,1,1,1726,1310,-416
11717,1,1,275,1399,1124
11718,1,0,51,0,-51
11719,1,0,23,0,-23
11720,1,1,608,1380,772
11721,1,1,772,1301,529
11722,0,0,144,0,-144
11723,1,0,59,0,-59
11724,0,0,27,0,-27
11725,1,1,574,1275,701
11726,1,0,227,0,-227
11727,0,0,14,0,-14
11728,0,0,184,0,-184
11729,1,1,509,1311,802
11730,1,1,124,1285,1161
11731,1,0,76,0,-76
11732,1,0,173,0,-173
11733,0,0,88,0,-88
11734,1,1,1554,1458,-96
11735,1,0,10,0,-10
11736,1,0,5,0,-5
11737,1,0,69,0,-69
11738,1,0,53,0,-53
11739,1,0,13,0,-13
11740,1,1,639,1226,587
11741,0,0,78,0,-78
11742,0,0,18,0,-18
11743,0,0,58,0,-58
11744,0,0,12,0,-12
11745,1,1,1192,1458,266
11746,1,0,155,0,-155
11747,0,0,20,0,-20
11748,1,1,659,1382,723
11749,1,0,57,0,-57
11750,1,1,1071,1268,197
11751,0,0,83,0,-83
11752,1,0,1,0,-1
11753,1,1,394,1248,854
11754,1,1,103,2165,2062
11755,1,0,177,0,-177
11756,0,0,41,0,-41
11757,0,0,27,0,-27
11758,1,1,176,2063,1887
11759,1,1,743,1731,988
11760,0,0,16,0,-16
11761,0,0,39,0,-39
11762,1,1,405,1940,1535
11763,1,0,38,0,-38
11764,1,0,13,0,-13
11765,0,0,127,0,-127
11766,1,0,0,0,0
11767,1,1,1313,1473,160
11768,1,0,62,0,-62
11769,1,1,785,2189,1404
11770,0,0,65,0,-65
11771,1,0,72,0,-72
11772,1,1,68,2264,2196
11773,1,0,34,0,-34
11774,1,1,410,1646,1236
11775,1,1,233,1325,1092
11776,0,0,89,0,-89
11777,1,0,17,0,-17
11778,1,0,119,0,-119
11779,0,0,16,0,-16
11780,0,0,29,0,-29
11781,1,0,45,0,-45
11782,1,0,66,0,-66
11783,0,0,270,0,-270
11784,0,0,106,0,-106
11785,1,0,31,0,-31
11786,0,0,10,0,-10
11787,1,1,260,2413,2153
11788,1,1,50,1306,1256
11789,1,1,592,1286,694
11790,1,1,576,1221,645
11791,0,0,181,0,-181
11792,0,0,3,0,-3
11793,0,0,41,0,-41
11794,0,0,49,0,-49
11795,0,0,8,0,-8
11796,1,0,87,0,-87
11797,1,1,315,1433,1118
11798,0,0,57,0,-57
11799,0,0,0,0,0
11800,1,1,550,1229,679
11801,1,1,582,1856,1274
11802,1,0,100,0,-100
11803,1,1,1000,1371,371
11804,0,0,44,0,-44
11805,1,0,4,0,-4
11806,1,1,319,1771,1452
11807,1,1,178,1232,1054
11808,1,0,87,0,-87
11809,0,0,49,0,-49
11810,0,0,31,0,-31
11811,1,1,1538,1244,-294
11812,0,0,20,0,-20
11813,1,1,735,1756,1021
11814,1,1,137,1429,1292
11815,0,0,244,0,-244
11816,1,1,207,1412,1205
11817,0,0,88,0,-88
11818,1,0,24,0,-24
11819,0,0,232,0,-232
11820,1,0,19,0,-19
11821,0,0,23,0,-23
11822,0,0,64,0,-64
11823,1,0,17,0,-17
11824,0,0,32,0,-32
11825,0,0,299,0,-299
11826,0,0,38,0,-38
11827,1,0,55,0,-55
11828,1,1,2198,1228,-970
11829,0,0,105,0,-105
11830,0,0,221,0,-221
11831,1,0,14,0,-14
11832,0,0,1,0,-1
11833,0,0,12,0,-12
11834,0,0,33,0,-33
11835,0,0,181,0,-181
11836,1,1,509,3498,2989
11837,1,0,77,0,-77
11838,1,1,686,1301,615
11839,1,0,39,0,-39
11840,0,0,106,0,-106
11841,0,0,23,0,-23
11842,1,0,192,0,-192
11843,0,0,76,0,-76
11844,0,0,57,0,-57
11845,1,0,131,0,-131
11846,1,1,1112,3331,2219
11847,1,0,194,0,-194
11848,0,0,87,0,-87
11849,1,0,13,0,-13
11850,1,1,1082,1450,368
11851,1,0,54,0,-54
11852,1,1,241,2466,2225
11853,1,0,26,0,-26
11854,1,0,38,0,-38
11855,1,1,27,1610,1583
11856,0,0,58,0,-58
11857,1,1,588,1446,858
11858,1,0,110,0,-110
11859,0,0,102,0,-102
11860,1,0,58,0,-58
11861,1,0,79,0,-79
11862,1,0,25,0,-25
11863,1,1,73,1740,1667
11864,1,0,170,0,-170
11865,1,1,471,1791,1320
11866,1,0,54,0,-54
11867,1,1,371,1363,992
11868,0,0,131,0,-131
11869,1,1,712,1220,508
11870,1,0,74,0,-74
11871,0,0,58,0,-58
11872,0,0,16,0,-16
11873,0,0,10,0,-10
11874,0,0,35,0,-35
11875,1,0,55,0,-55
11876,1,1,1685,1557,-128
11877,1,1,448,1223,775
11878,0,0,3,0,-3
11879,1,0,15,0,-15
11880,1,1,665,1774,1109
11881,1,0,35,0,-35
11882,1,1,90,1736,1646
11883,0,0,6,0,-6
11884,1,0,85,0,-85
11885,0,0,93,0,-93
11886,1,1,979,1217,238
11887,1,0,1,0,-1
11888,1,1,443,1235,792
11889,0,0,146,0,-146
11890,1,0,44,0,-44
11891,1,0,52,0,-52
11892,0,0,53,0,-53
11893,1,0,33,0,-33
11894,1,1,571,1249,678
11895,1,1,574,1374,800
11896,0,0,78,0,-78
11897,1,1,299,1313,1014
11898,1,0,51,0,-51
11899,0,0,195,0,-195
11900,1,1,537,1583,1046
11901,1,0,38,0,-38
11902,1,0,19,0,-19
11903,0,0,0,0,0
11904,1,0,13,0,-13
11905,0,0,72,0,-72
11906,0,0,24,0,-24
11907,1,1,89,1556,1467
11908,1,0,25,0,-25
11909,1,0,28,0,-28
11910,1,0,48,0,-48
11911,1,1,533,1562,1029
11912,0,0,3,0,-3
11913,1,1,553,1546,993
11914,1,1,339,1201,862
11915,1,0,33,0,-33
11916,0,0,51,0,-51
11917,0,0,23,0,-23
11918,0,0,56,0,-56
11919,0,0,4,0,-4
11920,0,0,10,0,-10
11921,1,0,59,0,-59
11922,1,0,39,0,-39
11923,1,1,505,1632,1127
11924,1,0,2,0,-2
11925,0,0,4,0,-4
11926,0,0,6,0,-6
11927,0,0,87,0,-87
11928,0,0,199,0,-199
11929,1,0,38,0,-38
11930,0,0,35,0,-35
11931,1,0,13,0,-13
11932,0,0,19,0,-19
11933,1,0,99,0,-99
11934,0,0,49,0,-49
11935,0,0,58,0,-58
11936,1,1,364,1459,1095
11937,1,1,175,1319,1144
11938,1,1,351,1381,1030
11939,1,1,161,1215,1054
11940,1,0,177,0,-177
11941,1,1,494,1243,749
11942,1,0,37,0,-37
11943,1,1,174,1758,1584
11944,0,0,8,0,-8
11945,0,0,0,0,0
11946,0,0,12,0,-12
11947,1,1,1125,1209,84
11948,1,1,467,2192,1725
11949,1,0,0,0,0
11950,1,0,12,0,-12
11951,0,0,41,0,-41
11952,1,1,1082,1392,310
11953,1,0,30,0,-30
11954,0,0,8,0,-8
11955,0,0,0,0,0
11956,0,0,24,0,-24
11957,1,1,203,1205,1002
11958,1,0,17,0,-17
11959,1,1,270,1783,1513
11960,1,0,48,0,-48
11961,1,1,183,1763,1580
11962,0,0,15,0,-15
11963,0,0,128,0,-128
11964,1,0,13,0,-13
11965,1,0,53,0,-53
11966,1,1,617,1216,599
11967,1,0,29,0,-29
11968,0,0,96,0,-96
11969,1,1,803,1968,1165
11970,1,0,9,0,-9
11971,1,0,0,0,0
11972,1,1,762,5191,4429
11973,1,1,446,1483,1037
11974,1,0,62,0,-62
11975,0,0,63,0,-63
11976,1,0,13,0,-13
11977,1,1,1264,1210,-54
11978,1,1,25,1644,1619
11979,0,0,31,0,-31
11980,0,0,12,0,-12
11981,0,0,20,0,-20
11982,0,0,28,0,-28
11983,1,0,63,0,-63
11984,1,1,656,1559,903
11985,0,0,18,0,-18
11986,0,0,24,0,-24
11987,1,0,190,0,-190
11988,0,0,33,0,-33
11989,1,0,146,0,-146
11990,0,0,122,0,-122
11991,1,1,1010,1466,456
11992,0,0,14,0,-14
11993,1,1,817,1599,782
11994,1,1,750,1202,452
11995,1,0,60,0,-60
11996,0,0,16,0,-16
11997,0,0,0,0,0
11998,1,0,24,0,-24
11999,0,0,55,0,-55
12000,1,0,34,0,-34
12001,1,0,49,0,-49
12002,0,0,6,0,-6
12003,1,1,701,1327,626
12004,0,0,29,0,-29
12005,1,1,122,1243,1121
12006,1,0,25,0,-25
12007,0,0,6,0,-6
12008,1,0,66,0,-66
12009,1,1,440,2008,1568
12010,1,0,17,0,-17
12011,1,0,20,0,-20
12012,1,0,46,0,-46
12013,1,1,894,1730,836
12014,0,0,60,0,-60
12015,0,0,160,0,-160
12016,1,0,136,0,-136
12017,1,1,590,1564,974
12018,0,0,34,0,-34
12019,1,0,12,0,-12
12020,1,0,87,0,-87
12021,1,0,13,0,-13
12022,1,0,16,0,-16
12023,1,1,1150,1820,670
12024,0,0,56,0,-56
12025,0,0,30,0,-30
12026,0,0,83,0,-83
12027,1,1,201,1245,1044
12028,0,0,7,0,-7
12029,1,1,179,1376,1197
12030,0,0,16,0,-16
12031,1,1,2268,1272,-996
12032,1,1,329,1316,987
12033,0,0,70,0,-70
12034,1,0,164,0,-164
12035,1,0,12,0,-12
12036,0,0,39,0,-39
12037,0,0,85,0,-85
12038,1,0,18,0,-18
12039,1,1,156,1377,1221
12040,1,1,267,1295,1028
12041,1,0,220,0,-220
12042,0,0,72,0,-72
12043,1,0,88,0,-88
12044,1,0,90,0,-90
12045,1,0,22,0,-22
12046,1,0,25,0,-25
12047,1,1,132,1289,1157
12048,0,0,29,0,-29
12049,1,1,1849,1743,-106
12050,0,0,38,0,-38
12051,0,0,14,0,-14
12052,0,0,29,0,-29
12053,1,0,106,0,-106
12054,0,0,25,0,-25
12055,1,0,9,0,-9
12056,0,0,43,0,-43
12057,0,0,5,0,-5
12058,0,0,77,0,-77
12059,1,1,105,1529,1424
12060,1,1,600,2296,1696
12061,1,0,133,0,-133
12062,0,0,41,0,-41
12063,1,1,1076,1656,580
12064,0,0,31,0,-31
12065,0,0,56,0,-56
12066,0,0,26,0,-26
12067,1,0,16,0,-16
12068,1,0,77,0,-77
12069,0,0,129,0,-129
12070,1,0,125,0,-125
12071,0,0,56,0,-56
12072,1,1,68,1487,1419
12073,1,1,36,1897,1861
12074,0,0,185,0,-185
12075,0,0,12,0,-12
12076,0,0,48,0,-48
12077,1,1,268,2066,1798
12078,1,0,16,0,-16
12079,1,0,78,0,-78
12080,1,1,391,1252,861
12081,1,1,948,1306,358
12082,0,0,33,0,-33
12083,0,0,130,0,-130
12084,0,0,46,0,-46
12085,0,0,14,0,-14
12086,0,0,5,0,-5
12087,0,0,105,0,-105
12088,0,0,53,0,-53
12089,0,0,130,0,-130
12090,0,0,166,0,-166
12091,0,0,5,0,-5
12092,0,0,37,0,-37
12093,1,1,102,1213,1111
12094,1,0,68,0,-68
12095,1,1,707,5087,4380
12096,1,1,908,1531,623
12097,0,0,47,0,-47
12098,1,1,275,1445,1170
12099,0,0,1,0,-1
12100,1,0,129,0,-129
12101,1,1,304,2082,1778
12102,0,0,119,0,-119
12103,0,0,2,0,-2
12104,0,0,74,0,-74
12105,0,0,70,0,-70
12106,1,0,43,0,-43
12107,1,1,385,1893,1508
12108,1,0,32,0,-32
12109,1,0,16,0,-16
12110,0,0,5,0,-5
12111,0,0,11,0,-11
12112,1,0,6,0,-6
12113,0,0,47,0,-47
12114,1,0,33,0,-33
12115,1,1,131,4095,3964
12116,0,0,52,0,-52
12117,1,0,437,0,-437
12118,1,1,2791,1416,-1375
12119,0,0,0,0,0
12120,1,1,1205,1211,6
12121,1,0,51,0,-51
12122,1,0,78,0,-78
12123,0,0,31,0,-31
12124,1,1,537,1387,850
12125,0,0,67,0,-67
12126,0,0,32,0,-32
12127,0,0,20,0,-20
12128,1,1,54,1889,1835
12129,0,0,11,0,-11
12130,0,0,8,0,-8
12131,1,0,10,0,-10
12132,0,0,35,0,-35
12133,1,1,79,1308,1229
12134,0,0,35,0,-35
12135,1,1,653,1256,603
12136,0,0,38,0,-38
12137,0,0,109,0,-109
12138,1,1,948,1551,603
12139,1,1,203,1600,1397
12140,0,0,57,0,-57
12141,0,0,33,0,-33
12142,1,0,20,0,-20
12143,0,0,98,0,-98
12144,1,0,87,0,-87
12145,1,1,226,2004,1778
12146,0,0,62,0,-62
12147,1,0,10,0,-10
12148,0,0,67,0,-67
12149,1,1,222,1249,1027
12150,1,0,157,0,-157
12151,0,0,62,0,-62
12152,1,0,43,0,-43
12153,1,0,47,0,-47
12154,1,0,27,0,-27
12155,1,1,182,2213,2031
12156,0,0,67,0,-67
12157,0,0,37,0,-37
12158,1,0,38,0,-38
12159,0,0,21,0,-21
12160,1,0,27,0,-27
12161,0,0,150,0,-150
12162,1,1,1100,1288,188
12163,0,0,95,0,-95
12164,1,1,1226,1863,637
12165,1,0,7,0,-7
12166,0,0,52,0,-52
12167,0,0,50,0,-50
12168,1,1,1229,1236,7
12169,0,0,31,0,-31
12170,1,1,229,1840,1611
12171,1,1,179,1221,1042
12172,1,0,25,0,-25
12173,0,0,0,0,0
12174,0,0,71,0,-71
12175,1,0,27,0,-27
12176,1,1,12,2872,2860
12177,1,0,1,0,-1
12178,0,0,29,0,-29
12179,0,0,17,0,-17
12180,1,1,190,1268,1078
12181,0,0,34,0,-34
12182,1,0,57,0,-57
12183,0,0,39,0,-39
12184,1,1,830,1316,486
12185,1,0,6,0,-6
12186,0,0,46,0,-46
12187,1,0,60,0,-60
12188,0,0,53,0,-53
12189,1,0,5,0,-5
12190,1,0,69,0,-69
12191,0,0,22,0,-22
12192,1,0,5,0,-5
12193,0,0,79,0,-79
12194,1,0,27,0,-27
12195,1,1,972,1262,290
12196,1,1,312,1360,1048
12197,1,1,397,1660,1263
12198,0,0,200,0,-200
12199,1,0,132,0,-132
12200,1,1,295,1610,1315
12201,1,1,520,1289,769
12202,0,0,20,0,-20
12203,0,0,42,0,-42
12204,1,1,559,1254,695
12205,1,1,1603,1306,-297
12206,0,0,21,0,-21
12207,1,0,21,0,-21
12208,1,0,29,0,-29
12209,1,0,57,0,-57
12210,1,1,607,1230,623
12211,1,0,31,0,-31
12212,0,0,83,0,-83
12213,0,0,27,0,-27
12214,0,0,107,0,-107
12215,1,0,101,0,-101
12216,1,0,30,0,-30
12217,1,1,293,1661,1368
12218,1,0,4,0,-4
12219,0,0,54,0,-54
12220,1,0,12,0,-12
12221,0,0,2,0,-2
12222,1,1,1125,1207,82
12223,0,0,0,0,0
12224,1,1,420,1430,1010
12225,1,1,157,1371,1214
12226,0,0,16,0,-16
12227,1,1,521,1200,679
12228,1,0,143,0,-143
12229,1,0,44,0,-44
12230,1,0,27,0,-27
12231,0,0,36,0,-36
12232,1,1,895,1216,321
12233,1,0,39,0,-39
12234,0,0,11,0,-11
12235,1,1,465,1786,1321
12236,1,1,284,1220,936
12237,1,0,39,0,-39
12238,1,1,112,1206,1094
12239,0,0,8,0,-8
12240,1,0,5,0,-5
12241,1,0,40,0,-40
12242,0,0,28,0,-28
12243,1,1,237,2122,1885
12244,1,1,313,1433,1120
12245,1,1,1529,1291,-238
12246,0,0,22,0,-22
12247,0,0,20,0,-20
12248,0,0,48,0,-48
12249,1,0,38,0,-38
12250,1,0,289,0,-289
12251,0,0,95,0,-95
12252,1,1,770,1320,550
12253,1,0,153,0,-153
12254,0,0,62,0,-62
12255,1,1,643,1631,988
12256,1,1,608,1276,668
12257,0,0,92,0,-92
12258,1,0,112,0,-112
12259,0,0,2,0,-2
12260,1,1,233,1223,990
12261,1,1,508,1211,703
12262,0,0,268,0,-268
12263,0,0,72,0,-72
12264,1,1,196,1362,1166
12265,0,0,43,0,-43
12266,1,1,641,1392,751
12267,1,0,49,0,-49
12268,1,0,26,0,-26
12269,0,0,22,0,-22
12270,1,0,200,0,-200
12271,1,1,1439,2250,811
12272,0,0,47,0,-47
12273,1,1,133,1210,1077
12274,0,0,4,0,-4
12275,1,1,275,1225,950
12276,1,1,161,1211,1050
12277,1,0,107,0,-107
12278,1,1,528,1365,837
12279,0,0,18,0,-18
12280,1,1,217,1299,1082
12281,1,1,551,1254,703
12282,0,0,31,0,-31
12283,0,0,62,0,-62
12284,1,1,119,1653,1534
12285,0,0,11,0,-11
12286,1,1,484,1266,782
12287,0,0,28,0,-28
12288,1,1,577,1271,694
12289,1,1,587,1204,617
12290,1,0,168,0,-168
12291,0,0,40,0,-40
12292,1,0,1,0,-1
12293,0,0,69,0,-69
12294,0,0,14,0,-14
12295,1,0,27,0,-27
12296,1,0,66,0,-66
12297,0,0,46,0,-46
12298,1,0,100,0,-100
12299,0,0,53,0,-53
12300,0,0,23,0,-23
12301,1,0,22,0,-22
12302,0,0,83,0,-83
12303,1,0,24,0,-24
12304,1,0,60,0,-60
12305,1,0,23,0,-23
12306,0,0,26,0,-26
12307,1,1,1179,1571,392
12308,1,0,54,0,-54
12309,0,0,72,0,-72
12310,0,0,10,0,-10
12311,0,0,4,0,-4
12312,1,0,39,0,-39
12313,0,0,32,0,-32
12314,0,0,0,0,0
12315,1,0,102,0,-102
12316,1,0,16,0,-16
12317,1,0,50,0,-50
12318,0,0,129,0,-129
12319,1,0,102,0,-102
12320,0,0,40,0,-40
12321,1,1,171,1380,1209
12322,0,0,76,0,-76
12323,1,1,744,2143,1399
12324,1,0,37,0,-37
12325,0,0,53,0,-53
12326,1,0,30,0,-30
12327,0,0,94,0,-94
12328,1,0,9,0,-9
12329,0,0,36,0,-36
12330,0,0,106,0,-106
12331,0,0,14,0,-14
12332,1,0,81,0,-81
12333,1,1,90,1375,1285
12334,1,0,0,0,0
12335,1,1,230,3795,3565
12336,1,0,29,0,-29
12337,1,0,42,0,-42
12338,1,0,24,0,-24
12339,0,0,140,0,-140
12340,1,1,177,1291,1114
12341,1,1,1537,1549,12
12342,0,0,12,0,-12
12343,1,1,366,1365,999
12344,0,0,12,0,-12
12345,1,1,421,1824,1403
12346,0,0,56,0,-56
12347,1,1,376,1578,1202
12348,1,0,132,0,-132
12349,1,0,2,0,-2
12350,0,0,1,0,-1
12351,1,0,62,0,-62
12352,0,0,27,0,-27
12353,1,1,1521,1255,-266
12354,0,0,73,0,-73
12355,1,1,473,1324,851
12356,0,0,19,0,-19
12357,0,0,7,0,-7
12358,1,1,183,1227,1044
12359,0,0,12,0,-12
12360,1,1,972,2759,1787
12361,0,0,2,0,-2
12362,1,0,28,0,-28
12363,1,0,9,0,-9
12364,0,0,15,0,-15
12365,0,0,157,0,-157
12366,1,1,840,1513,673
12367,1,1,1151,1326,175
12368,1,1,365,2217,1852
12369,0,0,13,0,-13
12370,1,1,867,1305,438
12371,0,0,72,0,-72
12372,0,0,23,0,-23
12373,0,0,50,0,-50
12374,0,0,3,0,-3
12375,0,0,23,0,-23
12376,1,1,188,1403,1215
12377,1,0,43,0,-43
12378,0,0,2,0,-2
12379,1,1,168,2060,1892
12380,0,0,16,0,-16
12381,0,0,41,0,-41
12382,0,0,13,0,-13
12383,1,0,64,0,-64
12384,1,1,160,1632,1472
12385,1,1,774,1469,695
12386,1,1,205,2639,2434
12387,1,1,315,1514,1199
12388,0,0,61,0,-61
12389,1,0,43,0,-43
12390,0,0,179,0,-179
12391,1,0,50,0,-50
12392,0,0,33,0,-33
12393,0,0,79,0,-79
12394,1,1,234,1845,1611
12395,0,0,10,0,-10
12396,1,1,498,1308,810
12397,1,1,1215,1215,0
12398,0,0,79,0,-79
12399,1,0,173,0,-173
12400,1,0,10,0,-10
12401,1,0,55,0,-55
12402,1,0,32,0,-32
12403,0,0,69,0,-69
12404,0,0,42,0,-42
12405,1,0,89,0,-89
12406,1,0,6,0,-6
12407,1,1,1268,1285,17
12408,1,0,25,0,-25
12409,1,0,13,0,-13
12410,0,0,3,0,-3
12411,0,0,39,0,-39
12412,0,0,42,0,-42
12413,1,1,1475,1288,-187
12414,1,1,3477,1260,-2217
12415,1,1,183,1302,1119
12416,1,1,281,1643,1362
12417,1,1,164,1201,1037
12418,1,1,246,2218,1972
12419,1,0,62,0,-62
12420,1,1,281,1601,1320
12421,1,1,395,1495,1100
12422,1,0,51,0,-51
12423,1,1,313,1258,945
12424,1,1,1445,1223,-222
12425,0,0,91,0,-91
12426,0,0,136,0,-136
12427,0,0,73,0,-73
12428,1,1,139,1375,1236
12429,0,0,74,0,-74
12430,1,0,40,0,-40
12431,1,0,51,0,-51
12432,1,1,380,1536,1156
12433,1,0,57,0,-57
12434,0,0,11,0,-11
12435,1,1,37,1744,1707
12436,0,0,37,0,-37
12437,0,0,70,0,-70
12438,0,0,5,0,-5
12439,0,0,21,0,-21
12440,1,1,259,1248,989
12441,1,1,454,1285,831
12442,0,0,16,0,-16
12443,0,0,20,0,-20
12444,0,0,23,0,-23
12445,1,0,14,0,-14
12446,0,0,28,0,-28
12447,1,0,68,0,-68
12448,1,1,94,1589,1495
12449,1,1,401,3355,2954
12450,0,0,125,0,-125
12451,1,1,103,1267,1164
12452,1,1,528,1935,1407
12453,1,0,24,0,-24
12454,0,0,55,0,-55
12455,1,0,46,0,-46
12456,0,0,5,0,-5
12457,1,0,96,0,-96
12458,0,0,153,0,-153
12459,1,0,3,0,-3
12460,1,1,301,1439,1138
12461,0,0,16,0,-16
12462,0,0,97,0,-97
12463,1,0,26,0,-26
12464,1,1,1068,2464,1396
12465,1,1,738,1204,466
12466,1,0,58,0,-58
12467,0,0,14,0,-14
12468,1,0,1,0,-1
12469,1,1,508,1663,1155
12470,1,1,155,1831,1676
12471,0,0,15,0,-15
12472,0,0,91,0,-91
12473,1,0,5,0,-5
12474,1,0,21,0,-21
12475,0,0,85,0,-85
12476,0,0,42,0,-42
12477,1,0,39,0,-39
12478,1,1,306,1807,1501
12479,0,0,41,0,-41
12480,0,0,9,0,-9
12481,0,0,19,0,-19
12482,0,0,40,0,-40
12483,0,0,36,0,-36
12484,0,0,3,0,-3
12485,0,0,13,0,-13
12486,1,0,83,0,-83
12487,0,0,50,0,-50
12488,1,1,742,1392,650
12489,0,0,2,0,-2
12490,0,0,11,0,-11
12491,1,1,246,2104,1858
12492,1,0,40,0,-40
12493,0,0,97,0,-97
12494,1,1,1346,1370,24
12495,0,0,67,0,-67
12496,1,1,108,1367,1259
12497,1,0,110,0,-110
12498,0,0,96,0,-96
12499,0,0,11,0,-11
12500,1,1,639,1246,607
12501,0,0,42,0,-42
12502,0,0,60,0,-60
12503,1,0,12,0,-12
12504,1,0,2,0,-2
12505,1,1,230,1487,1257
12506,0,0,17,0,-17
12507,0,0,4,0,-4
12508,1,0,39,0,-39
12509,1,1,449,1333,884
12510,0,0,0,0,0
12511,1,1,941,1555,614
12512,0,0,11,0,-11
12513,1,0,118,0,-118
12514,1,1,170,1617,1447
12515,0,0,1,0,-1
12516,1,0,5,0,-5
12517,1,0,29,0,-29
12518,1,1,840,1353,513
12519,1,1,126,1323,1197
12520,0,0,20,0,-20
12521,1,0,1,0,-1
12522,1,1,261,1284,1023
12523,1,1,464,1729,1265
12524,0,0,80,0,-80
12525,0,0,97,0,-97
12526,1,0,30,0,-30
12527,1,0,56,0,-56
12528,0,0,55,0,-55
12529,0,0,67,0,-67
12530,0,0,109,0,-109
12531,1,1,313,1252,939
12532,1,1,143,1333,1190
12533,0,0,37,0,-37
12534,1,1,715,2077,1362
12535,1,1,746,1268,522
12536,0,0,101,0,-101
12537,0,0,86,0,-86
12538,0,0,81,0,-81
12539,0,0,186,0,-186
12540,1,0,37,0,-37
12541,1,1,719,1264,545
12542,1,1,228,1209,981
12543,0,0,26,0,-26
12544,1,0,7,0,-7
12545,0,0,21,0,-21
12546,0,0,3,0,-3
12547,0,0,107,0,-107
12548,0,0,40,0,-40
12549,0,0,10,0,-10
12550,0,0,3,0,-3
12551,1,0,58,0,-58
12552,1,0,5,0,-5
12553,0,0,41,0,-41
12554,1,1,179,1565,1386
12555,1,0,23,0,-23
12556,1,0,77,0,-77
12557,1,1,442,2568,2126
12558,1,1,616,2172,1556
12559,1,1,818,1213,395
12560,1,1,265,1282,1017
12561,1,1,205,1771,1566
12562,0,0,142,0,-142
12563,1,1,283,1200,917
12564,1,0,2,0,-2
12565,0,0,52,0,-52
12566,1,1,789,1556,767
12567,0,0,145,0,-145
12568,0,0,2,0,-2
12569,0,0,1,0,-1
12570,0,0,40,0,-40
12571,1,0,142,0,-142
12572,0,0,63,0,-63
12573,1,0,12,0,-12
12574,0,0,30,0,-30
12575,1,0,4,0,-4
12576,1,1,308,1586,1278
12577,0,0,50,0,-50
12578,1,0,0,0,0
12579,1,1,379,1318,939
12580,1,1,451,1599,1148
12581,1,0,80,0,-80
12582,1,0,49,0,-49
12583,1,1,708,2338,1630
12584,0,0,7,0,-7
12585,1,0,16,0,-16
12586,0,0,164,0,-164
12587,1,1,182,1670,1488
12588,1,1,444,1280,836
12589,1,0,89,0,-89
12590,1,1,797,1418,621
12591,0,0,39,0,-39
12592,1,0,73,0,-73
12593,1,1,655,1201,546
12594,1,1,291,1337,1046
12595,1,0,8,0,-8
12596,0,0,22,0,-22
12597,1,0,44,0,-44
12598,1,0,2,0,-2
12599,0,0,58,0,-58
12600,1,1,880,1419,539
12601,1,0,23,0,-23
12602,0,0,33,0,-33
12603,0,0,8,0,-8
12604,0,0,3,0,-3
12605,1,1,1113,1341,228
12606,0,0,33,0,-33
12607,0,0,102,0,-102
12608,1,0,172,0,-172
12609,0,0,29,0,-29
12610,1,0,146,0,-146
12611,1,1,888,1233,345
12612,1,0,152,0,-152
12613,0,0,4,0,-4
12614,1,0,6,0,-6
12615,1,1,219,1415,1196
12616,1,1,410,1275,865
12617,0,0,67,0,-67
12618,1,1,597,1343,746
12619,1,1,114,1217,1103
12620,1,1,389,1289,900
12621,1,0,152,0,-152
12622,1,1,96,1337,1241
12623,0,0,53,0,-53
12624,0,0,4,0,-4
12625,0,0,28,0,-28
12626,0,0,8,0,-8
12627,0,0,4,0,-4
12628,0,0,60,0,-60
12629,0,0,47,0,-47
12630,1,1,247,1244,997
12631,0,0,20,0,-20
12632,1,1,125,2011,1886
12633,1,0,59,0,-59
12634,1,1,165,1281,1116
12635,0,0,205,0,-205
12636,0,0,41,0,-41
12637,1,1,607,1212,605
12638,1,1,435,1235,800
12639,1,0,1,0,-1
12640,0,0,13,0,-13
12641,1,1,1325,1989,664
12642,0,0,51,0,-51
12643,1,1,402,1364,962
12644,1,0,5,0,-5
12645,1,0,30,0,-30
12646,1,1,497,1228,731
12647,0,0,15,0,-15
12648,1,0,8,0,-8
12649,1,1,478,2853,2375
12650,1,1,316,1666,1350
12651,1,1,1173,2180,1007
12652,1,0,32,0,-32
12653,0,0,8,0,-8
12654,1,1,44,2463,2419
12655,0,0,4,0,-4
12656,1,0,0,0,0
12657,1,1,144,1459,1315
12658,1,0,25,0,-25
12659,1,0,15,0,-15
12660,1,0,150,0,-150
12661,0,0,166,0,-166
12662,1,0,29,0,-29
12663,0,0,39,0,-39
12664,0,0,40,0,-40
12665,1,1,119,1474,1355
12666,0,0,64,0,-64
12667,1,1,52,1875,1823
12668,0,0,0,0,0
12669,1,1,1089,1217,128
12670,0,0,26,0,-26
12671,1,0,27,0,-27
12672,1,0,10,0,-10
12673,0,0,62,0,-62
12674,1,0,13,0,-13
12675,1,0,157,0,-157
12676,1,1,224,1320,1096
12677,0,0,29,0,-29
12678,1,1,468,1294,826
12679,1,0,46,0,-46
12680,0,0,14,0,-14
12681,0,0,108,0,-108
12682,0,0,18,0,-18
12683,0,0,78,0,-78
12684,1,0,90,0,-90
12685,1,0,71,0,-71
12686,0,0,2,0,-2
12687,0,0,6,0,-6
12688,0,0,7,0,-7
12689,1,1,261,1883,1622
12690,0,0,8,0,-8
12691,1,1,649,1217,568
12692,1,0,5,0,-5
12693,0,0,9,0,-9
12694,0,0,53,0,-53
12695,1,1,240,1249,1009
12696,0,0,25,0,-25
12697,0,0,110,0,-110
12698,1,0,95,0,-95
12699,0,0,143,0,-143
12700,1,0,4,0,-4
12701,1,0,15,0,-15
12702,1,1,190,1579,1389
12703,1,1,789,1456,667
12704,0,0,99,0,-99
12705,1,1,220,1488,1268
12706,1,0,22,0,-22
12707,1,0,20,0,-20
12708,0,0,5,0,-5
12709,1,0,19,0,-19
12710,0,0,10,0,-10
12711,1,1,309,1571,1262
12712,1,1,63,1674,1611
12713,1,0,0,0,0
12714,1,0,13,0,-13
12715,1,1,1016,1286,270
12716,1,0,33,0,-33
12717,0,0,9,0,-9
12718,0,0,78,0,-78
12719,0,0,29,0,-29
12720,0,0,37,0,-37
12721,1,0,127,0,-127
12722,0,0,17,0,-17
12723,0,0,148,0,-148
12724,1,0,4,0,-4
12725,1,1,221,2744,2523
12726,0,0,50,0,-50
12727,1,1,508,1364,856
12728,1,0,12,0,-12
12729,1,1,883,1238,355
12730,0,0,238,0,-238
12731,1,1,155,1208,1053
12732,1,1,584,1317,733
12733,1,1,35,1709,1674
12734,1,0,0,0,0
12735,0,0,56,0,-56
12736,0,0,4,0,-4
12737,0,0,12,0,-12
12738,0,0,6,0,-6
12739,1,1,311,2180,1869
12740,0,0,23,0,-23
12741,0,0,15,0,-15
12742,0,0,62,0,-62
12743,1,0,44,0,-44
12744,1,0,176,0,-176
12745,0,0,14,0,-14
12746,0,0,171,0,-171
12747,1,1,204,1217,1013
12748,1,1,144,3792,3648
12749,1,0,10,0,-10
12750,0,0,49,0,-49
12751,0,0,40,0,-40
12752,0,0,30,0,-30
12753,0,0,38,0,-38
12754,1,0,52,0,-52
12755,1,1,593,1555,962
12756,1,1,1270,1254,-16
12757,1,1,611,1752,1141
12758,0,0,73,0,-73
12759,1,0,10,0,-10
12760,1,0,44,0,-44
12761,1,0,98,0,-98
12762,0,0,2,0,-2
12763,1,1,125,1225,1100
12764,0,0,4,0,-4
12765,0,0,48,0,-48
12766,0,0,36,0,-36
12767,1,0,121,0,-121
12768,0,0,25,0,-25
12769,0,0,123,0,-123
12770,0,0,52,0,-52
12771,1,0,71,0,-71
12772,1,0,12,0,-12
12773,0,0,115,0,-115
12774,1,0,70,0,-70
12775,1,0,28,0,-28
12776,1,0,47,0,-47
12777,1,1,466,2457,1991
12778,1,0,14,0,-14
12779,0,0,164,0,-164
12780,0,0,19,0,-19
12781,1,0,75,0,-75
12782,0,0,30,0,-30
12783,1,0,7,0,-7
12784,0,0,79,0,-79
12785,1,0,18,0,-18
12786,0,0,6,0,-6
12787,1,1,246,1306,1060
12788,1,1,644,1293,649
12789,1,1,345,1478,1133
12790,0,0,1,0,-1
12791,0,0,63,0,-63
12792,1,1,321,1878,1557
12793,1,1,33,1319,1286
12794,1,1,466,1846,1380
12795,1,0,46,0,-46
12796,1,1,63,4088,4025
12797,1,1,193,1212,1019
12798,1,0,169,0,-169
12799,0,0,82,0,-82
12800,1,1,270,1497,1227
12801,0,0,14,0,-14
12802,1,0,44,0,-44
12803,0,0,60,0,-60
12804,0,0,45,0,-45
12805,1,0,6,0,-6
12806,0,0,28,0,-28
12807,1,0,38,0,-38
12808,1,1,1193,1205,12
12809,0,0,54,0,-54
12810,1,0,24,0,-24
12811,1,0,23,0,-23
12812,0,0,106,0,-106
12813,1,1,452,1467,1015
12814,0,0,26,0,-26
12815,0,0,17,0,-17
12816,0,0,15,0,-15
12817,0,0,14,0,-14
12818,0,0,92,0,-92
12819,1,1,650,5426,4776
12820,1,0,26,0,-26
12821,1,0,19,0,-19
12822,1,1,694,1451,757
12823,1,1,258,1412,1154
12824,1,0,23,0,-23
12825,0,0,16,0,-16
12826,0,0,13,0,-13
12827,1,1,1101,1429,328
12828,1,0,48,0,-48
12829,0,0,11,0,-11
12830,1,0,1,0,-1
12831,1,1,1760,1230,-530
12832,1,0,132,0,-132
12833,1,0,60,0,-60
12834,1,0,49,0,-49
12835,1,1,1008,1405,397
12836,1,1,78,1562,1484
12837,1,1,306,1766,1460
12838,1,1,341,1248,907
12839,0,0,50,0,-50
12840,1,0,46,0,-46
12841,1,0,1,0,-1
12842,1,1,842,1305,463
12843,0,0,69,0,-69
12844,1,0,16,0,-16
12845,1,0,168,0,-168
12846,0,0,20,0,-20
12847,1,1,383,1844,1461
12848,0,0,52,0,-52
12849,0,0,49,0,-49
12850,1,1,680,1243,563
12851,1,1,122,1425,1303
12852,1,1,171,3513,3342
12853,0,0,201,0,-201
12854,1,0,44,0,-44
12855,1,1,132,2254,2122
12856,0,0,62,0,-62
12857,1,1,697,1210,513
12858,1,0,19,0,-19
12859,0,0,84,0,-84
12860,0,0,75,0,-75
12861,0,0,8,0,-8
12862,0,0,36,0,-36
12863,0,0,121,0,-121
12864,0,0,97,0,-97
12865,1,1,233,1319,1086
12866,1,1,522,1450,928
12867,0,0,56,0,-56
12868,1,0,12,0,-12
12869,0,0,34,0,-34
12870,1,1,1853,1448,-405
12871,1,0,37,0,-37
12872,1,0,11,0,-11
12873,0,0,80,0,-80
12874,0,0,142,0,-142
12875,1,1,10,1262,1252
12876,1,0,60,0,-60
12877,1,0,18,0,-18
12878,1,1,285,1252,967
12879,1,1,576,1465,889
12880,0,0,10,0,-10
12881,0,0,191,0,-191
12882,1,1,78,1208,1130
12883,1,0,49,0,-49
12884,1,1,392,1858,1466
12885,0,0,15,0,-15
12886,1,1,185,1525,1340
12887,0,0,7,0,-7
12888,1,1,972,1673,701
12889,1,1,420,1389,969
12890,0,0,172,0,-172
12891,0,0,9,0,-9
12892,0,0,5,0,-5
12893,1,1,304,1216,912
12894,1,1,161,2350,2189
12895,1,0,2,0,-2
12896,1,1,718,1773,1055
12897,1,0,101,0,-101
12898,1,1,114,1222,1108
12899,0,0,21,0,-21
12900,0,0,149,0,-149
12901,0,0,21,0,-21
12902,1,0,53,0,-53
12903,0,0,45,0,-45
12904,0,0,70,0,-70
12905,1,0,42,0,-42
12906,0,0,7,0,-7
12907,0,0,54,0,-54
12908,0,0,36,0,-36
12909,0,0,49,0,-49
12910,0,0,3,0,-3
12911,0,0,113,0,-113
12912,1,1,1722,1389,-333
12913,1,0,80,0,-80
12914,0,0,11,0,-11
12915,0,0,20,0,-20
12916,1,0,177,0,-177
12917,1,0,1,0,-1
12918,1,1,186,1644,1458
12919,1,0,1,0,-1
12920,0,0,11,0,-11
12921,1,0,43,0,-43
12922,0,0,65,0,-65
12923,1,0,50,0,-50
12924,1,1,448,1689,1241
12925,0,0,32,0,-32
12926,0,0,12,0,-12
12927,1,1,339,1219,880
12928,0,0,29,0,-29
12929,1,1,841,2004,1163
12930,0,0,6,0,-6
12931,1,0,54,0,-54
12932,1,0,80,0,-80
12933,1,1,685,1495,810
12934,0,0,77,0,-77
12935,1,1,81,1222,1141
12936,0,0,1,0,-1
12937,0,0,19,0,-19
12938,1,0,69,0,-69
12939,1,1,668,3566,2898
12940,0,0,32,0,-32
12941,0,0,69,0,-69
12942,0,0,34,0,-34
12943,1,0,67,0,-67
12944,0,0,41,0,-41
12945,0,0,0,0,0
12946,0,0,78,0,-78
12947,0,0,6,0,-6
12948,1,0,51,0,-51
12949,1,0,34,0,-34
12950,0,0,0,0,0
12951,0,0,31,0,-31
12952,1,0,143,0,-143
12953,1,0,69,0,-69
12954,0,0,56,0,-56
12955,0,0,9,0,-9
12956,0,0,77,0,-77
12957,1,0,20,0,-20
12958,1,0,122,0,-122
12959,1,1,1643,1721,78
12960,1,0,23,0,-23
12961,0,0,23,0,-23
12962,1,0,11,0,-11
12963,1,1,70,1278,1208
12964,0,0,63,0,-63
12965,1,0,12,0,-12
12966,0,0,50,0,-50
12967,1,0,63,0,-63
12968,1,1,101,1210,1109
12969,1,0,17,0,-17
12970,0,0,35,0,-35
12971,1,1,277,1826,1549
12972,0,0,45,0,-45
12973,1,1,253,1292,1039
12974,1,1,883,1355,472
12975,1,0,73,0,-73
12976,1,1,69,1647,1578
12977,0,0,93,0,-93
12978,1,0,28,0,-28
12979,0,0,24,0,-24
12980,0,0,25,0,-25
12981,0,0,6,0,-6
12982,0,0,5,0,-5
12983,0,0,58,0,-58
12984,0,0,96,0,-96
12985,1,1,622,1523,901
12986,1,0,4,0,-4
12987,1,0,13,0,-13
12988,1,1,1733,1217,-516
12989,1,1,1327,1403,76
12990,1,0,32,0,-32
12991,0,0,27,0,-27
12992,1,0,16,0,-16
12993,1,0,4,0,-4
12994,1,1,639,1492,853
12995,0,0,22,0,-22
12996,1,0,42,0,-42
12997,0,0,19,0,-19
12998,0,0,15,0,-15
12999,1,0,14,0,-14
13000,1,1,71,1200,1129
13001,1,0,56,0,-56
13002,1,0,13,0,-13
13003,1,1,120,1268,1148
13004,0,0,49,0,-49
13005,0,0,7,0,-7
13006,1,0,35,0,-35
13007,0,0,14,0,-14
13008,1,1,1567,1342,-225
13009,1,0,75,0,-75
13010,1,0,22,0,-22
13011,0,0,58,0,-58
13012,0,0,10,0,-10
13013,1,1,325,1253,928
13014,0,0,14,0,-14
13015,1,0,15,0,-15
13016,0,0,72,0,-72
13017,1,0,51,0,-51
13018,0,0,20,0,-20
13019,0,0,6,0,-6
13020,0,0,401,0,-401
13021,1,0,34,0,-34
13022,1,0,17,0,-17
13023,1,1,296,1318,1022
13024,1,0,141,0,-141
13025,1,0,51,0,-51
13026,1,0,115,0,-115
13027,0,0,63,0,-63
13028,1,1,60,2156,2096
13029,1,0,30,0,-30
13030,1,0,6,0,-6
13031,0,0,93,0,-93
13032,0,0,7,0,-7
13033,0,0,8,0,-8
13034,1,0,24,0,-24
13035,0,0,20,0,-20
13036,0,0,6,0,-6
13037,0,0,21,0,-21
13038,0,0,46,0,-46
13039,1,0,28,0,-28
13040,1,1,561,1223,662
13041,1,1,326,1281,955
13042,1,0,76,0,-76
13043,0,0,10,0,-10
13044,0,0,71,0,-71
13045,0,0,23,0,-23
13046,0,0,42,0,-42
13047,1,0,106,0,-106
13048,1,1,121,2428,2307
13049,1,0,42,0,-42
13050,0,0,7,0,-7
13051,1,0,28,0,-28
13052,1,1,1043,1235,192
13053,0,0,3,0,-3
13054,0,0,15,0,-15
13055,1,0,39,0,-39
13056,1,0,189,0,-189
13057,1,1,446,1344,898
13058,1,0,87,0,-87
13059,1,1,112,1361,1249
13060,0,0,62,0,-62
13061,0,0,61,0,-61
13062,1,0,39,0,-39
13063,0,0,48,0,-48
13064,1,1,79,1503,1424
13065,1,1,57,3655,3598
13066,0,0,68,0,-68
13067,1,0,49,0,-49
13068,1,1,432,1310,878
13069,0,0,147,0,-147
13070,0,0,1,0,-1
13071,1,0,6,0,-6
13072,0,0,133,0,-133
13073,1,1,530,4615,4085
13074,1,0,19,0,-19
13075,1,1,551,1282,731
13076,1,1,851,1734,883
13077,0,0,135,0,-135
13078,1,0,5,0,-5
13079,1,0,14,0,-14
13080,1,1,28,1702,1674
13081,1,0,40,0,-40
13082,1,1,234,1661,1427
13083,0,0,56,0,-56
13084,1,1,656,1320,664
13085,0,0,34,0,-34
13086,1,0,44,0,-44
13087,1,1,1586,1780,194
13088,0,0,56,0,-56
13089,1,1,234,2115,1881
13090,0,0,59,0,-59
13091,1,0,31,0,-31
13092,0,0,13,0,-13
13093,1,0,42,0,-42
13094,1,1,730,1418,688
13095,0,0,59,0,-59
13096,0,0,38,0,-38
13097,1,1,69,1607,1538
13098,1,0,18,0,-18
13099,1,0,44,0,-44
13100,1,0,1,0,-1
13101,1,0,107,0,-107
13102,1,0,60,0,-60
13103,1,1,57,1475,1418
13104,0,0,0,0,0
13105,0,0,11,0,-11
13106,1,1,135,1431,1296
13107,0,0,52,0,-52
13108,0,0,246,0,-246
13109,0,0,16,0,-16
13110,0,0,42,0,-42
13111,1,1,444,2723,2279
13112,1,0,55,0,-55
13113,1,1,1006,1524,518
13114,1,1,424,1232,808
13115,1,1,125,1684,1559
13116,1,1,256,1877,1621
13117,1,0,71,0,-71
13118,1,1,867,2171,1304
13119,0,0,6,0,-6
13120,0,0,23,0,-23
13121,1,1,147,1247,1100
13122,1,1,310,1640,1330
13123,0,0,239,0,-239
13124,1,1,536,1360,824
13125,1,1,763,1464,701
13126,1,1,956,1923,967
13127,0,0,43,0,-43
13128,1,0,182,0,-182
13129,0,0,0,0,0
13130,0,0,4,0,-4
13131,0,0,7,0,-7
13132,1,0,52,0,-52
13133,1,1,198,1216,1018
13134,0,0,8,0,-8
13135,1,1,177,2419,2242
13136,1,1,236,1233,997
13137,0,0,4,0,-4
13138,1,0,23,0,-23
13139,1,0,13,0,-13
13140,1,0,1,0,-1
13141,0,0,38,0,-38
13142,1,1,103,1365,1262
13143,1,0,11,0,-11
13144,1,0,2,0,-2
13145,0,0,17,0,-17
13146,0,0,27,0,-27
13147,0,0,97,0,-97
13148,1,0,6,0,-6
13149,0,0,8,0,-8
13150,0,0,103,0,-103
13151,0,0,36,0,-36
13152,1,1,567,1205,638
13153,0,0,43,0,-43
13154,0,0,90,0,-90
13155,1,0,8,0,-8
13156,1,1,1217,1221,4
13157,1,1,223,1202,979
13158,1,0,7,0,-7
13159,1,1,728,1209,481
13160,1,1,562,1393,831
13161,0,0,9,0,-9
13162,0,0,46,0,-46
13163,1,1,583,1566,983
13164,1,1,329,2111,1782
13165,1,0,4,0,-4
13166,0,0,3,0,-3
13167,1,1,114,1467,1353
13168,1,1,84,1392,1308
13169,1,0,4,0,-4
13170,0,0,60,0,-60
13171,0,0,10,0,-10
13172,1,0,73,0,-73
13173,1,1,435,1379,944
13174,1,0,18,0,-18
13175,1,0,4,0,-4
13176,1,1,149,1298,1149
13177,0,0,75,0,-75
13178,0,0,74,0,-74
13179,1,0,12,0,-12
13180,1,0,151,0,-151
13181,1,0,73,0,-73
13182,1,1,255,1788,1533
13183,1,1,152,1224,1072
13184,1,0,39,0,-39
13185,1,1,547,1258,711
13186,0,0,53,0,-53
13187,1,0,24,0,-24
13188,1,1,854,1941,1087
13189,0,0,10,0,-10
13190,0,0,9,0,-9
13191,1,1,73,1319,1246
13192,1,0,66,0,-66
13193,1,1,164,1300,1136
13194,1,0,45,0,-45
13195,1,0,120,0,-120
13196,0,0,1,0,-1
13197,1,1,1236,1256,20
13198,1,0,18,0,-18
13199,0,0,30,0,-30
13200,0,0,58,0,-58
13201,1,1,583,1917,1334
13202,1,0,28,0,-28
13203,1,0,17,0,-17
13204,1,0,174,0,-174
13205,0,0,12,0,-12
13206,1,0,14,0,-14
13207,1,0,47,0,-47
13208,0,0,51,0,-51
13209,1,0,104,0,-104
13210,1,1,412,1437,1025
13211,1,1,534,1467,933
13212,1,0,56,0,-56
13213,1,1,905,1304,399
13214,1,1,610,1591,981
13215,0,0,8,0,-8
13216,1,0,36,0,-36
13217,1,0,91,0,-91
13218,0,0,33,0,-33
13219,1,0,0,0,0
13220,1,0,15,0,-15
13221,0,0,251,0,-251
13222,0,0,16,0,-16
13223,0,0,130,0,-130
13224,1,1,419,1577,1158
13225,1,0,11,0,-11
13226,0,0,13,0,-13
13227,1,1,460,2353,1893
13228,0,0,34,0,-34
13229,0,0,10,0,-10
13230,1,0,47,0,-47
13231,0,0,112,0,-112
13232,1,1,113,1401,1288
13233,1,1,112,1753,1641
13234,0,0,46,0,-46
13235,0,0,118,0,-118
13236,0,0,22,0,-22
13237,1,0,7,0,-7
13238,0,0,20,0,-20
13239,1,0,14,0,-14
13240,0,0,102,0,-102
13241,0,0,65,0,-65
13242,0,0,2,0,-2
13243,0,0,378,0,-378
13244,1,0,27,0,-27
13245,1,1,443,1867,1424
13246,1,1,303,1607,1304
13247,0,0,27,0,-27
13248,1,0,346,0,-346
13249,1,1,257,3117,2860
13250,1,1,1086,1333,247
13251,0,0,120,0,-120
13252,0,0,29,0,-29
13253,1,0,6,0,-6
13254,0,0,57,0,-57
13255,1,0,11,0,-11
13256,1,0,23,0,-23
13257,0,0,55,0,-55
13258,1,0,0,0,0
13259,1,1,263,2025,1762
13260,1,0,17,0,-17
13261,1,0,26,0,-26
13262,1,1,181,1347,1166
13263,1,0,25,0,-25
13264,0,0,51,0,-51
13265,0,0,46,0,-46
13266,1,1,265,2262,1997
13267,0,0,46,0,-46
13268,1,1,12,1263,1251
13269,0,0,4,0,-4
13270,1,1,822,3101,2279
13271,0,0,11,0,-11
13272,1,0,0,0,0
13273,1,0,36,0,-36
13274,0,0,54,0,-54
13275,1,0,3,0,-3
13276,1,0,65,0,-65
13277,1,0,130,0,-130
13278,1,0,110,0,-110
13279,0,0,38,0,-38
13280,0,0,56,0,-56
13281,1,1,828,5161,4333
13282,1,1,253,1669,1416
13283,1,1,347,1768,1421
13284,0,0,178,0,-178
13285,1,1,410,1988,1578
13286,0,0,30,0,-30
13287,1,0,117,0,-117
13288,0,0,27,0,-27
13289,1,1,517,1514,997
13290,0,0,84,0,-84
13291,0,0,61,0,-61
13292,1,1,1148,1207,59
13293,0,0,109,0,-109
13294,1,1,636,1250,614
13295,1,1,1483,1413,-70
13296,1,0,14,0,-14
13297,1,0,6,0,-6
13298,1,0,100,0,-100
13299,0,0,20,0,-20
13300,0,0,8,0,-8
13301,0,0,87,0,-87
13302,1,0,39,0,-39
13303,1,0,113,0,-113
13304,0,0,14,0,-14
13305,1,1,1821,1888,67
13306,1,0,76,0,-76
13307,0,0,26,0,-26
13308,0,0,112,0,-112
13309,1,0,36,0,-36
13310,0,0,181,0,-181
13311,1,1,1695,1239,-456
13312,0,0,113,0,-113
13313,0,0,35,0,-35
13314,0,0,4,0,-4
13315,1,0,12,0,-12
13316,0,0,40,0,-40
13317,1,0,100,0,-100
13318,0,0,25,0,-25
13319,1,0,14,0,-14
13320,1,1,366,1458,1092
13321,0,0,31,0,-31
13322,0,0,14,0,-14
13323,1,0,55,0,-55
13324,0,0,7,0,-7
13325,1,0,19,0,-19
13326,1,1,59,1365,1306
13327,0,0,75,0,-75
13328,1,0,13,0,-13
13329,0,0,107,0,-107
13330,1,0,76,0,-76
13331,1,1,208,1309,1101
13332,1,1,636,3922,3286
13333,0,0,34,0,-34
13334,0,0,24,0,-24
13335,0,0,101,0,-101
13336,0,0,56,0,-56
13337,1,1,1032,1702,670
13338,1,1,37,1250,1213
13339,0,0,53,0,-53
13340,0,0,6,0,-6
13341,0,0,24,0,-24
13342,0,0,128,0,-128
13343,0,0,155,0,-155
13344,0,0,73,0,-73
13345,0,0,76,0,-76
13346,0,0,32,0,-32
13347,0,0,134,0,-134
13348,1,0,75,0,-75
13349,0,0,8,0,-8
13350,0,0,52,0,-52
13351,1,1,384,1265,881
13352,0,0,74,0,-74
13353,0,0,41,0,-41
13354,0,0,63,0,-63
13355,1,1,587,2868,2281
13356,1,0,161,0,-161
13357,0,0,49,0,-49
13358,0,0,11,0,-11
13359,0,0,51,0,-51
13360,1,1,345,1675,1330
13361,1,1,140,1230,1090
13362,1,0,89,0,-89
13363,1,1,517,1522,1005
13364,1,1,816,1408,592
13365,1,0,4,0,-4
13366,1,1,497,1344,847
13367,1,0,11,0,-11
13368,1,1,974,1286,312
13369,1,0,57,0,-57
13370,0,0,44,0,-44
13371,0,0,29,0,-29
13372,0,0,12,0,-12
13373,1,1,244,1415,1171
13374,0,0,12,0,-12
13375,0,0,144,0,-144
13376,1,0,59,0,-59
13377,1,1,607,1352,745
13378,1,1,771,1238,467
13379,1,0,69,0,-69
13380,0,0,91,0,-91
13381,1,1,1760,1305,-455
13382,0,0,35,0,-35
13383,1,0,24,0,-24
13384,0,0,16,0,-16
13385,0,0,75,0,-75
13386,1,0,18,0,-18
13387,1,1,415,1440,1025
13388,0,0,3,0,-3
13389,0,0,109,0,-109
13390,1,1,1043,1253,210
13391,0,0,31,0,-31
13392,0,0,15,0,-15
13393,0,0,12,0,-12
13394,0,0,35,0,-35
13395,0,0,75,0,-75
13396,0,0,17,0,-17
13397,1,1,248,1767,1519
13398,1,1,53,1202,1149
13399,1,1,494,1329,835
13400,0,0,99,0,-99
13401,1,0,146,0,-146
13402,0,0,72,0,-72
13403,1,1,536,1414,878
13404,1,0,3,0,-3
13405,1,1,598,1308,710
13406,1,0,46,0,-46
13407,0,0,32,0,-32
13408,1,0,27,0,-27
13409,1,1,109,2055,1946
13410,0,0,21,0,-21
13411,0,0,23,0,-23
13412,1,0,10,0,-10
13413,0,0,23,0,-23
13414,0,0,37,0,-37
13415,1,1,226,1245,1019
13416,1,0,14,0,-14
13417,0,0,122,0,-122
13418,1,0,89,0,-89
13419,1,1,735,1246,511
13420,1,1,321,1486,1165
13421,1,1,218,1242,1024
13422,1,1,413,1358,945
13423,1,0,46,0,-46
13424,1,1,181,1296,1115
13425,1,0,33,0,-33
13426,1,1,482,2240,1758
13427,1,1,796,1244,448
13428,0,0,49,0,-49
13429,0,0,42,0,-42
13430,1,0,113,0,-113
13431,0,0,97,0,-97
13432,1,0,48,0,-48
13433,1,0,8,0,-8
13434,0,0,33,0,-33
13435,1,1,332,1414,1082
13436,1,1,1220,1211,-9
13437,0,0,245,0,-245
13438,0,0,78,0,-78
13439,1,0,13,0,-13
13440,1,0,2,0,-2
13441,1,0,8,0,-8
13442,0,0,18,0,-18
13443,1,0,1,0,-1
13444,1,0,100,0,-100
13445,1,0,17,0,-17
13446,0,0,18,0,-18
13447,0,0,121,0,-121
13448,1,1,1442,1689,247
13449,1,0,26,0,-26
13450,0,0,26,0,-26
13451,0,0,103,0,-103
13452,1,0,38,0,-38
13453,1,1,289,1256,967
13454,1,0,41,0,-41
13455,0,0,45,0,-45
13456,1,1,988,2784,1796
13457,0,0,294,0,-294
13458,1,0,23,0,-23
13459,1,1,1409,1277,-132
13460,0,0,9,0,-9
13461,1,1,499,1548,1049
13462,1,1,143,3020,2877
13463,0,0,55,0,-55
13464,1,0,0,0,0
13465,0,0,41,0,-41
13466,1,1,165,1302,1137
13467,0,0,128,0,-128
13468,1,0,195,0,-195
13469,1,1,368,1535,1167
13470,0,0,62,0,-62
13471,1,1,530,1279,749
13472,0,0,49,0,-49
13473,0,0,103,0,-103
13474,1,0,66,0,-66
13475,0,0,3,0,-3
13476,1,0,15,0,-15
13477,1,0,24,0,-24
13478,1,1,1269,1331,62
13479,1,1,96,1244,1148
13480,0,0,1,0,-1
13481,0,0,117,0,-117
13482,0,0,79,0,-79
13483,0,0,28,0,-28
13484,1,0,20,0,-20
13485,1,0,89,0,-89
13486,1,1,60,1640,1580
13487,0,0,42,0,-42
13488,0,0,33,0,-33
13489,0,0,78,0,-78
13490,1,1,186,2188,2002
13491,0,0,17,0,-17
13492,0,0,17,0,-17
13493,1,0,82,0,-82
13494,0,0,39,0,-39
13495,0,0,3,0,-3
13496,1,0,40,0,-40
13497,1,1,487,1241,754
13498,0,0,175,0,-175
13499,1,1,145,1250,1105
13500,0,0,16,0,-16
13501,0,0,61,0,-61
13502,1,1,333,1549,1216
13503,1,1,842,1288,446
13504,1,0,43,0,-43
13505,1,0,50,0,-50
13506,1,1,149,1809,1660
13507,0,0,90,0,-90
13508,1,1,798,1488,690
13509,0,0,3,0,-3
13510,1,1,562,1366,804
13511,1,1,1069,1394,325
13512,0,0,8,0,-8
13513,1,0,78,0,-78
13514,0,0,44,0,-44
13515,0,0,27,0,-27
13516,1,0,25,0,-25
13517,1,0,18,0,-18
13518,1,1,385,1553,1168
13519,1,1,581,1220,639
13520,0,0,51,0,-51
13521,1,0,37,0,-37
13522,0,0,62,0,-62
13523,1,1,1032,1328,296
13524,1,0,101,0,-101
13525,0,0,25,0,-25
13526,1,0,71,0,-71
13527,1,1,1255,1514,259
13528,0,0,112,0,-112
13529,1,1,928,1433,505
13530,0,0,73,0,-73
13531,1,0,90,0,-90
13532,0,0,123,0,-123
13533,1,0,61,0,-61
13534,1,0,2,0,-2
13535,1,1,66,1324,1258
13536,1,0,119,0,-119
13537,0,0,14,0,-14
13538,1,0,29,0,-29
13539,1,0,21,0,-21
13540,1,1,666,1283,617
13541,1,1,398,2080,1682
13542,1,1,84,1355,1271
13543,0,0,1,0,-1
13544,1,1,626,1422,796
13545,0,0,5,0,-5
13546,1,0,51,0,-51
13547,0,0,30,0,-30
13548,1,0,36,0,-36
13549,1,0,17,0,-17
13550,1,1,307,1533,1226
13551,1,0,36,0,-36
13552,1,0,6,0,-6
13553,1,1,495,1952,1457
13554,0,0,32,0,-32
13555,0,0,49,0,-49
13556,1,0,62,0,-62
13557,1,0,23,0,-23
13558,1,0,84,0,-84
13559,1,1,165,1494,1329
13560,1,0,45,0,-45
13561,0,0,89,0,-89
13562,1,1,331,1333,1002
13563,0,0,16,0,-16
13564,1,1,226,1699,1473
13565,0,0,25,0,-25
13566,0,0,2,0,-2
13567,1,0,12,0,-12
13568,1,0,33,0,-33
13569,0,0,40,0,-40
13570,0,0,89,0,-89
13571,0,0,5,0,-5
13572,1,1,467,1513,1046
13573,1,0,21,0,-21
13574,1,0,8,0,-8
13575,0,0,12,0,-12
13576,1,1,1430,1438,8
13577,1,1,609,1210,601
13578,0,0,10,0,-10
13579,0,0,9,0,-9
13580,1,1,88,1354,1266
13581,0,0,18,0,-18
13582,0,0,33,0,-33
13583,0,0,28,0,-28
13584,0,0,78,0,-78
13585,1,1,97,1811,1714
13586,1,0,111,0,-111
13587,0,0,77,0,-77
13588,1,0,1,0,-1
13589,0,0,26,0,-26
13590,0,0,19,0,-19
13591,0,0,26,0,-26
13592,1,1,2259,1377,-882
13593,1,0,92,0,-92
13594,1,0,12,0,-12
13595,0,0,123,0,-123
13596,1,0,9,0,-9
13597,1,1,132,1210,1078
13598,0,0,22,0,-22
13599,0,0,253,0,-253
13600,1,1,304,1419,1115
13601,1,0,35,0,-35
13602,0,0,37,0,-37
13603,1,0,55,0,-55
13604,1,1,295,2500,2205
13605,1,0,39,0,-39
13606,0,0,52,0,-52
13607,1,1,413,1517,1104
13608,1,1,1104,1527,423
13609,1,0,35,0,-35
13610,1,0,2,0,-2
13611,1,1,273,1291,1018
13612,1,1,378,1255,877
13613,1,1,1340,1752,412
13614,1,1,1091,1493,402
13615,1,1,132,2256,2124
13616,1,1,74,1363,1289
13617,0,0,48,0,-48
13618,0,0,15,0,-15
13619,1,0,33,0,-33
13620,1,0,40,0,-40
13621,0,0,53,0,-53
13622,1,0,22,0,-22
13623,0,0,6,0,-6
13624,1,1,775,1280,505
13625,1,0,84,0,-84
13626,0,0,61,0,-61
13627,0,0,30,0,-30
13628,0,0,29,0,-29
13629,1,1,188,2029,1841
13630,0,0,36,0,-36
13631,1,1,311,1290,979
13632,1,1,106,1901,1795
13633,1,1,729,1298,569
13634,0,0,75,0,-75
13635,1,0,20,0,-20
13636,1,1,865,1471,606
13637,1,1,685,1393,708
13638,0,0,3,0,-3
13639,1,1,1825,1651,-174
13640,0,0,6,0,-6
13641,0,0,14,0,-14
13642,1,0,7,0,-7
13643,1,1,825,1207,382
13644,1,1,369,1300,931
13645,0,0,3,0,-3
13646,0,0,29,0,-29
13647,1,1,1298,1385,87
13648,0,0,4,0,-4
13649,1,0,36,0,-36
13650,1,0,39,0,-39
13651,0,0,7,0,-7
13652,1,1,2107,1239,-868
13653,1,1,694,1634,940
13654,1,0,9,0,-9
13655,1,1,212,1210,998
13656,1,0,95,0,-95
13657,0,0,47,0,-47
13658,1,0,11,0,-11
13659,0,0,35,0,-35
13660,0,0,10,0,-10
13661,1,1,608,1208,600
13662,0,0,47,0,-47
13663,1,0,2,0,-2
13664,1,0,42,0,-42
13665,1,0,16,0,-16
13666,0,0,16,0,-16
13667,0,0,51,0,-51
13668,1,0,7,0,-7
13669,1,1,1288,3346,2058
13670,1,1,290,1266,976
13671,1,1,1011,1228,217
13672,0,0,36,0,-36
13673,1,1,825,1250,425
13674,0,0,56,0,-56
13675,0,0,60,0,-60
13676,1,1,758,2432,1674
13677,1,1,1165,1267,102
13678,0,0,79,0,-79
13679,1,0,253,0,-253
13680,0,0,0,0,0
13681,0,0,116,0,-116
13682,0,0,89,0,-89
13683,1,0,27,0,-27
13684,1,1,128,1674,1546
13685,1,1,257,1213,956
13686,0,0,54,0,-54
13687,1,1,322,1575,1253
13688,1,0,84,0,-84
13689,0,0,78,0,-78
13690,1,0,14,0,-14
13691,0,0,0,0,0
13692,0,0,12,0,-12
13693,0,0,63,0,-63
13694,1,1,549,1276,727
13695,1,1,89,2270,2181
13696,1,0,3,0,-3
13697,1,0,114,0,-114
13698,1,0,67,0,-67
13699,1,1,728,1227,499
13700,1,1,374,1355,981
13701,0,0,149,0,-149
13702,1,0,52,0,-52
13703,0,0,90,0,-90
13704,1,1,360,1789,1429
13705,1,0,2,0,-2
13706,1,0,21,0,-21
13707,1,0,129,0,-129
13708,0,0,261,0,-261
13709,0,0,2,0,-2
13710,1,0,82,0,-82
13711,1,1,745,2725,1980
13712,1,1,278,1250,972
13713,0,0,91,0,-91
13714,1,0,100,0,-100
13715,1,1,647,1428,781
13716,1,0,95,0,-95
13717,0,0,48,0,-48
13718,1,1,277,1259,982
13719,0,0,8,0,-8
13720,0,0,47,0,-47
13721,1,0,60,0,-60
13722,1,1,295,1242,947
13723,1,1,139,2142,2003
13724,1,1,900,1711,811
13725,0,0,32,0,-32
13726,0,0,5,0,-5
13727,1,1,158,1459,1301
13728,0,0,3,0,-3
13729,0,0,4,0,-4
13730,1,0,5,0,-5
13731,1,0,100,0,-100
13732,0,0,83,0,-83
13733,1,0,128,0,-128
13734,1,0,20,0,-20
13735,0,0,0,0,0
13736,1,1,30,1327,1297
13737,1,1,93,1504,1411
13738,1,0,12,0,-12
13739,0,0,64,0,-64
13740,0,0,153,0,-153
13741,1,0,30,0,-30
13742,0,0,47,0,-47
13743,0,0,53,0,-53
13744,1,1,61,1281,1220
13745,0,0,7,0,-7
13746,1,1,185,1255,1070
13747,1,1,690,1572,882
13748,1,1,296,2188,1892
13749,1,1,1005,1234,229
13750,0,0,122,0,-122
13751,0,0,3,0,-3
13752,1,1,54,1285,1231
13753,1,0,114,0,-114
13754,0,0,6,0,-6
13755,1,1,1075,1483,408
13756,0,0,132,0,-132
13757,0,0,62,0,-62
13758,1,0,33,0,-33
13759,1,1,102,1208,1106
13760,1,1,1281,1471,190
13761,1,1,154,1648,1494
13762,0,0,70,0,-70
13763,1,0,92,0,-92
13764,1,1,81,1530,1449
13765,1,0,72,0,-72
13766,1,1,474,1365,891
13767,1,0,179,0,-179
13768,0,0,168,0,-168
13769,1,0,52,0,-52
13770,1,0,51,0,-51
13771,1,0,51,0,-51
13772,1,1,54,1527,1473
13773,1,1,622,1788,1166
13774,1,0,47,0,-47
13775,1,0,17,0,-17
13776,1,0,71,0,-71
13777,0,0,0,0,0
13778,0,0,9,0,-9
13779,1,0,29,0,-29
13780,0,0,12,0,-12
13781,1,0,28,0,-28
13782,0,0,43,0,-43
13783,1,1,1062,1898,836
13784,1,0,61,0,-61
13785,1,1,792,1207,415
13786,0,0,9,0,-9
13787,1,1,192,1200,1008
13788,0,0,5,0,-5
13789,1,1,637,1765,1128
13790,1,0,54,0,-54
13791,1,1,159,1286,1127
13792,1,0,6,0,-6
13793,1,0,6,0,-6
13794,1,0,131,0,-131
13795,0,0,2,0,-2
13796,1,1,748,2071,1323
13797,0,0,86,0,-86
13798,1,0,128,0,-128
13799,0,0,28,0,-28
13800,1,1,61,1549,1488
13801,1,0,86,0,-86
13802,1,0,15,0,-15
13803,0,0,1,0,-1
13804,0,0,28,0,-28
13805,1,0,8,0,-8
13806,1,1,918,2467,1549
13807,1,0,17,0,-17
13808,0,0,27,0,-27
13809,0,0,7,0,-7
13810,1,0,2,0,-2
13811,1,1,1564,1369,-195
13812,0,0,34,0,-34
13813,1,0,124,0,-124
13814,1,0,68,0,-68
13815,0,0,65,0,-65
13816,0,0,102,0,-102
13817,1,1,660,1201,541
13818,1,0,1,0,-1
13819,0,0,74,0,-74
13820,1,0,24,0,-24
13821,1,1,1177,1739,562
13822,1,1,142,1615,1473
13823,0,0,6,0,-6
13824,0,0,79,0,-79
13825,0,0,0,0,0
13826,1,1,492,1500,1008
13827,1,1,356,1361,1005
13828,1,0,36,0,-36
13829,1,0,77,0,-77
13830,0,0,208,0,-208
13831,0,0,6,0,-6
13832,1,1,972,1364,392
13833,1,0,47,0,-47
13834,0,0,5,0,-5
13835,1,1,568,1930,1362
13836,0,0,76,0,-76
13837,1,1,598,1281,683
13838,0,0,159,0,-159
13839,1,1,928,1763,835
13840,0,0,143,0,-143
13841,1,0,8,0,-8
13842,1,0,51,0,-51
13843,0,0,168,0,-168
13844,0,0,51,0,-51
13845,1,0,12,0,-12
13846,0,0,35,0,-35
13847,0,0,48,0,-48
13848,1,0,0,0,0
13849,1,1,351,1529,1178
13850,0,0,3,0,-3
13851,1,0,86,0,-86
13852,1,1,303,1322,1019
13853,1,1,120,1825,1705
13854,1,0,180,0,-180
13855,1,0,19,0,-19
13856,1,0,24,0,-24
13857,1,0,52,0,-52
13858,1,1,213,1263,1050
13859,0,0,40,0,-40
13860,1,0,6,0,-6
13861,1,1,153,1866,1713
13862,1,0,32,0,-32
13863,0,0,30,0,-30
13864,1,0,36,0,-36
13865,0,0,29,0,-29
13866,1,0,70,0,-70
13867,1,0,127,0,-127
13868,1,0,31,0,-31
13869,1,0,7,0,-7
13870,1,0,78,0,-78
13871,1,0,0,0,0
13872,1,1,22,1452,1430
13873,1,1,678,1384,706
13874,0,0,10,0,-10
13875,0,0,22,0,-22
13876,1,1,320,2286,1966
13877,1,0,2,0,-2
13878,1,1,674,1214,540
13879,0,0,49,0,-49
13880,1,1,427,2015,1588
13881,1,0,115,0,-115
13882,0,0,31,0,-31
13883,0,0,1,0,-1
13884,0,0,47,0,-47
13885,1,0,27,0,-27
13886,1,0,209,0,-209
13887,1,0,4,0,-4
13888,1,0,5,0,-5
13889,0,0,33,0,-33
13890,1,0,43,0,-43
13891,0,0,42,0,-42
13892,0,0,15,0,-15
13893,0,0,29,0,-29
13894,0,0,116,0,-116
13895,1,0,6,0,-6
13896,0,0,91,0,-91
13897,0,0,20,0,-20
13898,1,1,594,1713,1119
13899,1,1,1156,1618,462
13900,1,0,58,0,-58
13901,1,1,631,1994,1363
13902,1,1,161,3112,2951
13903,1,0,41,0,-41
13904,1,0,10,0,-10
13905,0,0,3,0,-3
13906,1,0,32,0,-32
13907,1,0,0,0,0
13908,1,0,87,0,-87
13909,1,1,1751,1434,-317
13910,1,1,853,1483,630
13911,1,0,19,0,-19
13912,0,0,55,0,-55
13913,0,0,1,0,-1
13914,1,0,18,0,-18
13915,0,0,30,0,-30
13916,1,0,163,0,-163
13917,0,0,11,0,-11
13918,1,1,438,1546,1108
13919,1,1,988,1238,250
13920,0,0,50,0,-50
13921,1,1,596,1407,811
13922,0,0,38,0,-38
13923,1,1,86,1353,1267
13924,1,1,442,2840,2398
13925,0,0,86,0,-86
13926,0,0,23,0,-23
13927,1,0,50,0,-50
13928,1,0,3,0,-3
13929,1,1,384,1474,1090
13930,0,0,83,0,-83
13931,1,1,830,2523,1693
13932,1,1,204,1689,1485
13933,1,0,73,0,-73
13934,1,0,24,0,-24
13935,1,1,267,1269,1002
13936,1,1,150,1453,1303
13937,1,1,583,1746,1163
13938,1,0,2,0,-2
13939,0,0,21,0,-21
13940,1,1,364,1354,990
13941,0,0,21,0,-21
13942,1,0,10,0,-10
13943,1,0,44,0,-44
13944,1,0,37,0,-37
13945,1,1,606,1392,786
13946,1,0,47,0,-47
13947,0,0,48,0,-48
13948,1,0,41,0,-41
13949,0,0,13,0,-13
13950,0,0,50,0,-50
13951,0,0,23,0,-23
13952,1,1,261,1266,1005
13953,1,0,37,0,-37
13954,0,0,114,0,-114
13955,1,0,49,0,-49
13956,0,0,65,0,-65
13957,1,0,90,0,-90
13958,1,1,196,1475,1279
13959,1,1,242,1276,1034
13960,1,0,13,0,-13
13961,0,0,10,0,-10
13962,1,0,59,0,-59
13963,1,0,115,0,-115
13964,1,1,816,1915,1099
13965,1,1,104,2183,2079
13966,0,0,36,0,-36
13967,0,0,1,0,-1
13968,1,0,27,0,-27
13969,1,1,387,1641,1254
13970,1,1,1227,2285,1058
13971,0,0,44,0,-44
13972,1,0,5,0,-5
13973,1,0,56,0,-56
13974,1,1,376,1610,1234
13975,1,1,251,1842,1591
13976,1,1,681,1801,1120
13977,1,0,11,0,-11
13978,1,1,1443,1220,-223
13979,1,1,486,1391,905
13980,0,0,10,0,-10
13981,1,0,8,0,-8
13982,1,1,1181,2696,1515
13983,0,0,45,0,-45
13984,1,0,72,0,-72
13985,0,0,14,0,-14
13986,0,0,14,0,-14
13987,1,1,99,1893,1794
13988,1,0,44,0,-44
13989,1,0,41,0,-41
13990,0,0,19,0,-19
13991,1,0,80,0,-80
13992,0,0,59,0,-59
13993,1,0,68,0,-68
13994,1,0,1,0,-1
13995,1,0,47,0,-47
13996,0,0,140,0,-140
13997,0,0,81,0,-81
13998,1,1,1350,1260,-90
13999,1,0,101,0,-101
14000,1,0,78,0,-78
14001,0,0,12,0,-12
14002,0,0,17,0,-17
14003,1,1,522,1355,833
14004,1,1,267,1232,965
14005,0,0,1,0,-1
14006,1,1,1151,1812,661
14007,1,0,82,0,-82
14008,1,1,82,1258,1176
14009,1,0,55,0,-55
14010,1,1,1488,1501,13
14011,1,0,74,0,-74
14012,0,0,79,0,-79
14013,1,1,142,2135,1993
14014,1,0,54,0,-54
14015,0,0,54,0,-54
14016,0,0,23,0,-23
14017,1,0,5,0,-5
14018,1,0,1,0,-1
14019,0,0,7,0,-7
14020,1,1,1135,1363,228
14021,0,0,11,0,-11
14022,0,0,187,0,-187
14023,1,0,12,0,-12
14024,0,0,21,0,-21
14025,0,0,78,0,-78
14026,1,1,329,1222,893
14027,1,1,594,2988,2394
14028,0,0,26,0,-26
14029,1,0,16,0,-16
14030,1,0,7,0,-7
14031,1,1,324,1583,1259
14032,0,0,12,0,-12
14033,0,0,68,0,-68
14034,0,0,45,0,-45
14035,0,0,40,0,-40
14036,1,0,2,0,-2
14037,1,0,21,0,-21
14038,0,0,92,0,-92
14039,1,1,981,1236,255
14040,0,0,25,0,-25
14041,1,0,183,0,-183
14042,1,0,258,0,-258
14043,1,1,207,1344,1137
14044,0,0,63,0,-63
14045,1,1,182,1271,1089
14046,1,0,130,0,-130
14047,0,0,19,0,-19
14048,1,0,2,0,-2
14049,0,0,42,0,-42
14050,0,0,93,0,-93
14051,1,0,67,0,-67
14052,1,1,402,1251,849
14053,0,0,57,0,-57
14054,0,0,137,0,-137
14055,1,0,42,0,-42
14056,1,0,3,0,-3
14057,0,0,46,0,-46
14058,1,0,77,0,-77
14059,1,1,1311,1314,3
14060,1,0,2,0,-2
14061,1,0,19,0,-19
14062,0,0,77,0,-77
14063,0,0,57,0,-57
14064,0,0,14,0,-14
14065,0,0,2,0,-2
14066,1,1,79,2160,2081
14067,1,0,38,0,-38
14068,1,1,543,1377,834
14069,1,0,1,0,-1
14070,0,0,43,0,-43
14071,1,0,6,0,-6
14072,1,1,253,1832,1579
14073,1,1,81,1223,1142
14074,0,0,1,0,-1
14075,1,0,6,0,-6
14076,0,0,17,0,-17
14077,0,0,164,0,-164
14078,1,0,107,0,-107
14079,0,0,46,0,-46
14080,1,0,11,0,-11
14081,1,0,55,0,-55
14082,1,0,12,0,-12
14083,1,0,102,0,-102
14084,0,0,24,0,-24
14085,1,0,37,0,-37
14086,0,0,18,0,-18
14087,0,0,3,0,-3
14088,1,1,282,1604,1322
14089,1,1,367,1559,1192
14090,0,0,88,0,-88
14091,1,0,134,0,-134
14092,1,1,372,1587,1215
14093,1,1,380,1327,947
14094,1,1,35,1451,1416
14095,0,0,22,0,-22
14096,0,0,84,0,-84
14097,1,1,560,1608,1048
14098,0,0,23,0,-23
14099,0,0,89,0,-89
14100,0,0,4,0,-4
14101,1,0,4,0,-4
14102,1,1,321,1421,1100
14103,0,0,29,0,-29
14104,0,0,4,0,-4
14105,0,0,25,0,-25
14106,1,0,44,0,-44
14107,1,1,608,1851,1243
14108,1,1,101,1265,1164
14109,1,0,31,0,-31
14110,0,0,51,0,-51
14111,0,0,38,0,-38
14112,0,0,91,0,-91
14113,1,1,546,1550,1004
14114,1,1,173,1300,1127
14115,1,1,653,1299,646
14116,0,0,205,0,-205
14117,0,0,43,0,-43
14118,1,0,41,0,-41
14119,1,0,127,0,-127
14120,1,0,49,0,-49
14121,1,0,2,0,-2
14122,0,0,16,0,-16
14123,0,0,15,0,-15
14124,1,1,421,1467,1046
14125,0,0,39,0,-39
14126,1,0,39,0,-39
14127,1,0,13,0,-13
14128,0,0,16,0,-16
14129,0,0,42,0,-42
14130,1,0,10,0,-10
14131,1,1,427,1257,830
14132,0,0,22,0,-22
14133,0,0,39,0,-39
14134,1,1,72,1612,1540
14135,0,0,66,0,-66
14136,1,1,140,1762,1622
14137,1,1,116,1276,1160
14138,1,0,20,0,-20
14139,1,1,1124,1409,285
14140,1,1,160,1277,1117
14141,1,1,482,2202,1720
14142,1,1,246,1578,1332
14143,0,0,1,0,-1
14144,0,0,6,0,-6
14145,0,0,33,0,-33
14146,0,0,42,0,-42
14147,1,1,54,1925,1871
14148,1,1,307,1378,1071
14149,0,0,2,0,-2
14150,1,0,11,0,-11
14151,0,0,23,0,-23
14152,1,0,30,0,-30
14153,1,1,52,1474,1422
14154,0,0,36,0,-36
14155,0,0,14,0,-14
14156,1,1,272,1565,1293
14157,1,0,5,0,-5
14158,0,0,12,0,-12
14159,0,0,26,0,-26
14160,1,0,164,0,-164
14161,1,1,659,1300,641
14162,1,1,751,1339,588
14163,0,0,75,0,-75
14164,0,0,81,0,-81
14165,1,0,3,0,-3
14166,1,0,3,0,-3
14167,1,0,23,0,-23
14168,1,1,881,1662,781
14169,1,1,1122,1398,276
14170,1,0,43,0,-43
14171,1,0,61,0,-61
14172,1,1,143,1596,1453
14173,1,0,59,0,-59
14174,1,1,278,2306,2028
14175,1,0,40,0,-40
14176,1,1,62,1393,1331
14177,1,1,444,1973,1529
14178,1,0,0,0,0
14179,0,0,8,0,-8
14180,0,0,77,0,-77
14181,0,0,56,0,-56
14182,0,0,32,0,-32
14183,1,1,249,2484,2235
14184,0,0,12,0,-12
14185,1,1,779,1551,772
14186,0,0,38,0,-38
14187,1,1,124,1791,1667
14188,0,0,96,0,-96
14189,1,0,8,0,-8
14190,0,0,9,0,-9
14191,0,0,73,0,-73
14192,1,0,7,0,-7
14193,1,0,104,0,-104
14194,0,0,29,0,-29
14195,1,1,3709,1375,-2334
14196,0,0,42,0,-42
14197,1,1,454,1623,1169
14198,1,1,17,1317,1300
14199,0,0,18,0,-18
14200,1,0,17,0,-17
14201,1,1,70,2621,2551
14202,1,0,33,0,-33
14203,1,1,40,1205,1165
14204,1,1,242,1511,1269
14205,1,1,482,1904,1422
14206,1,0,74,0,-74
14207,0,0,78,0,-78
14208,1,0,10,0,-10
14209,0,0,23,0,-23
14210,0,0,4,0,-4
14211,1,0,23,0,-23
14212,0,0,70,0,-70
14213,1,0,64,0,-64
14214,0,0,40,0,-40
14215,0,0,13,0,-13
14216,0,0,8,0,-8
14217,1,0,1,0,-1
14218,1,0,86,0,-86
14219,1,1,298,1333,1035
14220,1,0,5,0,-5
14221,1,1,652,2938,2286
14222,1,0,30,0,-30
14223,1,1,268,1449,1181
14224,1,1,97,1631,1534
14225,0,0,66,0,-66
14226,0,0,52,0,-52
14227,0,0,130,0,-130
14228,0,0,165,0,-165
14229,0,0,110,0,-110
14230,0,0,32,0,-32
14231,0,0,42,0,-42
14232,1,1,72,1233,1161
14233,0,0,57,0,-57
14234,1,1,538,1379,841
14235,1,0,1,0,-1
14236,0,0,15,0,-15
14237,0,0,113,0,-113
14238,0,0,6,0,-6
14239,0,0,77,0,-77
14240,1,1,534,2192,1658
14241,0,0,84,0,-84
14242,1,0,112,0,-112
14243,1,0,170,0,-170
14244,1,0,231,0,-231
14245,1,1,1359,1301,-58
14246,1,0,28,0,-28
14247,1,0,0,0,0
14248,0,0,31,0,-31
14249,0,0,55,0,-55
14250,1,0,46,0,-46
14251,0,0,100,0,-100
14252,0,0,84,0,-84
14253,0,0,233,0,-233
14254,1,0,9,0,-9
14255,1,1,68,1745,1677
14256,0,0,9,0,-9
14257,1,0,69,0,-69
14258,1,0,19,0,-19
14259,1,1,202,1829,1627
14260,1,1,460,1227,767
14261,1,0,122,0,-122
14262,1,0,41,0,-41
14263,1,1,548,2206,1658
14264,0,0,147,0,-147
14265,1,0,61,0,-61
14266,0,0,58,0,-58
14267,1,0,0,0,0
14268,1,1,2094,1735,-359
14269,1,1,225,2020,1795
14270,0,0,43,0,-43
14271,1,0,57,0,-57
14272,1,0,8,0,-8
14273,0,0,239,0,-239
14274,1,0,60,0,-60
14275,1,1,667,1313,646
14276,1,0,83,0,-83
14277,1,1,515,1741,1226
14278,1,0,7,0,-7
14279,1,1,531,1743,1212
14280,0,0,27,0,-27
14281,0,0,42,0,-42
14282,0,0,59,0,-59
14283,1,1,2037,1232,-805
14284,1,0,9,0,-9
14285,0,0,101,0,-101
14286,1,0,287,0,-287
14287,0,0,1,0,-1
14288,1,0,40,0,-40
14289,0,0,1,0,-1
14290,1,0,26,0,-26
14291,1,1,106,1300,1194
14292,0,0,12,0,-12
14293,0,0,72,0,-72
14294,0,0,22,0,-22
14295,0,0,43,0,-43
14296,0,0,255,0,-255
14297,1,0,48,0,-48
14298,0,0,85,0,-85
14299,0,0,61,0,-61
14300,1,0,85,0,-85
14301,1,0,66,0,-66
14302,0,0,24,0,-24
14303,1,0,133,0,-133
14304,1,1,1880,1476,-404
14305,1,0,34,0,-34
14306,1,0,25,0,-25
14307,1,1,151,1234,1083
14308,1,1,268,1234,966
14309,0,0,45,0,-45
14310,1,0,196,0,-196
14311,1,0,39,0,-39
14312,0,0,27,0,-27
14313,0,0,3,0,-3
14314,1,0,50,0,-50
14315,1,0,8,0,-8
14316,1,0,108,0,-108
14317,1,0,8,0,-8
14318,1,1,236,1716,1480
14319,0,0,21,0,-21
14320,0,0,1,0,-1
14321,1,1,451,1229,778
14322,1,1,297,1203,906
14323,1,1,280,1351,1071
14324,0,0,30,0,-30
14325,1,1,270,1327,1057
14326,1,1,54,1518,1464
14327,1,0,71,0,-71
14328,1,1,181,2228,2047
14329,1,0,24,0,-24
14330,1,0,58,0,-58
14331,0,0,202,0,-202
14332,1,0,108,0,-108
14333,0,0,9,0,-9
14334,1,0,9,0,-9
14335,1,1,79,1580,1501
14336,1,0,22,0,-22
14337,1,1,889,5164,4275
14338,1,0,44,0,-44
14339,1,0,123,0,-123
14340,1,1,320,1626,1306
14341,1,0,27,0,-27
14342,0,0,30,0,-30
14343,0,0,47,0,-47
14344,0,0,135,0,-135
14345,0,0,82,0,-82
14346,1,1,248,1238,990
14347,1,1,1665,1894,229
14348,1,1,73,1224,1151
14349,1,0,173,0,-173
14350,1,0,79,0,-79
14351,0,0,2,0,-2
14352,1,0,2,0,-2
14353,0,0,98,0,-98
14354,0,0,33,0,-33
14355,1,1,131,1259,1128
14356,1,1,264,1629,1365
14357,0,0,13,0,-13
14358,1,0,16,0,-16
14359,0,0,69,0,-69
14360,1,0,43,0,-43
14361,0,0,25,0,-25
14362,0,0,48,0,-48
14363,0,0,20,0,-20
14364,1,0,25,0,-25
14365,0,0,135,0,-135
14366,1,1,67,1207,1140
14367,1,1,441,1683,1242
14368,1,0,98,0,-98
14369,0,0,14,0,-14
14370,1,1,368,1595,1227
14371,0,0,86,0,-86
14372,1,0,176,0,-176
14373,0,0,55,0,-55
14374,1,0,25,0,-25
14375,1,1,36,1677,1641
14376,1,0,21,0,-21
14377,0,0,26,0,-26
14378,1,1,320,1755,1435
14379,1,0,26,0,-26
14380,1,1,507,1237,730
14381,0,0,80,0,-80
14382,0,0,29,0,-29
14383,0,0,18,0,-18
14384,0,0,75,0,-75
14385,1,1,643,1288,645
14386,1,1,697,1781,1084
14387,1,0,67,0,-67
14388,1,0,190,0,-190
14389,0,0,5,0,-5
14390,0,0,3,0,-3
14391,1,1,132,2358,2226
14392,0,0,84,0,-84
14393,1,0,34,0,-34
14394,0,0,14,0,-14
14395,1,1,405,2098,1693
14396,0,0,35,0,-35
14397,1,0,155,0,-155
14398,1,1,1011,1532,521
14399,1,0,146,0,-146
14400,1,1,122,1333,1211
14401,1,1,191,1616,1425
14402,1,0,33,0,-33
14403,0,0,68,0,-68
14404,1,1,437,1409,972
14405,0,0,5,0,-5
14406,1,1,306,1482,1176
14407,1,0,0,0,0
14408,1,1,41,1425,1384
14409,1,0,17,0,-17
14410,1,0,42,0,-42
14411,0,0,59,0,-59
14412,0,0,16,0,-16
14413,1,0,77,0,-77
14414,1,1,567,3167,2600
14415,1,0,8,0,-8
14416,0,0,4,0,-4
14417,0,0,109,0,-109
14418,1,1,220,1664,1444
14419,1,0,5,0,-5
14420,0,0,54,0,-54
14421,1,1,927,1817,890
14422,1,0,15,0,-15
14423,0,0,10,0,-10
14424,1,1,661,1222,561
14425,1,0,18,0,-18
14426,1,0,5,0,-5
14427,1,0,131,0,-131
14428,0,0,119,0,-119
14429,0,0,13,0,-13
14430,1,0,16,0,-16
14431,1,1,1307,1212,-95
14432,0,0,6,0,-6
14433,0,0,10,0,-10
14434,1,0,3,0,-3
14435,0,0,8,0,-8
14436,1,0,51,0,-51
14437,0,0,100,0,-100
14438,0,0,29,0,-29
14439,0,0,214,0,-214
14440,1,0,99,0,-99
14441,1,0,0,0,0
14442,0,0,0,0,0
14443,0,0,9,0,-9
14444,0,0,3,0,-3
14445,0,0,20,0,-20
14446,0,0,23,0,-23
14447,0,0,49,0,-49
14448,1,0,17,0,-17
14449,0,0,139,0,-139
14450,1,1,1210,1224,14
14451,1,1,418,1202,784
14452,1,1,1785,1372,-413
14453,1,1,101,1245,1144
14454,0,0,5,0,-5
14455,0,0,90,0,-90
14456,1,1,4,1238,1234
14457,1,0,124,0,-124
14458,1,1,406,1763,1357
14459,1,0,2,0,-2
14460,0,0,99,0,-99
14461,1,0,34,0,-34
14462,1,1,353,1686,1333
14463,1,0,104,0,-104
14464,1,0,24,0,-24
14465,0,0,14,0,-14
14466,0,0,25,0,-25
14467,1,0,37,0,-37
14468,0,0,59,0,-59
14469,1,0,16,0,-16
14470,0,0,20,0,-20
14471,0,0,2,0,-2
14472,1,0,123,0,-123
14473,0,0,28,0,-28
14474,1,1,111,2856,2745
14475,1,1,478,1323,845
14476,1,1,75,1376,1301
14477,1,1,625,1482,857
14478,1,1,308,1569,1261
14479,0,0,35,0,-35
14480,0,0,9,0,-9
14481,1,1,1826,1669,-157
14482,1,0,0,0,0
14483,1,0,99,0,-99
14484,0,0,47,0,-47
14485,0,0,117,0,-117
14486,1,1,99,1374,1275
14487,0,0,113,0,-113
14488,0,0,77,0,-77
14489,1,1,232,1352,1120
14490,1,1,779,1232,453
14491,1,0,44,0,-44
14492,0,0,58,0,-58
14493,0,0,4,0,-4
14494,0,0,34,0,-34
14495,1,0,51,0,-51
14496,1,1,443,2010,1567
14497,0,0,43,0,-43
14498,1,0,71,0,-71
14499,1,0,8,0,-8
14500,0,0,68,0,-68
14501,1,1,711,1278,567
14502,0,0,20,0,-20
14503,1,1,408,1295,887
14504,1,0,36,0,-36
14505,1,0,17,0,-17
14506,1,1,1070,1472,402
14507,1,1,620,1302,682
14508,1,0,3,0,-3
14509,0,0,60,0,-60
14510,1,0,5,0,-5
14511,1,0,1,0,-1
14512,1,1,257,1421,1164
14513,1,0,21,0,-21
14514,1,0,25,0,-25
14515,0,0,21,0,-21
14516,1,1,1035,1251,216
14517,0,0,95,0,-95
14518,0,0,3,0,-3
14519,1,1,88,2561,2473
14520,0,0,85,0,-85
14521,1,0,48,0,-48
14522,0,0,64,0,-64
14523,1,0,69,0,-69
14524,1,0,55,0,-55
14525,0,0,30,0,-30
14526,1,0,3,0,-3
14527,0,0,10,0,-10
14528,0,0,15,0,-15
14529,0,0,91,0,-91
14530,1,1,541,1286,745
14531,1,0,205,0,-205
14532,0,0,132,0,-132
14533,1,0,9,0,-9
14534,0,0,32,0,-32
14535,1,1,388,1455,1067
14536,0,0,90,0,-90
14537,1,1,172,1449,1277
14538,1,0,106,0,-106
14539,1,1,726,1525,799
14540,1,1,550,2269,1719
14541,1,0,88,0,-88
14542,1,0,45,0,-45
14543,1,1,489,1289,800
14544,0,0,155,0,-155
14545,1,1,1603,1382,-221
14546,1,1,502,1314,812
14547,0,0,21,0,-21
14548,1,1,412,1207,795
14549,1,1,690,1497,807
14550,1,1,128,1272,1144
14551,1,1,221,1441,1220
14552,1,0,18,0,-18
14553,0,0,1,0,-1
14554,1,0,21,0,-21
14555,0,0,23,0,-23
14556,1,1,119,3693,3574
14557,1,1,364,1776,1412
14558,0,0,146,0,-146
14559,1,0,91,0,-91
14560,1,1,124,1716,1592
14561,0,0,35,0,-35
14562,1,1,1821,1494,-327
14563,1,1,598,3929,3331
14564,1,0,39,0,-39
14565,0,0,67,0,-67
14566,1,0,30,0,-30
14567,0,0,109,0,-109
14568,0,0,378,0,-378
14569,0,0,13,0,-13
14570,0,0,30,0,-30
14571,0,0,86,0,-86
14572,1,1,803,1278,475
14573,0,0,50,0,-50
14574,0,0,41,0,-41
14575,0,0,23,0,-23
14576,1,0,12,0,-12
14577,0,0,20,0,-20
14578,0,0,56,0,-56
14579,0,0,4,0,-4
14580,0,0,65,0,-65
14581,1,0,19,0,-19
14582,1,1,184,1359,1175
14583,0,0,33,0,-33
14584,1,1,160,1746,1586
14585,1,1,534,1253,719
14586,1,0,45,0,-45
14587,1,1,130,1411,1281
14588,1,0,0,0,0
14589,0,0,37,0,-37
14590,1,0,10,0,-10
14591,0,0,110,0,-110
14592,0,0,13,0,-13
14593,0,0,8,0,-8
14594,1,1,501,1239,738
14595,0,0,0,0,0
14596,0,0,5,0,-5
14597,0,0,195,0,-195
14598,1,1,1820,1212,-608
14599,1,0,59,0,-59
14600,1,0,1,0,-1
14601,1,0,84,0,-84
14602,0,0,44,0,-44
14603,0,0,14,0,-14
14604,1,1,162,1319,1157
14605,1,0,2,0,-2
14606,1,0,154,0,-154
14607,1,1,320,1451,1131
14608,0,0,5,0,-5
14609,1,0,37,0,-37
14610,1,0,10,0,-10
14611,1,0,3,0,-3
14612,0,0,13,0,-13
14613,1,1,466,1312,846
14614,0,0,119,0,-119
14615,1,1,56,1267,1211
14616,0,0,10,0,-10
14617,1,0,46,0,-46
14618,0,0,49,0,-49
14619,1,1,133,1732,1599
14620,0,0,12,0,-12
14621,1,1,1017,1360,343
14622,0,0,32,0,-32
14623,1,1,185,1232,1047
14624,1,0,4,0,-4
14625,1,0,7,0,-7
14626,1,1,380,1278,898
14627,1,1,93,1225,1132
14628,0,0,7,0,-7
14629,0,0,51,0,-51
14630,0,0,132,0,-132
14631,1,0,32,0,-32
14632,0,0,16,0,-16
14633,0,0,12,0,-12
14634,1,1,417,1771,1354
14635,1,0,8,0,-8
14636,1,0,32,0,-32
14637,0,0,0,0,0
14638,0,0,97,0,-97
14639,1,0,64,0,-64
14640,0,0,28,0,-28
14641,1,0,5,0,-5
14642,1,1,374,1488,1114
14643,1,1,344,1269,925
14644,1,0,4,0,-4
14645,1,0,267,0,-267
14646,1,0,64,0,-64
14647,1,0,80,0,-80
14648,1,0,52,0,-52
14649,0,0,120,0,-120
14650,1,0,1,0,-1
14651,1,1,1021,1345,324
14652,0,0,79,0,-79
14653,1,0,72,0,-72
14654,1,1,256,2285,2029
14655,1,1,254,1466,1212
14656,0,0,17,0,-17
14657,0,0,1,0,-1
14658,1,1,596,1779,1183
14659,1,0,128,0,-128
14660,1,1,552,1517,965
14661,0,0,57,0,-57
14662,1,0,25,0,-25
14663,1,0,43,0,-43
14664,1,1,341,1249,908
14665,0,0,123,0,-123
14666,0,0,68,0,-68
14667,0,0,28,0,-28
14668,0,0,100,0,-100
14669,1,0,0,0,0
14670,1,1,103,1409,1306
14671,0,0,11,0,-11
14672,1,1,195,1343,1148
14673,0,0,115,0,-115
14674,1,1,868,1208,340
14675,1,0,6,0,-6
14676,0,0,43,0,-43
14677,0,0,26,0,-26
14678,0,0,100,0,-100
14679,0,0,16,0,-16
14680,1,0,21,0,-21
14681,0,0,48,0,-48
14682,1,1,289,1492,1203
14683,0,0,127,0,-127
14684,1,0,49,0,-49
14685,1,1,159,1307,1148
14686,0,0,226,0,-226
14687,1,0,2,0,-2
14688,1,0,2,0,-2
14689,0,0,55,0,-55
14690,1,1,863,1586,723
14691,1,0,135,0,-135
14692,1,0,17,0,-17
14693,0,0,56,0,-56
14694,0,0,131,0,-131
14695,1,0,103,0,-103
14696,0,0,10,0,-10
14697,0,0,112,0,-112
14698,0,0,49,0,-49
14699,0,0,57,0,-57
14700,0,0,36,0,-36
14701,1,1,101,1477,1376
14702,1,0,15,0,-15
14703,0,0,70,0,-70
14704,1,1,380,1232,852
14705,0,0,42,0,-42
14706,1,0,21,0,-21
14707,0,0,15,0,-15
14708,0,0,14,0,-14
14709,1,0,1,0,-1
14710,1,0,91,0,-91
14711,1,1,559,1461,902
14712,0,0,27,0,-27
14713,0,0,42,0,-42
14714,0,0,128,0,-128
14715,0,0,179,0,-179
14716,1,1,483,1384,901
14717,0,0,64,0,-64
14718,1,1,86,1221,1135
14719,1,1,1275,2622,1347
14720,0,0,5,0,-5
14721,1,1,1090,1331,241
14722,1,1,456,1599,1143
14723,0,0,36,0,-36
14724,1,1,813,1362,549
14725,1,0,0,0,0
14726,0,0,50,0,-50
14727,0,0,0,0,0
14728,0,0,5,0,-5
14729,0,0,22,0,-22
14730,1,0,14,0,-14
14731,0,0,83,0,-83
14732,1,0,10,0,-10
14733,1,1,94,1303,1209
14734,1,0,29,0,-29
14735,0,0,31,0,-31
14736,1,1,659,1571,912
14737,1,1,532,1607,1075
14738,0,0,13,0,-13
14739,0,0,40,0,-40
14740,0,0,4,0,-4
14741,1,1,134,1545,1411
14742,1,0,28,0,-28
14743,1,0,14,0,-14
14744,0,0,20,0,-20
14745,1,0,240,0,-240
14746,0,0,40,0,-40
14747,1,0,23,0,-23
14748,1,0,173,0,-173
14749,0,0,56,0,-56
14750,1,0,131,0,-131
14751,0,0,27,0,-27
14752,0,0,121,0,-121
14753,1,1,533,1236,703
14754,1,1,757,1210,453
14755,1,0,36,0,-36
14756,0,0,0,0,0
14757,1,0,1,0,-1
14758,1,0,109,0,-109
14759,0,0,20,0,-20
14760,0,0,6,0,-6
14761,1,1,1153,1240,87
14762,0,0,169,0,-169
14763,0,0,58,0,-58
14764,0,0,28,0,-28
14765,0,0,21,0,-21
14766,0,0,66,0,-66
14767,0,0,25,0,-25
14768,1,0,31,0,-31
14769,1,0,5,0,-5
14770,1,0,31,0,-31
14771,1,0,81,0,-81
14772,1,0,109,0,-109
14773,0,0,294,0,-294
14774,0,0,98,0,-98
14775,1,0,10,0,-10
14776,0,0,60,0,-60
14777,0,0,50,0,-50
14778,1,0,18,0,-18
14779,1,1,219,1320,1101
14780,1,1,1429,1212,-217
14781,0,0,90,0,-90
14782,1,0,27,0,-27
14783,1,0,41,0,-41
14784,1,0,23,0,-23
14785,1,1,2079,1258,-821
14786,0,0,34,0,-34
14787,1,1,557,1322,765
14788,1,0,7,0,-7
14789,0,0,52,0,-52
14790,1,1,1040,1340,300
14791,1,0,50,0,-50
14792,1,1,287,1353,1066
14793,0,0,146,0,-146
14794,0,0,90,0,-90
14795,0,0,49,0,-49
14796,1,1,669,1415,746
14797,1,1,539,1556,1017
14798,0,0,110,0,-110
14799,0,0,85,0,-85
14800,0,0,202,0,-202
14801,0,0,25,0,-25
14802,0,0,11,0,-11
14803,0,0,58,0,-58
14804,0,0,86,0,-86
14805,1,0,2,0,-2
14806,0,0,23,0,-23
14807,1,1,336,1854,1518
14808,1,0,58,0,-58
14809,1,1,586,1827,1241
14810,1,1,577,1547,970
14811,1,1,86,1229,1143
14812,1,0,69,0,-69
14813,0,0,10,0,-10
14814,1,1,141,1338,1197
14815,1,0,44,0,-44
14816,1,0,80,0,-80
14817,1,1,861,1204,343
14818,0,0,40,0,-40
14819,0,0,13,0,-13
14820,1,1,143,2509,2366
14821,0,0,47,0,-47
14822,1,1,894,2134,1240
14823,0,0,13,0,-13
14824,1,1,1361,1836,475
14825,0,0,16,0,-16
14826,1,1,216,1258,1042
14827,1,0,15,0,-15
14828,1,0,62,0,-62
14829,1,1,101,1983,1882
14830,0,0,22,0,-22
14831,0,0,4,0,-4
14832,0,0,5,0,-5
14833,1,0,30,0,-30
14834,1,0,16,0,-16
14835,1,0,57,0,-57
14836,0,0,29,0,-29
14837,0,0,56,0,-56
14838,1,0,3,0,-3
14839,1,1,94,2064,1970
14840,1,0,14,0,-14
14841,1,1,1573,1527,-46
14842,1,0,6,0,-6
14843,0,0,148,0,-148
14844,1,0,96,0,-96
14845,1,0,176,0,-176
14846,0,0,68,0,-68
14847,1,0,33,0,-33
14848,0,0,9,0,-9
14849,1,0,0,0,0
14850,0,0,44,0,-44
14851,0,0,8,0,-8
14852,0,0,101,0,-101
14853,1,0,8,0,-8
14854,1,1,246,1395,1149
14855,0,0,94,0,-94
14856,1,1,124,1297,1173
14857,0,0,38,0,-38
14858,0,0,8,0,-8
14859,1,1,632,1302,670
14860,0,0,2,0,-2
14861,1,1,413,1261,848
14862,1,0,86,0,-86
14863,0,0,19,0,-19
14864,1,1,264,1397,1133
14865,1,1,204,1263,1059
14866,1,0,81,0,-81
14867,1,1,232,1321,1089
14868,1,0,186,0,-186
14869,0,0,10,0,-10
14870,1,1,1062,1204,142
14871,1,1,650,1508,858
14872,0,0,131,0,-131
14873,0,0,48,0,-48
14874,1,1,492,1678,1186
14875,0,0,16,0,-16
14876,1,0,28,0,-28
14877,1,0,69,0,-69
14878,0,0,33,0,-33
14879,1,0,29,0,-29
14880,1,0,71,0,-71
14881,1,1,724,1525,801
14882,1,0,69,0,-69
14883,0,0,26,0,-26
14884,0,0,19,0,-19
14885,0,0,46,0,-46
14886,1,0,41,0,-41
14887,1,0,133,0,-133
14888,0,0,16,0,-16
14889,0,0,57,0,-57
14890,1,1,517,1329,812
14891,1,0,35,0,-35
14892,1,0,41,0,-41
14893,0,0,1,0,-1
14894,1,1,239,1408,1169
14895,1,1,304,1336,1032
14896,0,0,8,0,-8
14897,0,0,9,0,-9
14898,1,1,54,1219,1165
14899,0,0,32,0,-32
14900,0,0,163,0,-163
14901,1,1,103,1220,1117
14902,0,0,36,0,-36
14903,0,0,33,0,-33
14904,1,1,213,1654,1441
14905,1,0,57,0,-57
14906,1,0,4,0,-4
14907,1,1,1882,1312,-570
14908,0,0,0,0,0
14909,1,1,1767,1466,-301
14910,0,0,24,0,-24
14911,0,0,62,0,-62
14912,1,1,158,1283,1125
14913,1,0,4,0,-4
14914,1,0,34,0,-34
14915,1,0,133,0,-133
14916,0,0,24,0,-24
14917,1,0,58,0,-58
14918,0,0,7,0,-7
14919,0,0,14,0,-14
14920,0,0,9,0,-9
14921,1,1,1549,2763,1214
14922,0,0,44,0,-44
14923,1,0,71,0,-71
14924,1,0,7,0,-7
14925,0,0,55,0,-55
14926,1,0,49,0,-49
14927,1,1,279,1984,1705
14928,0,0,21,0,-21
14929,1,1,1067,1642,575
14930,0,0,109,0,-109
14931,1,0,12,0,-12
14932,1,0,16,0,-16
14933,0,0,22,0,-22
14934,1,0,88,0,-88
14935,0,0,75,0,-75
14936,1,1,930,1293,363
14937,1,1,546,1501,955
14938,0,0,29,0,-29
14939,1,1,51,1537,1486
14940,1,1,1180,2092,912
14941,0,0,13,0,-13
14942,1,0,50,0,-50
14943,0,0,11,0,-11
14944,1,0,44,0,-44
14945,1,1,1344,1883,539
14946,0,0,95,0,-95
14947,1,0,31,0,-31
14948,1,1,104,1650,1546
14949,0,0,5,0,-5
14950,1,1,286,1406,1120
14951,1,1,924,1332,408
14952,0,0,103,0,-103
14953,1,1,1137,1417,280
14954,1,0,16,0,-16
14955,1,1,30,1362,1332
14956,0,0,29,0,-29
14957,1,0,15,0,-15
14958,0,0,1,0,-1
14959,1,0,54,0,-54
14960,1,1,273,1238,965
14961,1,1,385,1205,820
14962,0,0,37,0,-37
14963,0,0,11,0,-11
14964,0,0,14,0,-14
14965,1,1,436,1215,779
14966,0,0,7,0,-7
14967,0,0,59,0,-59
14968,1,1,496,1602,1106
14969,0,0,61,0,-61
14970,1,0,43,0,-43
14971,0,0,13,0,-13
14972,1,0,22,0,-22
14973,0,0,25,0,-25
14974,0,0,18,0,-18
14975,1,0,143,0,-143
14976,1,0,40,0,-40
14977,0,0,30,0,-30
14978,1,1,613,1215,602
14979,1,1,163,1495,1332
14980,1,1,227,1849,1622
14981,1,0,9,0,-9
14982,0,0,32,0,-32
14983,1,0,14,0,-14
14984,1,0,44,0,-44
14985,0,0,8,0,-8
14986,0,0,73,0,-73
14987,0,0,68,0,-68
14988,1,1,889,1363,474
14989,1,0,16,0,-16
14990,0,0,39,0,-39
14991,1,0,152,0,-152
14992,1,0,62,0,-62
14993,0,0,16,0,-16
14994,1,1,397,1405,1008
14995,1,0,73,0,-73
14996,1,1,352,1803,1451
14997,0,0,36,0,-36
14998,1,0,21,0,-21
14999,0,0,49,0,-49
15000,0,0,193,0,-193
15001,1,0,106,0,-106
15002,1,0,44,0,-44
15003,1,0,45,0,-45
15004,0,0,13,0,-13
15005,0,0,44,0,-44
15006,1,1,199,1293,1094
15007,1,1,852,2006,1154
15008,1,1,761,1265,504
15009,0,0,11,0,-11
15010,0,0,11,0,-11
15011,0,0,85,0,-85
15012,0,0,50,0,-50
15013,0,0,14,0,-14
15014,0,0,56,0,-56
15015,1,0,34,0,-34
15016,0,0,16,0,-16
15017,1,0,21,0,-21
15018,0,0,91,0,-91
15019,1,0,13,0,-13
15020,1,1,259,1956,1697
15021,0,0,6,0,-6
15022,1,0,27,0,-27
15023,0,0,51,0,-51
15024,0,0,54,0,-54
15025,1,1,338,1559,1221
15026,0,0,68,0,-68
15027,0,0,85,0,-85
15028,1,1,368,1301,933
15029,0,0,2,0,-2
15030,0,0,21,0,-21
15031,1,1,275,1431,1156
15032,0,0,124,0,-124
15033,1,1,311,1242,931
15034,1,1,529,1233,704
15035,1,1,352,1379,1027
15036,1,0,18,0,-18
15037,1,1,111,1550,1439
15038,1,1,425,1487,1062
15039,0,0,4,0,-4
15040,1,1,1022,1318,296
15041,1,1,73,1783,1710
15042,0,0,32,0,-32
15043,1,0,5,0,-5
15044,1,0,8,0,-8
15045,1,0,81,0,-81
15046,1,0,41,0,-41
15047,1,0,81,0,-81
15048,0,0,9,0,-9
15049,1,1,2130,1317,-813
15050,1,0,39,0,-39
15051,1,1,868,1351,483
15052,1,0,74,0,-74
15053,0,0,61,0,-61
15054,0,0,12,0,-12
15055,1,0,23,0,-23
15056,1,0,13,0,-13
15057,0,0,56,0,-56
15058,1,1,409,1549,1140
15059,1,1,200,2488,2288
15060,1,1,834,1269,435
15061,0,0,20,0,-20
15062,0,0,18,0,-18
15063,1,0,94,0,-94
15064,1,1,129,1372,1243
15065,0,0,364,0,-364
15066,0,0,5,0,-5
15067,0,0,24,0,-24
15068,1,0,24,0,-24
15069,1,0,47,0,-47
15070,0,0,48,0,-48
15071,1,0,17,0,-17
15072,0,0,26,0,-26
15073,1,0,21,0,-21
15074,0,0,79,0,-79
15075,1,0,13,0,-13
15076,1,1,272,1462,1190
15077,0,0,10,0,-10
15078,0,0,44,0,-44
15079,1,1,878,1215,337
15080,0,0,13,0,-13
15081,1,1,173,1312,1139
15082,1,0,9,0,-9
15083,0,0,60,0,-60
15084,0,0,53,0,-53
15085,1,0,5,0,-5
15086,1,0,61,0,-61
15087,0,0,14,0,-14
15088,0,0,2,0,-2
15089,1,0,60,0,-60
15090,1,0,147,0,-147
15091,1,0,22,0,-22
15092,1,0,3,0,-3
15093,1,0,140,0,-140
15094,1,0,90,0,-90
15095,0,0,19,0,-19
15096,1,1,142,1567,1425
15097,1,1,746,1266,520
15098,1,1,539,1541,1002
15099,0,0,46,0,-46
15100,1,0,14,0,-14
15101,1,0,72,0,-72
15102,0,0,0,0,0
15103,1,1,1188,1279,91
15104,0,0,48,0,-48
15105,1,0,202,0,-202
15106,1,1,918,1268,350
15107,0,0,41,0,-41
15108,0,0,84,0,-84
15109,1,1,288,1293,1005
15110,0,0,2,0,-2
15111,1,0,11,0,-11
15112,0,0,37,0,-37
15113,1,1,646,1344,698
15114,0,0,181,0,-181
15115,1,0,33,0,-33
15116,1,1,591,1687,1096
15117,0,0,24,0,-24
15118,1,1,143,1366,1223
15119,1,1,939,1201,262
15120,0,0,46,0,-46
15121,1,1,1123,1717,594
15122,1,0,95,0,-95
15123,0,0,108,0,-108
15124,0,0,6,0,-6
15125,0,0,21,0,-21
15126,0,0,9,0,-9
15127,1,1,2236,1797,-439
15128,0,0,35,0,-35
15129,0,0,42,0,-42
15130,1,1,72,1280,1208
15131,1,0,56,0,-56
15132,1,1,326,1489,1163
15133,0,0,23,0,-23
15134,0,0,71,0,-71
15135,1,1,245,3400,3155
15136,0,0,35,0,-35
15137,0,0,88,0,-88
15138,0,0,81,0,-81
15139,0,0,56,0,-56
15140,0,0,14,0,-14
15141,0,0,11,0,-11
15142,1,0,87,0,-87
15143,1,1,353,1477,1124
15144,1,1,148,1549,1401
15145,1,1,280,1597,1317
15146,1,1,144,1226,1082
15147,0,0,15,0,-15
15148,1,0,1,0,-1
15149,0,0,54,0,-54
15150,1,1,573,1521,948
15151,1,0,73,0,-73
15152,0,0,37,0,-37
15153,1,0,22,0,-22
15154,0,0,6,0,-6
15155,1,1,646,1910,1264
15156,1,1,154,2540,2386
15157,1,1,32,1625,1593
15158,0,0,144,0,-144
15159,1,0,15,0,-15
15160,1,0,167,0,-167
15161,0,0,47,0,-47
15162,0,0,86,0,-86
15163,0,0,15,0,-15
15164,1,0,97,0,-97
15165,1,1,276,1348,1072
15166,1,0,49,0,-49
15167,1,0,7,0,-7
15168,0,0,68,0,-68
15169,1,1,712,1382,670
15170,0,0,45,0,-45
15171,1,1,133,1449,1316
15172,0,0,34,0,-34
15173,0,0,10,0,-10
15174,1,0,3,0,-3
15175,1,0,10,0,-10
15176,0,0,22,0,-22
15177,0,0,36,0,-36
15178,1,1,761,1273,512
15179,1,0,141,0,-141
15180,1,0,5,0,-5
15181,0,0,55,0,-55
15182,1,0,29,0,-29
15183,1,1,256,1230,974
15184,0,0,51,0,-51
15185,0,0,41,0,-41
15186,0,0,54,0,-54
15187,0,0,10,0,-10
15188,0,0,3,0,-3
15189,1,0,41,0,-41
15190,1,0,59,0,-59
15191,1,0,11,0,-11
15192,1,1,621,1324,703
15193,0,0,21,0,-21
15194,1,1,55,1204,1149
15195,1,1,1070,1383,313
15196,1,0,42,0,-42
15197,0,0,36,0,-36
15198,1,0,22,0,-22
15199,1,0,150,0,-150
15200,0,0,51,0,-51
15201,1,0,160,0,-160
15202,1,1,618,1345,727
15203,1,0,80,0,-80
15204,0,0,7,0,-7
15205,1,1,30,1324,1294
15206,1,0,45,0,-45
15207,0,0,42,0,-42
15208,1,1,637,1862,1225
15209,1,0,30,0,-30
15210,0,0,146,0,-146
15211,1,1,7,1759,1752
15212,1,1,789,1501,712
15213,1,1,808,1451,643
15214,0,0,34,0,-34
15215,1,0,25,0,-25
15216,1,0,5,0,-5
15217,1,1,276,1469,1193
15218,0,0,74,0,-74
15219,1,0,9,0,-9
15220,1,1,128,1606,1478
15221,0,0,3,0,-3
15222,1,1,657,1530,873
15223,1,1,584,1223,639
15224,0,0,1,0,-1
15225,1,1,825,3157,2332
15226,0,0,10,0,-10
15227,0,0,50,0,-50
15228,0,0,46,0,-46
15229,1,1,148,1810,1662
15230,0,0,28,0,-28
15231,1,0,72,0,-72
15232,1,0,22,0,-22
15233,1,1,188,4668,4480
15234,0,0,52,0,-52
15235,0,0,63,0,-63
15236,1,1,328,1911,1583
15237,0,0,50,0,-50
15238,1,1,178,1330,1152
15239,0,0,24,0,-24
15240,1,0,46,0,-46
15241,1,1,262,1288,1026
15242,0,0,23,0,-23
15243,0,0,31,0,-31
15244,1,1,262,1259,997
15245,0,0,105,0,-105
15246,0,0,74,0,-74
15247,1,1,605,1409,804
15248,1,0,65,0,-65
15249,0,0,67,0,-67
15250,1,1,1054,1202,148
15251,1,1,270,1334,1064
15252,0,0,16,0,-16
15253,0,0,89,0,-89
15254,0,0,16,0,-16
15255,0,0,120,0,-120
15256,0,0,142,0,-142
15257,0,0,25,0,-25
15258,1,0,17,0,-17
15259,1,1,647,1511,864
15260,1,1,112,1201,1089
15261,1,1,222,1333,1111
15262,0,0,13,0,-13
15263,0,0,204,0,-204
15264,0,0,18,0,-18
15265,1,0,64,0,-64
15266,0,0,88,0,-88
15267,1,1,346,1560,1214
15268,1,0,3,0,-3
15269,1,0,45,0,-45
15270,0,0,0,0,0
15271,1,1,333,1875,1542
15272,1,1,855,1370,515
15273,1,0,6,0,-6
15274,1,0,24,0,-24
15275,0,0,27,0,-27
15276,1,1,136,1275,1139
15277,1,0,49,0,-49
15278,0,0,7,0,-7
15279,0,0,35,0,-35
15280,0,0,56,0,-56
15281,1,0,23,0,-23
15282,1,0,72,0,-72
15283,0,0,24,0,-24
15284,1,1,455,1331,876
15285,1,1,681,1311,630
15286,1,0,9,0,-9
15287,1,1,707,1314,607
15288,1,0,35,0,-35
15289,1,1,801,1733,932
15290,1,0,1,0,-1
15291,1,1,38,1562,1524
15292,1,0,107,0,-107
15293,0,0,21,0,-21
15294,1,0,29,0,-29
15295,1,1,606,1672,1066
15296,0,0,21,0,-21
15297,0,0,38,0,-38
15298,1,1,320,1317,997
15299,0,0,57,0,-57
15300,1,0,115,0,-115
15301,0,0,3,0,-3
15302,1,0,44,0,-44
15303,0,0,6,0,-6
15304,1,1,138,1215,1077
15305,1,0,48,0,-48
15306,1,0,20,0,-20
15307,0,0,3,0,-3
15308,1,1,380,1362,982
15309,0,0,115,0,-115
15310,1,1,831,1333,502
15311,1,1,1299,1808,509
15312,1,0,0,0,0
15313,0,0,12,0,-12
15314,1,1,710,1248,538
15315,1,0,21,0,-21
15316,1,0,71,0,-71
15317,0,0,2,0,-2
15318,1,1,238,1342,1104
15319,0,0,1,0,-1
15320,1,1,324,1501,1177
15321,0,0,9,0,-9
15322,1,1,225,1229,1004
15323,0,0,142,0,-142
15324,1,1,522,1201,679
15325,0,0,5,0,-5
15326,0,0,158,0,-158
15327,0,0,18,0,-18
15328,0,0,166,0,-166
15329,0,0,14,0,-14
15330,0,0,86,0,-86
15331,1,1,221,1472,1251
15332,0,0,14,0,-14
15333,1,1,1000,1433,433
15334,1,1,240,1816,1576
15335,1,1,1299,1216,-83
15336,0,0,47,0,-47
15337,0,0,112,0,-112
15338,0,0,50,0,-50
15339,0,0,11,0,-11
15340,1,1,447,1443,996
15341,0,0,59,0,-59
15342,0,0,50,0,-50
15343,1,1,1390,1220,-170
15344,0,0,161,0,-161
15345,1,1,164,1358,1194
15346,1,0,27,0,-27
15347,1,0,74,0,-74
15348,0,0,20,0,-20
15349,0,0,51,0,-51
15350,0,0,44,0,-44
15351,0,0,16,0,-16
15352,1,1,1231,1273,42
15353,1,0,149,0,-149
15354,1,1,347,2179,1832
15355,1,1,1465,1615,150
15356,0,0,29,0,-29
15357,1,1,211,1409,1198
15358,1,1,123,1536,1413
15359,0,0,7,0,-7
15360,1,0,10,0,-10
15361,1,1,205,1223,1018
15362,0,0,83,0,-83
15363,1,0,79,0,-79
15364,0,0,29,0,-29
15365,1,0,145,0,-145
15366,0,0,79,0,-79
15367,1,1,274,1698,1424
15368,1,1,330,1282,952
15369,0,0,9,0,-9
15370,0,0,28,0,-28
15371,1,1,248,2013,1765
15372,0,0,9,0,-9
15373,0,0,43,0,-43
15374,0,0,84,0,-84
15375,1,0,76,0,-76
15376,1,1,2009,1204,-805
15377,1,0,9,0,-9
15378,0,0,3,0,-3
15379,0,0,5,0,-5
15380,0,0,27,0,-27
15381,1,1,504,1215,711
15382,1,1,449,1576,1127
15383,1,1,404,3494,3090
15384,0,0,28,0,-28
15385,1,0,32,0,-32
15386,1,0,106,0,-106
15387,1,1,493,1619,1126
15388,1,1,79,1402,1323
15389,1,0,6,0,-6
15390,0,0,37,0,-37
15391,1,1,250,1234,984
15392,1,1,885,1271,386
15393,1,1,766,1200,434
15394,1,0,122,0,-122
15395,0,0,13,0,-13
15396,1,0,93,0,-93
15397,1,1,799,1826,1027
15398,1,0,17,0,-17
15399,1,0,1,0,-1
15400,0,0,64,0,-64
15401,0,0,86,0,-86
15402,1,1,1085,1321,236
15403,1,1,207,1335,1128
15404,0,0,14,0,-14
15405,1,0,31,0,-31
15406,1,0,15,0,-15
15407,0,0,32,0,-32
15408,0,0,48,0,-48
15409,1,0,19,0,-19
15410,1,1,671,2069,1398
15411,1,0,127,0,-127
15412,1,1,479,1701,1222
15413,1,0,43,0,-43
15414,1,0,46,0,-46
15415,1,1,135,1490,1355
15416,0,0,7,0,-7
15417,1,0,14,0,-14
15418,1,0,41,0,-41
15419,0,0,21,0,-21
15420,0,0,18,0,-18
15421,1,0,10,0,-10
15422,0,0,0,0,0
15423,0,0,36,0,-36
15424,1,0,15,0,-15
15425,1,0,31,0,-31
15426,1,0,5,0,-5
15427,1,1,420,1346,926
15428,0,0,14,0,-14
15429,0,0,200,0,-200
15430,0,0,115,0,-115
15431,1,0,0,0,0
15432,1,1,64,1568,1504
15433,0,0,11,0,-11
15434,0,0,33,0,-33
15435,1,1,515,1288,773
15436,0,0,49,0,-49
15437,1,0,196,0,-196
15438,1,1,320,1593,1273
15439,1,1,52,1207,1155
15440,1,0,163,0,-163
15441,0,0,213,0,-213
15442,0,0,90,0,-90
15443,1,0,44,0,-44
15444,1,0,4,0,-4
15445,0,0,133,0,-133
15446,0,0,11,0,-11
15447,1,1,315,1902,1587
15448,1,0,2,0,-2
15449,0,0,98,0,-98
15450,1,0,63,0,-63
15451,0,0,143,0,-143
15452,0,0,52,0,-52
15453,1,1,808,1227,419
15454,1,0,8,0,-8
15455,1,1,444,1762,1318
15456,1,1,862,5276,4414
15457,1,1,363,2094,1731
15458,1,0,33,0,-33
15459,0,0,40,0,-40
15460,1,0,87,0,-87
15461,0,0,24,0,-24
15462,0,0,63,0,-63
15463,1,1,1310,1922,612
15464,1,0,34,0,-34
15465,1,0,51,0,-51
15466,0,0,40,0,-40
15467,0,0,22,0,-22
15468,1,1,1729,1450,-279
15469,1,0,2,0,-2
15470,1,1,179,1238,1059
15471,1,1,2259,1994,-265
15472,1,1,48,1725,1677
15473,0,0,19,0,-19
15474,1,1,1206,1600,394
15475,1,1,982,1778,796
15476,1,1,377,1655,1278
15477,1,0,3,0,-3
15478,0,0,29,0,-29
15479,1,1,281,1267,986
15480,1,1,43,1710,1667
15481,0,0,160,0,-160
15482,0,0,25,0,-25
15483,1,0,62,0,-62
15484,1,1,452,1734,1282
15485,0,0,39,0,-39
15486,1,1,1164,1935,771
15487,0,0,1,0,-1
15488,1,0,203,0,-203
15489,1,1,155,1538,1383
15490,1,0,133,0,-133
15491,0,0,16,0,-16
15492,0,0,69,0,-69
15493,1,1,1918,1340,-578
15494,0,0,139,0,-139
15495,1,0,144,0,-144
15496,1,1,154,1433,1279
15497,0,0,19,0,-19
15498,1,0,65,0,-65
15499,1,0,33,0,-33
15500,1,1,1016,1594,578
15501,0,0,47,0,-47
15502,1,1,1330,2572,1242
15503,0,0,69,0,-69
15504,1,1,172,1307,1135
15505,1,1,544,2675,2131
15506,0,0,75,0,-75
15507,1,1,807,1285,478
15508,0,0,8,0,-8
15509,1,0,56,0,-56
15510,1,0,28,0,-28
15511,1,1,1705,1301,-404
15512,1,1,2630,1711,-919
15513,0,0,80,0,-80
15514,0,0,42,0,-42
15515,1,1,344,1212,868
15516,0,0,7,0,-7
15517,0,0,261,0,-261
15518,1,1,243,1212,969
15519,1,1,2544,1428,-1116
15520,1,0,34,0,-34
15521,0,0,8,0,-8
15522,1,0,91,0,-91
15523,0,0,187,0,-187
15524,1,0,2,0,-2
15525,0,0,38,0,-38
15526,0,0,96,0,-96
15527,0,0,48,0,-48
15528,1,0,1,0,-1
15529,1,0,93,0,-93
15530,0,0,6,0,-6
15531,1,0,0,0,0
15532,1,1,316,1975,1659
15533,1,0,22,0,-22
15534,1,0,155,0,-155
15535,1,0,104,0,-104
15536,1,0,4,0,-4
15537,1,1,175,2096,1921
15538,0,0,9,0,-9
15539,1,0,58,0,-58
15540,1,1,193,1873,1680
15541,1,0,116,0,-116
15542,0,0,10,0,-10
15543,1,1,221,1663,1442
15544,0,0,24,0,-24
15545,1,1,41,1375,1334
15546,1,0,22,0,-22
15547,1,0,30,0,-30
15548,1,0,35,0,-35
15549,0,0,22,0,-22
15550,1,0,113,0,-113
15551,0,0,71,0,-71
15552,1,1,508,1544,1036
15553,1,1,383,1945,1562
15554,0,0,42,0,-42
15555,1,1,675,1717,1042
15556,0,0,72,0,-72
15557,1,1,277,1624,1347
15558,0,0,83,0,-83
15559,0,0,3,0,-3
15560,1,1,880,1202,322
15561,0,0,47,0,-47
15562,0,0,8,0,-8
15563,0,0,42,0,-42
15564,1,1,262,1715,1453
15565,0,0,11,0,-11
15566,0,0,13,0,-13
15567,0,0,36,0,-36
15568,1,1,110,1338,1228
15569,1,0,17,0,-17
15570,1,1,293,1234,941
15571,1,1,143,1626,1483
15572,1,1,1128,1486,358
15573,1,0,13,0,-13
15574,1,1,860,1224,364
15575,0,0,0,0,0
15576,1,0,9,0,-9
15577,1,1,55,1438,1383
15578,0,0,28,0,-28
15579,0,0,72,0,-72
15580,1,0,49,0,-49
15581,1,0,59,0,-59
15582,0,0,60,0,-60
15583,1,1,691,1314,623
15584,1,0,34,0,-34
15585,1,1,58,1370,1312
15586,1,0,56,0,-56
15587,1,0,18,0,-18
15588,1,0,4,0,-4
15589,0,0,32,0,-32
15590,1,0,61,0,-61
15591,0,0,29,0,-29
15592,1,0,93,0,-93
15593,1,0,103,0,-103
15594,0,0,19,0,-19
15595,0,0,45,0,-45
15596,1,1,638,2163,1525
15597,1,0,81,0,-81
15598,1,0,128,0,-128
15599,0,0,11,0,-11
15600,1,1,107,1462,1355
15601,0,0,1,0,-1
15602,1,0,42,0,-42
15603,1,1,819,2464,1645
15604,0,0,53,0,-53
15605,1,1,621,1282,661
15606,1,0,43,0,-43
15607,1,0,26,0,-26
15608,1,0,211,0,-211
15609,1,0,40,0,-40
15610,1,1,106,2641,2535
15611,1,0,68,0,-68
15612,0,0,56,0,-56
15613,0,0,138,0,-138
15614,0,0,57,0,-57
15615,1,1,863,1316,453
15616,1,0,14,0,-14
15617,0,0,65,0,-65
15618,1,1,330,1425,1095
15619,1,0,196,0,-196
15620,1,0,11,0,-11
15621,1,1,583,1275,692
15622,0,0,154,0,-154
15623,1,0,67,0,-67
15624,0,0,37,0,-37
15625,1,1,119,1700,1581
15626,0,0,5,0,-5
15627,0,0,15,0,-15
15628,0,0,5,0,-5
15629,1,1,287,1597,1310
15630,1,0,49,0,-49
15631,1,0,44,0,-44
15632,1,1,527,1378,851
15633,1,1,308,2081,1773
15634,0,0,73,0,-73
15635,1,1,207,2208,2001
15636,0,0,6,0,-6
15637,0,0,38,0,-38
15638,0,0,68,0,-68
15639,0,0,19,0,-19
15640,0,0,38,0,-38
15641,1,1,321,1703,1382
15642,0,0,51,0,-51
15643,0,0,45,0,-45
15644,1,0,49,0,-49
15645,0,0,30,0,-30
15646,1,0,20,0,-20
15647,1,1,678,1533,855
15648,1,1,143,1204,1061
15649,1,1,456,1549,1093
15650,1,0,11,0,-11
15651,0,0,27,0,-27
15652,1,0,21,0,-21
15653,0,0,97,0,-97
15654,1,0,65,0,-65
15655,1,0,36,0,-36
15656,1,0,117,0,-117
15657,1,1,347,1702,1355
15658,1,0,79,0,-79
15659,1,0,28,0,-28
15660,1,1,86,1262,1176
15661,1,0,48,0,-48
15662,1,0,30,0,-30
15663,0,0,12,0,-12
15664,1,1,222,1544,1322
15665,1,1,495,1431,936
15666,1,0,60,0,-60
15667,1,0,29,0,-29
15668,0,0,15,0,-15
15669,1,1,72,1329,1257
15670,1,1,61,1796,1735
15671,1,1,608,1307,699
15672,0,0,10,0,-10
15673,0,0,0,0,0
15674,0,0,167,0,-167
15675,0,0,78,0,-78
15676,1,1,325,1426,1101
15677,0,0,94,0,-94
15678,1,0,4,0,-4
15679,1,1,1658,1216,-442
15680,1,1,757,1677,920
15681,1,1,1010,1765,755
15682,1,0,32,0,-32
15683,1,1,442,1213,771
15684,1,1,302,1550,1248
15685,0,0,65,0,-65
15686,1,0,28,0,-28
15687,0,0,24,0,-24
15688,1,1,811,1417,606
15689,1,1,580,1238,658
15690,1,1,651,1805,1154
15691,0,0,41,0,-41
15692,0,0,56,0,-56
15693,0,0,12,0,-12
15694,1,1,153,2032,1879
15695,0,0,15,0,-15
15696,0,0,113,0,-113
15697,0,0,59,0,-59
15698,1,1,184,2942,2758
15699,1,0,100,0,-100
15700,1,1,1707,2362,655
15701,0,0,45,0,-45
15702,0,0,21,0,-21
15703,1,0,14,0,-14
15704,0,0,334,0,-334
15705,1,1,563,1234,671
15706,0,0,71,0,-71
15707,1,0,24,0,-24
15708,1,1,850,1244,394
15709,1,1,1077,1227,150
15710,1,0,40,0,-40
15711,1,0,103,0,-103
15712,1,0,18,0,-18
15713,1,0,22,0,-22
15714,1,0,24,0,-24
15715,1,1,1219,1234,15
15716,1,1,43,1214,1171
15717,1,1,571,1264,693
15718,1,1,914,1213,299
15719,0,0,9,0,-9
15720,1,0,44,0,-44
15721,0,0,17,0,-17
15722,1,0,36,0,-36
15723,1,0,16,0,-16
15724,1,0,59,0,-59
15725,0,0,31,0,-31
15726,1,1,50,1418,1368
15727,1,1,321,1364,1043
15728,0,0,27,0,-27
15729,1,1,579,1622,1043
15730,0,0,63,0,-63
15731,1,1,821,1801,980
15732,0,0,74,0,-74
15733,0,0,70,0,-70
15734,0,0,46,0,-46
15735,1,1,692,1406,714
15736,1,1,434,1596,1162
15737,0,0,38,0,-38
15738,1,1,111,1224,1113
15739,1,1,200,1287,1087
15740,1,0,45,0,-45
15741,1,1,110,1811,1701
15742,1,0,62,0,-62
15743,1,1,338,1471,1133
15744,1,0,62,0,-62
15745,0,0,44,0,-44
15746,1,0,33,0,-33
15747,1,0,29,0,-29
15748,0,0,15,0,-15
15749,1,0,36,0,-36
15750,1,1,338,1959,1621
15751,1,0,29,0,-29
15752,0,0,26,0,-26
15753,0,0,223,0,-223
15754,0,0,17,0,-17
15755,0,0,24,0,-24
15756,1,0,59,0,-59
15757,0,0,28,0,-28
15758,0,0,21,0,-21
15759,1,1,170,1290,1120
15760,0,0,5,0,-5
15761,1,0,29,0,-29
15762,1,0,29,0,-29
15763,1,1,893,1816,923
15764,1,1,27,1337,1310
15765,1,1,881,1511,630
15766,1,1,337,1393,1056
15767,1,0,8,0,-8
15768,1,1,123,1773,1650
15769,1,0,30,0,-30
15770,1,0,23,0,-23
15771,1,1,507,1202,695
15772,0,0,20,0,-20
15773,0,0,131,0,-131
15774,1,0,66,0,-66
15775,1,1,278,1781,1503
15776,1,0,28,0,-28
15777,1,0,202,0,-202
15778,1,1,230,1502,1272
15779,1,1,42,1970,1928
15780,0,0,12,0,-12
15781,1,0,3,0,-3
15782,0,0,3,0,-3
15783,1,0,32,0,-32
15784,1,1,419,2896,2477
15785,1,0,89,0,-89
15786,1,1,200,1515,1315
15787,1,1,1093,2386,1293
15788,0,0,53,0,-53
15789,1,0,95,0,-95
15790,1,0,135,0,-135
15791,1,0,64,0,-64
15792,0,0,17,0,-17
15793,1,0,11,0,-11
15794,1,1,215,2159,1944
15795,1,1,174,1321,1147
15796,1,1,120,1412,1292
15797,1,1,751,1236,485
15798,0,0,234,0,-234
15799,1,0,5,0,-5
15800,1,0,28,0,-28
15801,0,0,32,0,-32
15802,1,1,39,1490,1451
15803,1,1,296,1205,909
15804,0,0,22,0,-22
15805,1,0,4,0,-4
15806,1,0,28,0,-28
15807,0,0,8,0,-8
15808,0,0,3,0,-3
15809,1,0,122,0,-122
15810,1,0,1,0,-1
15811,1,0,128,0,-128
15812,0,0,61,0,-61
15813,0,0,79,0,-79
15814,0,0,3,0,-3
15815,1,0,4,0,-4
15816,0,0,42,0,-42
15817,1,1,781,1382,601
15818,0,0,5,0,-5
15819,0,0,98,0,-98
15820,1,1,133,1284,1151
15821,0,0,23,0,-23
15822,0,0,0,0,0
15823,0,0,46,0,-46
15824,1,0,84,0,-84
15825,1,0,79,0,-79
15826,0,0,79,0,-79
15827,0,0,25,0,-25
15828,0,0,36,0,-36
15829,1,1,112,1271,1159
15830,0,0,61,0,-61
15831,0,0,83,0,-83
15832,1,1,517,1231,714
15833,1,0,87,0,-87
15834,0,0,0,0,0
15835,1,1,1423,1202,-221
15836,0,0,10,0,-10
15837,1,1,142,1610,1468
15838,1,1,386,2810,2424
15839,1,1,895,1479,584
15840,1,1,157,1875,1718
15841,1,0,122,0,-122
15842,1,0,34,0,-34
15843,1,1,76,1235,1159
15844,1,1,880,1660,780
15845,1,0,17,0,-17
15846,0,0,28,0,-28
15847,1,1,606,1350,744
15848,1,1,1227,1827,600
15849,0,0,49,0,-49
15850,1,1,377,1422,1045
15851,1,1,74,1483,1409
15852,0,0,10,0,-10
15853,1,1,173,1633,1460
15854,0,0,14,0,-14
15855,1,1,908,1401,493
15856,0,0,62,0,-62
15857,0,0,12,0,-12
15858,0,0,22,0,-22
15859,1,0,102,0,-102
15860,0,0,11,0,-11
15861,0,0,50,0,-50
15862,0,0,49,0,-49
15863,1,1,640,1223,583
15864,1,0,12,0,-12
15865,1,1,728,1293,565
15866,1,1,170,1502,1332
15867,1,1,1313,1547,234
15868,1,1,1104,1335,231
15869,0,0,94,0,-94
15870,0,0,19,0,-19
15871,1,0,38,0,-38
15872,1,1,31,1404,1373
15873,0,0,3,0,-3
15874,1,1,370,1236,866
15875,1,0,0,0,0
15876,1,1,255,1314,1059
15877,1,1,71,1485,1414
15878,1,0,34,0,-34
15879,1,0,21,0,-21
15880,1,0,22,0,-22
15881,1,1,638,4960,4322
15882,1,1,1769,1295,-474
15883,1,1,1510,1426,-84
15884,1,1,735,1296,561
15885,0,0,20,0,-20
15886,1,0,133,0,-133
15887,0,0,102,0,-102
15888,1,1,78,1426,1348
15889,1,0,41,0,-41
15890,1,0,14,0,-14
15891,1,0,11,0,-11
15892,0,0,19,0,-19
15893,1,1,62,1320,1258
15894,0,0,11,0,-11
15895,1,0,30,0,-30
15896,1,1,55,1522,1467
15897,1,0,19,0,-19
15898,1,1,1225,1253,28
15899,1,0,25,0,-25
15900,0,0,2,0,-2
15901,1,0,29,0,-29
15902,0,0,13,0,-13
15903,1,0,25,0,-25
15904,1,0,78,0,-78
15905,1,0,273,0,-273
15906,1,1,894,1210,316
15907,0,0,30,0,-30
15908,1,1,1512,1880,368
15909,0,0,28,0,-28
15910,1,0,26,0,-26
15911,0,0,6,0,-6
15912,1,1,235,1246,1011
15913,1,0,132,0,-132
15914,1,0,19,0,-19
15915,0,0,0,0,0
15916,0,0,8,0,-8
15917,1,0,34,0,-34
15918,0,0,22,0,-22
15919,0,0,23,0,-23
15920,1,1,426,1324,898
15921,1,0,120,0,-120
15922,1,0,44,0,-44
15923,1,1,160,2470,2310
15924,1,1,479,1888,1409
15925,0,0,16,0,-16
15926,0,0,11,0,-11
15927,1,1,553,1350,797
15928,0,0,6,0,-6
15929,1,1,565,2634,2069
15930,1,0,170,0,-170
15931,0,0,71,0,-71
15932,0,0,135,0,-135
15933,1,1,2392,1527,-865
15934,1,1,821,1720,899
15935,0,0,61,0,-61
15936,1,1,295,1347,1052
15937,0,0,73,0,-73
15938,1,0,18,0,-18
15939,1,0,73,0,-73
15940,1,0,6,0,-6
15941,1,0,27,0,-27
15942,1,1,1266,1848,582
15943,0,0,110,0,-110
15944,0,0,44,0,-44
15945,0,0,7,0,-7
15946,1,0,2,0,-2
15947,1,0,29,0,-29
15948,0,0,159,0,-159
15949,1,0,137,0,-137
15950,1,1,241,1262,1021
15951,1,0,97,0,-97
15952,1,0,39,0,-39
15953,0,0,22,0,-22
15954,1,0,26,0,-26
15955,1,1,2327,2482,155
15956,1,0,29,0,-29
15957,1,0,2,0,-2
15958,1,0,53,0,-53
15959,0,0,16,0,-16
15960,1,1,100,1225,1125
15961,0,0,4,0,-4
15962,0,0,102,0,-102
15963,1,1,423,1261,838
15964,1,0,127,0,-127
15965,1,0,21,0,-21
15966,1,0,16,0,-16
15967,1,0,321,0,-321
15968,0,0,26,0,-26
15969,1,1,363,1202,839
15970,1,1,126,1289,1163
15971,1,0,9,0,-9
15972,0,0,95,0,-95
15973,0,0,4,0,-4
15974,0,0,41,0,-41
15975,1,1,573,1291,718
15976,1,1,615,1372,757
15977,0,0,23,0,-23
15978,1,1,1136,1694,558
15979,0,0,26,0,-26
15980,1,0,33,0,-33
15981,1,0,72,0,-72
15982,0,0,13,0,-13
15983,0,0,100,0,-100
15984,0,0,71,0,-71
15985,0,0,16,0,-16
15986,1,0,65,0,-65
15987,1,0,226,0,-226
15988,0,0,53,0,-53
15989,0,0,1,0,-1
15990,1,0,6,0,-6
15991,1,1,205,1311,1106
15992,0,0,5,0,-5
15993,1,0,20,0,-20
15994,0,0,37,0,-37
15995,0,0,41,0,-41
15996,0,0,4,0,-4
15997,1,0,111,0,-111
15998,0,0,10,0,-10
15999,1,0,133,0,-133
16000,1,0,9,0,-9
16001,0,0,63,0,-63
16002,1,1,1369,1248,-121
16003,1,1,2064,1874,-190
16004,1,1,69,1328,1259
16005,1,0,76,0,-76
16006,1,0,65,0,-65
16007,0,0,66,0,-66
16008,1,0,8,0,-8
16009,1,0,39,0,-39
16010,0,0,77,0,-77
16011,1,0,182,0,-182
16012,0,0,37,0,-37
16013,1,1,1312,1211,-101
16014,0,0,75,0,-75
16015,0,0,7,0,-7
16016,1,1,688,1724,1036
16017,0,0,21,0,-21
16018,1,1,209,3187,2978
16019,1,1,303,1259,956
16020,0,0,49,0,-49
16021,1,0,15,0,-15
16022,0,0,12,0,-12
16023,0,0,35,0,-35
16024,0,0,37,0,-37
16025,1,0,11,0,-11
16026,0,0,26,0,-26
16027,0,0,130,0,-130
16028,1,1,408,1216,808
16029,1,0,1,0,-1
16030,1,0,4,0,-4
16031,0,0,17,0,-17
16032,1,0,50,0,-50
16033,1,0,254,0,-254
16034,1,0,3,0,-3
16035,1,1,1001,1717,716
16036,0,0,42,0,-42
16037,0,0,3,0,-3
16038,1,0,29,0,-29
16039,1,1,878,1355,477
16040,1,1,1567,1324,-243
16041,1,1,121,1275,1154
16042,1,0,75,0,-75
16043,1,1,472,1232,760
16044,1,0,130,0,-130
16045,1,0,62,0,-62
16046,1,0,9,0,-9
16047,1,1,1205,3396,2191
16048,0,0,29,0,-29
16049,0,0,172,0,-172
16050,1,1,1307,1252,-55
16051,1,0,107,0,-107
16052,1,1,144,1475,1331
16053,1,0,31,0,-31
16054,1,0,71,0,-71
16055,0,0,73,0,-73
16056,1,0,3,0,-3
16057,1,0,67,0,-67
16058,0,0,51,0,-51
16059,0,0,171,0,-171
16060,0,0,29,0,-29
16061,0,0,123,0,-123
16062,1,1,215,1491,1276
16063,1,0,58,0,-58
16064,0,0,25,0,-25
16065,0,0,29,0,-29
16066,0,0,0,0,0
16067,1,0,35,0,-35
16068,0,0,37,0,-37
16069,1,1,239,1400,1161
16070,0,0,73,0,-73
16071,1,1,768,1951,1183
16072,0,0,6,0,-6
16073,1,0,6,0,-6
16074,0,0,14,0,-14
16075,1,0,17,0,-17
16076,1,1,1321,1255,-66
16077,1,1,439,1592,1153
16078,1,1,464,1306,842
16079,0,0,100,0,-100
16080,1,1,241,1323,1082
16081,0,0,56,0,-56
16082,0,0,42,0,-42
16083,0,0,29,0,-29
16084,0,0,51,0,-51
16085,0,0,15,0,-15
16086,0,0,22,0,-22
16087,0,0,32,0,-32
16088,0,0,2,0,-2
16089,0,0,0,0,0
16090,1,1,220,1483,1263
16091,0,0,120,0,-120
16092,0,0,21,0,-21
16093,0,0,57,0,-57
16094,1,1,1282,2433,1151
16095,1,0,41,0,-41
16096,0,0,182,0,-182
16097,0,0,42,0,-42
16098,1,1,826,1644,818
16099,1,0,48,0,-48
16100,1,0,36,0,-36
16101,1,1,201,1231,1030
16102,1,1,637,1433,796
16103,0,0,4,0,-4
16104,1,1,67,2206,2139
16105,1,0,0,0,0
16106,1,0,37,0,-37
16107,0,0,70,0,-70
16108,1,0,89,0,-89
16109,0,0,44,0,-44
16110,1,1,589,1693,1104
16111,1,1,1670,1439,-231
16112,0,0,24,0,-24
16113,0,0,0,0,0
16114,1,0,12,0,-12
16115,1,0,11,0,-11
16116,0,0,198,0,-198
16117,1,0,17,0,-17
16118,1,0,49,0,-49
16119,1,0,60,0,-60
16120,1,1,1300,1942,642
16121,1,0,69,0,-69
16122,1,0,29,0,-29
16123,1,1,629,1840,1211
16124,1,0,52,0,-52
16125,0,0,9,0,-9
16126,0,0,6,0,-6
16127,1,0,28,0,-28
16128,1,0,31,0,-31
16129,0,0,27,0,-27
16130,1,0,31,0,-31
16131,1,0,17,0,-17
16132,1,1,12,1473,1461
16133,1,1,303,1337,1034
16134,1,1,295,1451,1156
16135,1,0,10,0,-10
16136,0,0,57,0,-57
16137,1,0,4,0,-4
16138,0,0,36,0,-36
16139,0,0,2,0,-2
16140,1,0,73,0,-73
16141,0,0,16,0,-16
16142,1,0,76,0,-76
16143,0,0,20,0,-20
16144,1,1,253,1381,1128
16145,0,0,1,0,-1
16146,1,1,117,1200,1083
16147,1,1,162,1824,1662
16148,0,0,30,0,-30
16149,0,0,111,0,-111
16150,1,0,32,0,-32
16151,0,0,99,0,-99
16152,1,0,53,0,-53
16153,0,0,32,0,-32
16154,0,0,54,0,-54
16155,1,1,401,1327,926
16156,0,0,70,0,-70
16157,1,1,607,1698,1091
16158,1,0,4,0,-4
16159,1,0,25,0,-25
16160,0,0,58,0,-58
16161,0,0,29,0,-29
16162,1,0,235,0,-235
16163,0,0,32,0,-32
16164,0,0,26,0,-26
16165,1,1,178,1424,1246
16166,0,0,56,0,-56
16167,1,1,358,1682,1324
16168,1,0,175,0,-175
16169,0,0,23,0,-23
16170,1,1,1619,2540,921
16171,1,1,141,1773,1632
16172,1,1,408,2988,2580
16173,1,1,157,2375,2218
16174,1,0,14,0,-14
16175,0,0,45,0,-45
16176,0,0,29,0,-29
16177,1,0,29,0,-29
16178,1,1,96,1760,1664
16179,0,0,77,0,-77
16180,0,0,43,0,-43
16181,0,0,101,0,-101
16182,0,0,49,0,-49
16183,0,0,9,0,-9
16184,1,1,413,1257,844
16185,1,0,6,0,-6
16186,1,0,81,0,-81
16187,1,0,11,0,-11
16188,1,1,339,2053,1714
16189,0,0,0,0,0
16190,1,1,436,2269,1833
16191,1,0,30,0,-30
16192,0,0,14,0,-14
16193,1,0,92,0,-92
16194,0,0,1,0,-1
16195,1,0,21,0,-21
16196,1,1,2447,1223,-1224
16197,1,0,16,0,-16
16198,0,0,3,0,-3
16199,1,0,88,0,-88
16200,1,1,789,1910,1121
16201,0,0,2,0,-2
16202,1,1,92,1283,1191
16203,0,0,17,0,-17
16204,1,0,64,0,-64
16205,0,0,32,0,-32
16206,1,1,123,1314,1191
16207,0,0,75,0,-75
16208,0,0,61,0,-61
16209,1,0,28,0,-28
16210,1,1,135,1615,1480
16211,1,0,103,0,-103
16212,1,1,60,1319,1259
16213,1,1,78,1307,1229
16214,1,0,43,0,-43
16215,1,1,232,1324,1092
16216,0,0,25,0,-25
16217,1,1,1210,1416,206
16218,1,1,311,2503,2192
16219,0,0,80,0,-80
16220,1,0,1,0,-1
16221,0,0,159,0,-159
16222,1,1,32,3149,3117
16223,1,1,348,1991,1643
16224,1,1,208,1727,1519
16225,0,0,131,0,-131
16226,0,0,280,0,-280
16227,1,1,378,1551,1173
16228,1,0,49,0,-49
16229,0,0,136,0,-136
16230,1,0,3,0,-3
16231,0,0,5,0,-5
16232,1,1,125,1892,1767
16233,0,0,10,0,-10
16234,1,1,570,1300,730
16235,1,1,306,2269,1963
16236,1,1,1625,2221,596
16237,0,0,26,0,-26
16238,1,0,71,0,-71
16239,0,0,17,0,-17
16240,0,0,25,0,-25
16241,1,0,43,0,-43
16242,0,0,206,0,-206
16243,1,1,251,1642,1391
16244,1,0,28,0,-28
16245,1,1,925,1836,911
16246,0,0,92,0,-92
16247,1,1,1500,1341,-159
16248,0,0,26,0,-26
16249,0,0,143,0,-143
16250,1,1,287,1547,1260
16251,0,0,14,0,-14
16252,1,1,768,1732,964
16253,1,1,806,1317,511
16254,1,1,74,1401,1327
16255,0,0,15,0,-15
16256,1,1,311,1474,1163
16257,1,1,727,1594,867
16258,0,0,17,0,-17
16259,1,0,161,0,-161
16260,0,0,24,0,-24
16261,0,0,40,0,-40
16262,1,0,19,0,-19
16263,0,0,97,0,-97
16264,1,1,102,1250,1148
16265,0,0,41,0,-41
16266,0,0,74,0,-74
16267,1,0,14,0,-14
16268,0,0,25,0,-25
16269,1,0,33,0,-33
16270,1,1,569,1317,748
16271,0,0,2,0,-2
16272,0,0,36,0,-36
16273,1,0,27,0,-27
16274,0,0,31,0,-31
16275,0,0,0,0,0
16276,0,0,43,0,-43
16277,0,0,29,0,-29
16278,1,0,9,0,-9
16279,1,1,672,2037,1365
16280,1,0,52,0,-52
16281,1,1,2452,2086,-366
16282,1,1,1796,1720,-76
16283,0,0,32,0,-32
16284,0,0,108,0,-108
16285,1,1,981,1491,510
16286,0,0,83,0,-83
16287,0,0,6,0,-6
16288,0,0,22,0,-22
16289,0,0,5,0,-5
16290,1,1,852,2712,1860
16291,0,0,62,0,-62
16292,0,0,42,0,-42
16293,1,0,54,0,-54
16294,0,0,26,0,-26
16295,1,1,270,1320,1050
16296,0,0,22,0,-22
16297,0,0,69,0,-69
16298,0,0,70,0,-70
16299,1,0,48,0,-48
16300,1,0,118,0,-118
16301,0,0,30,0,-30
16302,0,0,215,0,-215
16303,0,0,61,0,-61
16304,0,0,30,0,-30
16305,0,0,81,0,-81
16306,1,0,109,0,-109
16307,0,0,1,0,-1
16308,1,1,84,1281,1197
16309,0,0,88,0,-88
16310,0,0,40,0,-40
16311,0,0,112,0,-112
16312,1,1,705,1270,565
16313,0,0,13,0,-13
16314,1,1,735,1549,814
16315,0,0,61,0,-61
16316,1,1,67,1915,1848
16317,1,0,3,0,-3
16318,1,1,142,1453,1311
16319,0,0,42,0,-42
16320,0,0,90,0,-90
16321,1,1,255,1441,1186
16322,1,1,104,1292,1188
16323,0,0,83,0,-83
16324,1,1,1097,1240,143
16325,1,1,486,1266,780
16326,1,0,61,0,-61
16327,1,1,28,1270,1242
16328,1,0,90,0,-90
16329,1,0,42,0,-42
16330,0,0,2,0,-2
16331,1,1,534,1225,691
16332,0,0,58,0,-58
16333,0,0,34,0,-34
16334,1,1,1535,1389,-146
16335,0,0,65,0,-65
16336,0,0,29,0,-29
16337,0,0,99,0,-99
16338,1,1,732,1459,727
16339,0,0,27,0,-27
16340,0,0,178,0,-178
16341,1,0,3,0,-3
16342,0,0,31,0,-31
16343,0,0,41,0,-41
16344,1,1,68,1380,1312
16345,0,0,1,0,-1
16346,0,0,52,0,-52
16347,0,0,7,0,-7
16348,0,0,20,0,-20
16349,1,1,249,1200,951
16350,1,1,596,1375,779
16351,0,0,83,0,-83
16352,1,0,30,0,-30
16353,0,0,11,0,-11
16354,0,0,55,0,-55
16355,0,0,21,0,-21
16356,0,0,41,0,-41
16357,0,0,180,0,-180
16358,1,0,23,0,-23
16359,0,0,84,0,-84
16360,1,1,345,1457,1112
16361,0,0,39,0,-39
16362,1,0,34,0,-34
16363,0,0,3,0,-3
16364,0,0,72,0,-72
16365,1,1,559,1236,677
16366,1,1,1113,1577,464
16367,0,0,54,0,-54
16368,0,0,74,0,-74
16369,0,0,29,0,-29
16370,0,0,110,0,-110
16371,0,0,51,0,-51
16372,1,1,237,1215,978
16373,1,1,277,1703,1426
16374,1,0,38,0,-38
16375,1,1,138,1285,1147
16376,0,0,115,0,-115
16377,1,0,25,0,-25
16378,0,0,68,0,-68
16379,1,0,13,0,-13
16380,1,1,188,1735,1547
16381,0,0,109,0,-109
16382,1,1,1611,1269,-342
16383,0,0,159,0,-159
16384,1,1,51,1228,1177
16385,0,0,11,0,-11
16386,0,0,51,0,-51
16387,0,0,43,0,-43
16388,1,0,86,0,-86
16389,1,1,66,1263,1197
16390,1,1,306,1306,1000
16391,0,0,4,0,-4
16392,1,0,87,0,-87
16393,0,0,102,0,-102
16394,1,1,190,1291,1101
16395,1,1,1027,1342,315
16396,1,0,24,0,-24
16397,1,0,122,0,-122
16398,1,0,4,0,-4
16399,1,1,1024,1703,679
16400,0,0,343,0,-343
16401,1,1,199,1429,1230
16402,1,1,248,1768,1520
16403,1,0,25,0,-25
16404,0,0,35,0,-35
16405,1,0,19,0,-19
16406,1,1,295,1622,1327
16407,1,1,265,1427,1162
16408,0,0,24,0,-24
16409,1,1,829,2059,1230
16410,1,1,1284,1276,-8
16411,1,0,10,0,-10
16412,1,0,42,0,-42
16413,0,0,38,0,-38
16414,1,0,9,0,-9
16415,1,0,29,0,-29
16416,0,0,82,0,-82
16417,1,0,13,0,-13
16418,0,0,51,0,-51
16419,1,1,33,1807,1774
16420,1,1,951,1291,340
16421,0,0,80,0,-80
16422,0,0,112,0,-112
16423,0,0,2,0,-2
16424,0,0,40,0,-40
16425,1,0,4,0,-4
16426,0,0,21,0,-21
16427,1,0,41,0,-41
16428,0,0,32,0,-32
16429,0,0,55,0,-55
16430,1,0,21,0,-21
16431,1,0,42,0,-42
16432,0,0,61,0,-61
16433,1,0,161,0,-161
16434,1,1,872,1614,742
16435,1,0,42,0,-42
16436,1,0,3,0,-3
16437,0,0,9,0,-9
16438,1,0,11,0,-11
16439,1,0,19,0,-19
16440,0,0,38,0,-38
16441,0,0,18,0,-18
16442,1,0,38,0,-38
16443,0,0,38,0,-38
16444,1,0,56,0,-56
16445,1,0,37,0,-37
16446,0,0,18,0,-18
16447,1,0,94,0,-94
16448,1,0,13,0,-13
16449,1,1,453,1591,1138
16450,1,0,38,0,-38
16451,1,1,286,1240,954
16452,1,0,16,0,-16
16453,0,0,103,0,-103
16454,0,0,18,0,-18
16455,0,0,10,0,-10
16456,1,1,2732,1415,-1317
16457,1,1,1158,1709,551
16458,1,1,1161,1381,220
16459,0,0,14,0,-14
16460,1,0,46,0,-46
16461,0,0,92,0,-92
16462,1,1,425,1227,802
16463,0,0,176,0,-176
16464,0,0,68,0,-68
16465,1,1,560,3684,3124
16466,1,0,7,0,-7
16467,0,0,7,0,-7
16468,1,1,1058,1210,152
16469,0,0,30,0,-30
16470,1,1,354,1315,961
16471,0,0,73,0,-73
16472,1,0,53,0,-53
16473,1,1,667,1289,622
16474,0,0,72,0,-72
16475,1,0,27,0,-27
16476,1,1,828,1248,420
16477,0,0,47,0,-47
16478,1,1,1050,1351,301
16479,1,1,175,1927,1752
16480,0,0,23,0,-23
16481,0,0,5,0,-5
16482,1,1,986,3792,2806
16483,1,0,15,0,-15
16484,0,0,18,0,-18
16485,0,0,79,0,-79
16486,0,0,58,0,-58
16487,0,0,55,0,-55
16488,1,0,25,0,-25
16489,0,0,58,0,-58
16490,0,0,45,0,-45
16491,1,1,690,1631,941
16492,1,1,978,1673,695
16493,1,0,31,0,-31
16494,0,0,78,0,-78
16495,0,0,79,0,-79
16496,1,0,34,0,-34
16497,1,1,761,1378,617
16498,1,0,18,0,-18
16499,1,1,816,1455,639
16500,0,0,11,0,-11
16501,1,1,420,1946,1526
16502,1,0,15,0,-15
16503,0,0,115,0,-115
16504,1,0,86,0,-86
16505,1,0,62,0,-62
16506,0,0,36,0,-36
16507,1,0,21,0,-21
16508,1,1,341,1250,909
16509,0,0,4,0,-4
16510,1,0,21,0,-21
16511,0,0,5,0,-5
16512,0,0,106,0,-106
16513,1,0,37,0,-37
16514,0,0,152,0,-152
16515,0,0,2,0,-2
16516,1,1,129,2001,1872
16517,0,0,0,0,0
16518,1,0,139,0,-139
16519,1,0,32,0,-32
16520,0,0,32,0,-32
16521,1,1,1262,1664,402
16522,0,0,48,0,-48
16523,0,0,57,0,-57
16524,1,1,25,1420,1395
16525,0,0,45,0,-45
16526,1,0,5,0,-5
16527,1,1,13,1502,1489
16528,0,0,63,0,-63
16529,1,0,44,0,-44
16530,1,1,491,1249,758
16531,1,1,607,1490,883
16532,0,0,65,0,-65
16533,1,0,125,0,-125
16534,1,0,67,0,-67
16535,1,1,1056,1439,383
16536,1,1,172,1260,1088
16537,0,0,1,0,-1
16538,1,1,1089,1533,444
16539,1,1,1519,1369,-150
16540,1,0,11,0,-11
16541,1,1,592,1257,665
16542,0,0,100,0,-100
16543,1,0,27,0,-27
16544,1,0,39,0,-39
16545,1,0,48,0,-48
16546,0,0,0,0,0
16547,0,0,73,0,-73
16548,0,0,59,0,-59
16549,1,1,143,1592,1449
16550,1,1,531,1335,804
16551,0,0,84,0,-84
16552,1,0,21,0,-21
16553,1,0,32,0,-32
16554,1,1,1374,1335,-39
16555,0,0,40,0,-40
16556,1,1,983,1263,280
16557,0,0,30,0,-30
16558,0,0,40,0,-40
16559,1,1,257,1323,1066
16560,1,1,872,2326,1454
16561,1,0,95,0,-95
16562,1,0,31,0,-31
16563,1,0,58,0,-58
16564,1,0,12,0,-12
16565,0,0,2,0,-2
16566,1,0,85,0,-85
16567,0,0,45,0,-45
16568,1,1,796,1691,895
16569,0,0,46,0,-46
16570,1,0,64,0,-64
16571,1,0,63,0,-63
16572,1,0,58,0,-58
16573,1,0,55,0,-55
16574,1,1,1016,1974,958
16575,1,1,143,1973,1830
16576,1,1,188,1690,1502
16577,0,0,82,0,-82
16578,0,0,11,0,-11
16579,1,1,497,1331,834
16580,1,1,722,1719,997
16581,0,0,34,0,-34
16582,1,1,134,2007,1873
16583,1,1,1241,2144,903
16584,0,0,65,0,-65
16585,1,0,3,0,-3
16586,1,1,1450,2165,715
16587,1,0,47,0,-47
16588,1,0,8,0,-8
16589,0,0,97,0,-97
16590,1,1,94,1660,1566
16591,0,0,115,0,-115
16592,1,0,97,0,-97
16593,0,0,21,0,-21
16594,1,1,170,1321,1151
16595,1,1,50,1662,1612
16596,0,0,7,0,-7
16597,0,0,193,0,-193
16598,0,0,85,0,-85
16599,0,0,31,0,-31
16600,1,0,98,0,-98
16601,1,0,39,0,-39
16602,0,0,89,0,-89
16603,0,0,11,0,-11
16604,0,0,61,0,-61
16605,1,1,65,1434,1369
16606,1,1,331,2687,2356
16607,1,0,1,0,-1
16608,1,0,14,0,-14
16609,0,0,229,0,-229
16610,1,1,765,1280,515
16611,0,0,35,0,-35
16612,1,0,43,0,-43
16613,1,0,150,0,-150
16614,1,0,37,0,-37
16615,1,0,94,0,-94
16616,0,0,90,0,-90
16617,0,0,43,0,-43
16618,1,0,121,0,-121
16619,1,1,343,2151,1808
16620,1,0,97,0,-97
16621,0,0,20,0,-20
16622,1,0,2,0,-2
16623,1,0,3,0,-3
16624,1,0,184,0,-184
16625,1,0,10,0,-10
16626,0,0,47,0,-47
16627,0,0,95,0,-95
16628,0,0,63,0,-63
16629,0,0,66,0,-66
16630,1,0,23,0,-23
16631,1,1,356,2243,1887
16632,0,0,17,0,-17
16633,1,0,64,0,-64
16634,1,0,59,0,-59
16635,1,0,63,0,-63
16636,1,1,1119,1576,457
16637,0,0,37,0,-37
16638,1,1,657,1493,836
16639,0,0,18,0,-18
16640,1,0,47,0,-47
16641,0,0,21,0,-21
16642,0,0,28,0,-28
16643,1,1,129,1527,1398
16644,0,0,71,0,-71
16645,0,0,37,0,-37
16646,1,1,351,3253,2902
16647,0,0,158,0,-158
16648,0,0,5,0,-5
16649,1,1,847,1803,956
16650,1,1,380,1212,832
16651,0,0,56,0,-56
16652,1,0,59,0,-59
16653,1,0,71,0,-71
16654,1,0,7,0,-7
16655,0,0,9,0,-9
16656,0,0,104,0,-104
16657,0,0,80,0,-80
16658,1,0,102,0,-102
16659,0,0,5,0,-5
16660,0,0,187,0,-187
16661,0,0,14,0,-14
16662,0,0,128,0,-128
16663,1,1,46,1233,1187
16664,1,1,263,1266,1003
16665,1,0,99,0,-99
16666,0,0,53,0,-53
16667,1,0,14,0,-14
16668,1,0,161,0,-161
16669,1,1,1082,1445,363
16670,1,0,97,0,-97
16671,0,0,96,0,-96
16672,1,1,292,2271,1979
16673,1,0,45,0,-45
16674,1,1,588,1329,741
16675,0,0,6,0,-6
16676,0,0,107,0,-107
16677,0,0,2,0,-2
16678,0,0,61,0,-61
16679,1,1,390,1232,842
16680,1,1,647,1513,866
16681,1,1,653,1397,744
16682,1,1,1200,1455,255
16683,1,0,27,0,-27
16684,0,0,79,0,-79
16685,1,0,9,0,-9
16686,1,0,9,0,-9
16687,1,0,1,0,-1
16688,0,0,9,0,-9
16689,0,0,0,0,0
16690,0,0,28,0,-28
16691,0,0,32,0,-32
16692,0,0,61,0,-61
16693,1,0,38,0,-38
16694,1,1,63,1216,1153
16695,1,1,159,1221,1062
16696,0,0,77,0,-77
16697,1,1,210,1269,1059
16698,1,0,29,0,-29
16699,1,1,574,1219,645
16700,1,0,34,0,-34
16701,0,0,4,0,-4
16702,1,0,100,0,-100
16703,1,0,5,0,-5
16704,1,0,80,0,-80
16705,1,1,562,1485,923
16706,0,0,70,0,-70
16707,1,0,26,0,-26
16708,0,0,55,0,-55
16709,0,0,2,0,-2
16710,0,0,1,0,-1
16711,1,1,356,1438,1082
16712,0,0,88,0,-88
16713,1,0,53,0,-53
16714,1,0,47,0,-47
16715,1,0,57,0,-57
16716,0,0,16,0,-16
16717,0,0,16,0,-16
16718,0,0,20,0,-20
16719,1,1,44,1265,1221
16720,1,1,266,1302,1036
16721,1,0,13,0,-13
16722,1,1,169,1275,1106
16723,1,0,179,0,-179
16724,1,1,492,1380,888
16725,1,1,1769,2155,386
16726,1,0,51,0,-51
16727,1,1,809,1486,677
16728,1,1,353,3481,3128
16729,1,1,719,1347,628
16730,1,1,426,1256,830
16731,0,0,39,0,-39
16732,1,1,786,1385,599
16733,0,0,76,0,-76
16734,1,1,105,1266,1161
16735,1,1,1664,2015,351
16736,0,0,86,0,-86
16737,0,0,18,0,-18
16738,1,0,15,0,-15
16739,0,0,38,0,-38
16740,0,0,34,0,-34
16741,1,1,444,1634,1190
16742,1,0,139,0,-139
16743,1,1,260,1611,1351
16744,1,1,911,1478,567
16745,1,1,522,1460,938
16746,0,0,12,0,-12
16747,1,0,123,0,-123
16748,0,0,48,0,-48
16749,1,1,631,1418,787
16750,1,1,1103,1693,590
16751,0,0,5,0,-5
16752,1,0,96,0,-96
16753,1,0,58,0,-58
16754,1,1,415,1562,1147
16755,0,0,16,0,-16
16756,1,0,16,0,-16
16757,1,0,15,0,-15
16758,0,0,63,0,-63
16759,0,0,7,0,-7
16760,1,0,139,0,-139
16761,1,0,10,0,-10
16762,0,0,8,0,-8
16763,0,0,37,0,-37
16764,0,0,56,0,-56
16765,1,1,1177,1246,69
16766,1,1,561,1337,776
16767,0,0,112,0,-112
16768,0,0,4,0,-4
16769,1,0,120,0,-120
16770,1,1,205,1251,1046
16771,1,1,1009,1350,341
16772,0,0,46,0,-46
16773,1,1,1076,1347,271
16774,0,0,101,0,-101
16775,1,0,16,0,-16
16776,1,0,76,0,-76
16777,1,0,17,0,-17
16778,1,1,77,2231,2154
16779,0,0,19,0,-19
16780,1,0,38,0,-38
16781,0,0,1,0,-1
16782,0,0,18,0,-18
16783,0,0,10,0,-10
16784,1,1,94,1287,1193
16785,1,1,159,1253,1094
16786,1,0,63,0,-63
16787,1,1,39,1255,1216
16788,1,1,202,1301,1099
16789,1,0,16,0,-16
16790,0,0,18,0,-18
16791,1,0,8,0,-8
16792,0,0,8,0,-8
16793,1,0,39,0,-39
16794,1,0,63,0,-63
16795,1,0,49,0,-49
16796,1,0,38,0,-38
16797,1,1,572,2275,1703
16798,1,0,45,0,-45
16799,0,0,31,0,-31
16800,0,0,48,0,-48
16801,1,1,959,1955,996
16802,0,0,38,0,-38
16803,1,1,1317,1479,162
16804,1,1,402,1740,1338
16805,0,0,68,0,-68
16806,1,0,199,0,-199
16807,0,0,51,0,-51
16808,0,0,28,0,-28
16809,1,0,13,0,-13
16810,1,0,10,0,-10
16811,1,0,212,0,-212
16812,0,0,22,0,-22
16813,1,0,9,0,-9
16814,1,1,343,2314,1971
16815,0,0,25,0,-25
16816,1,1,1003,1340,337
16817,0,0,13,0,-13
16818,1,0,40,0,-40
16819,1,1,47,2343,2296
16820,0,0,36,0,-36
16821,1,1,362,2050,1688
16822,0,0,23,0,-23
16823,1,1,293,2211,1918
16824,1,1,839,1279,440
16825,1,1,210,1303,1093
16826,0,0,4,0,-4
16827,1,0,3,0,-3
16828,1,1,1491,1211,-280
16829,1,0,4,0,-4
16830,1,1,178,1273,1095
16831,0,0,17,0,-17
16832,0,0,13,0,-13
16833,0,0,18,0,-18
16834,1,1,677,2099,1422
16835,1,0,2,0,-2
16836,1,1,56,1281,1225
16837,0,0,40,0,-40
16838,1,0,10,0,-10
16839,1,1,178,1865,1687
16840,0,0,19,0,-19
16841,1,0,35,0,-35
16842,1,1,747,1350,603
16843,1,1,590,1330,740
16844,1,0,143,0,-143
16845,1,1,266,1466,1200
16846,1,0,26,0,-26
16847,1,0,57,0,-57
16848,0,0,36,0,-36
16849,0,0,70,0,-70
16850,1,1,864,1220,356
16851,0,0,0,0,0
16852,0,0,46,0,-46
16853,0,0,21,0,-21
16854,1,0,23,0,-23
16855,1,1,707,2008,1301
16856,1,1,885,3185,2300
16857,1,1,655,1546,891
16858,1,0,6,0,-6
16859,1,1,204,1617,1413
16860,1,1,1000,2510,1510
16861,0,0,0,0,0
16862,1,1,335,1360,1025
16863,1,1,1100,1283,183
16864,0,0,5,0,-5
16865,1,1,183,1407,1224
16866,1,0,98,0,-98
16867,1,0,81,0,-81
16868,1,0,70,0,-70
16869,1,0,106,0,-106
16870,1,1,76,1273,1197
16871,0,0,4,0,-4
16872,1,0,34,0,-34
16873,1,1,374,1291,917
16874,1,1,894,1914,1020
16875,0,0,6,0,-6
16876,0,0,6,0,-6
16877,1,0,156,0,-156
16878,1,1,1003,1405,402
16879,0,0,83,0,-83
16880,0,0,36,0,-36
16881,1,1,115,1409,1294
16882,1,1,1087,1603,516
16883,1,1,423,1338,915
16884,1,1,247,2834,2587
16885,0,0,11,0,-11
16886,0,0,10,0,-10
16887,1,1,744,1991,1247
16888,0,0,31,0,-31
16889,1,1,566,1316,750
16890,1,0,13,0,-13
16891,1,1,403,2878,2475
16892,1,1,256,1324,1068
16893,0,0,86,0,-86
16894,0,0,24,0,-24
16895,1,0,56,0,-56
16896,0,0,55,0,-55
16897,1,1,190,1577,1387
16898,0,0,76,0,-76
16899,0,0,5,0,-5
16900,0,0,15,0,-15
16901,1,0,6,0,-6
16902,1,1,378,1294,916
16903,1,1,784,1507,723
16904,1,1,373,1260,887
16905,1,0,81,0,-81
16906,1,0,58,0,-58
16907,1,0,0,0,0
16908,0,0,148,0,-148
16909,1,0,89,0,-89
16910,0,0,4,0,-4
16911,1,0,46,0,-46
16912,1,1,30,1358,1328
16913,0,0,45,0,-45
16914,1,1,162,1322,1160
16915,0,0,18,0,-18
16916,1,1,320,1416,1096
16917,0,0,13,0,-13
16918,0,0,1,0,-1
16919,1,0,88,0,-88
16920,0,0,57,0,-57
16921,0,0,17,0,-17
16922,0,0,15,0,-15
16923,1,0,5,0,-5
16924,1,1,563,1219,656
16925,1,1,426,1278,852
16926,1,0,50,0,-50
16927,1,0,64,0,-64
16928,0,0,8,0,-8
16929,1,1,1067,1625,558
16930,0,0,17,0,-17
16931,1,0,13,0,-13
16932,1,1,511,1351,840
16933,0,0,7,0,-7
16934,0,0,133,0,-133
16935,0,0,7,0,-7
16936,1,1,380,1588,1208
16937,1,0,65,0,-65
16938,0,0,109,0,-109
16939,0,0,15,0,-15
16940,0,0,27,0,-27
16941,1,0,0,0,0
16942,0,0,40,0,-40
16943,1,0,49,0,-49
16944,0,0,34,0,-34
16945,1,0,158,0,-158
16946,1,0,14,0,-14
16947,1,0,42,0,-42
16948,0,0,172,0,-172
16949,0,0,16,0,-16
16950,0,0,0,0,0
16951,1,0,36,0,-36
16952,1,0,102,0,-102
16953,1,0,4,0,-4
16954,1,1,596,1205,609
16955,1,0,38,0,-38
16956,1,0,32,0,-32
16957,1,0,114,0,-114
16958,0,0,13,0,-13
16959,0,0,54,0,-54
16960,0,0,45,0,-45
16961,1,1,406,1357,951
16962,0,0,37,0,-37
16963,1,1,632,1410,778
16964,1,1,943,1215,272
16965,1,1,448,1306,858
16966,0,0,49,0,-49
16967,1,1,1032,1353,321
16968,1,1,739,1585,846
16969,1,0,83,0,-83
16970,0,0,234,0,-234
16971,0,0,12,0,-12
16972,1,0,47,0,-47
16973,1,1,2473,1251,-1222
16974,0,0,189,0,-189
16975,1,0,82,0,-82
16976,1,1,55,1427,1372
16977,0,0,50,0,-50
16978,1,1,1014,1871,857
16979,1,0,99,0,-99
16980,0,0,174,0,-174
16981,1,1,104,1240,1136
16982,1,1,692,1339,647
16983,1,1,275,1388,1113
16984,0,0,7,0,-7
16985,1,1,983,1235,252
16986,0,0,6,0,-6
16987,1,0,74,0,-74
16988,1,0,13,0,-13
16989,1,0,141,0,-141
16990,0,0,37,0,-37
16991,1,1,225,2041,1816
16992,1,1,1026,1473,447
16993,0,0,39,0,-39
16994,1,0,46,0,-46
16995,0,0,97,0,-97
16996,0,0,108,0,-108
16997,0,0,122,0,-122
16998,0,0,4,0,-4
16999,0,0,53,0,-53
17000,0,0,75,0,-75
17001,0,0,20,0,-20
17002,0,0,73,0,-73
17003,0,0,43,0,-43
17004,1,0,263,0,-263
17005,0,0,125,0,-125
17006,1,1,474,1221,747
17007,1,0,0,0,0
17008,0,0,22,0,-22
17009,1,0,24,0,-24
17010,1,0,21,0,-21
17011,0,0,31,0,-31
17012,1,0,20,0,-20
17013,1,0,81,0,-81
17014,1,0,231,0,-231
17015,1,1,240,1899,1659
17016,1,0,22,0,-22
17017,0,0,68,0,-68
17018,0,0,126,0,-126
17019,0,0,13,0,-13
17020,1,0,3,0,-3
17021,0,0,146,0,-146
17022,1,1,774,1623,849
17023,0,0,29,0,-29
17024,1,1,756,1747,991
17025,1,1,548,1272,724
17026,1,0,27,0,-27
17027,1,1,839,1318,479
17028,0,0,134,0,-134
17029,0,0,46,0,-46
17030,1,0,29,0,-29
17031,1,1,655,1353,698
17032,0,0,38,0,-38
17033,1,0,10,0,-10
17034,0,0,2,0,-2
17035,0,0,43,0,-43
17036,0,0,5,0,-5
17037,0,0,46,0,-46
17038,0,0,91,0,-91
17039,1,1,1316,1557,241
17040,1,0,19,0,-19
17041,0,0,53,0,-53
17042,0,0,151,0,-151
17043,0,0,6,0,-6
17044,1,0,272,0,-272
17045,1,0,29,0,-29
17046,1,0,5,0,-5
17047,1,1,711,1262,551
17048,1,0,20,0,-20
17049,1,1,1189,1446,257
17050,1,1,321,1226,905
17051,0,0,19,0,-19
17052,1,0,28,0,-28
17053,0,0,45,0,-45
17054,1,1,368,1384,1016
17055,1,0,11,0,-11
17056,0,0,39,0,-39
17057,1,1,631,1211,580
17058,0,0,71,0,-71
17059,0,0,58,0,-58
17060,0,0,25,0,-25
17061,0,0,58,0,-58
17062,1,0,75,0,-75
17063,0,0,170,0,-170
17064,1,0,4,0,-4
17065,1,0,41,0,-41
17066,1,1,1066,1663,597
17067,1,1,630,1230,600
17068,1,1,175,1568,1393
17069,1,1,171,1424,1253
17070,0,0,12,0,-12
17071,0,0,58,0,-58
17072,0,0,11,0,-11
17073,1,0,17,0,-17
17074,0,0,11,0,-11
17075,1,1,493,1591,1098
17076,1,0,109,0,-109
17077,1,0,6,0,-6
17078,0,0,210,0,-210
17079,1,1,746,1325,579
17080,1,1,438,1451,1013
17081,1,1,731,1300,569
17082,0,0,13,0,-13
17083,1,0,5,0,-5
17084,0,0,30,0,-30
17085,0,0,43,0,-43
17086,1,1,545,1696,1151
17087,0,0,28,0,-28
17088,1,0,142,0,-142
17089,0,0,111,0,-111
17090,0,0,35,0,-35
17091,1,1,1122,1581,459
17092,1,1,453,1463,1010
17093,1,1,732,1249,517
17094,1,1,626,1537,911
17095,1,1,260,1286,1026
17096,0,0,8,0,-8
17097,0,0,36,0,-36
17098,0,0,16,0,-16
17099,0,0,23,0,-23
17100,1,0,176,0,-176
17101,0,0,19,0,-19
17102,0,0,38,0,-38
17103,0,0,7,0,-7
17104,1,1,680,1728,1048
17105,0,0,36,0,-36
17106,1,0,26,0,-26
17107,1,0,9,0,-9
17108,0,0,5,0,-5
17109,1,1,692,1393,701
17110,1,1,176,1287,1111
17111,1,1,383,1489,1106
17112,1,0,156,0,-156
17113,1,1,77,1493,1416
17114,0,0,5,0,-5
17115,0,0,29,0,-29
17116,0,0,95,0,-95
17117,1,0,112,0,-112
17118,1,1,148,1391,1243
17119,1,0,11,0,-11
17120,1,1,448,1838,1390
17121,0,0,11,0,-11
17122,0,0,39,0,-39
17123,1,1,206,1213,1007
17124,0,0,0,0,0
17125,0,0,20,0,-20
17126,1,1,419,1345,926
17127,0,0,11,0,-11
17128,1,1,268,1700,1432
17129,0,0,110,0,-110
17130,0,0,59,0,-59
17131,1,0,69,0,-69
17132,0,0,93,0,-93
17133,0,0,33,0,-33
17134,1,0,128,0,-128
17135,1,1,370,1341,971
17136,1,0,8,0,-8
17137,0,0,5,0,-5
17138,1,1,564,1292,728
17139,0,0,0,0,0
17140,1,0,11,0,-11
17141,0,0,74,0,-74
17142,0,0,110,0,-110
17143,1,0,25,0,-25
17144,1,0,37,0,-37
17145,1,1,264,2307,2043
17146,1,1,1986,1231,-755
17147,1,1,744,2409,1665
17148,1,0,54,0,-54
17149,1,1,179,4263,4084
17150,1,1,221,1405,1184
17151,0,0,43,0,-43
17152,1,0,110,0,-110
17153,0,0,382,0,-382
17154,1,1,1821,1856,35
17155,1,0,18,0,-18
17156,1,1,584,1793,1209
17157,1,1,728,1350,622
17158,0,0,78,0,-78
17159,0,0,54,0,-54
17160,0,0,111,0,-111
17161,0,0,140,0,-140
17162,0,0,34,0,-34
17163,1,1,588,2140,1552
17164,1,0,83,0,-83
17165,1,1,75,1384,1309
17166,1,1,202,1222,1020
17167,0,0,6,0,-6
17168,1,1,821,1675,854
17169,1,0,76,0,-76
17170,0,0,5,0,-5
17171,1,0,9,0,-9
17172,0,0,113,0,-113
17173,1,1,348,1416,1068
17174,1,1,44,1482,1438
17175,0,0,38,0,-38
17176,1,0,28,0,-28
17177,0,0,12,0,-12
17178,0,0,148,0,-148
17179,0,0,65,0,-65
17180,1,1,1247,1222,-25
17181,1,1,340,1798,1458
17182,0,0,69,0,-69
17183,0,0,91,0,-91
17184,1,1,1288,1230,-58
17185,1,0,146,0,-146
17186,0,0,100,0,-100
17187,1,0,13,0,-13
17188,1,0,110,0,-110
17189,0,0,11,0,-11
17190,1,1,619,1348,729
17191,0,0,10,0,-10
17192,1,1,730,3137,2407
17193,1,1,279,1524,1245
17194,0,0,79,0,-79
17195,1,0,56,0,-56
17196,0,0,244,0,-244
17197,1,1,542,1736,1194
17198,1,1,280,1432,1152
17199,1,1,1252,1577,325
17200,0,0,16,0,-16
17201,1,1,477,1405,928
17202,0,0,45,0,-45
17203,0,0,26,0,-26
17204,1,0,3,0,-3
17205,1,1,2101,1217,-884
17206,1,1,400,1226,826
17207,1,0,5,0,-5
17208,1,0,45,0,-45
17209,1,1,278,1216,938
17210,0,0,51,0,-51
17211,0,0,83,0,-83
17212,0,0,25,0,-25
17213,0,0,15,0,-15
17214,0,0,40,0,-40
17215,1,1,1430,1206,-224
17216,1,0,0,0,0
17217,1,1,237,3463,3226
17218,0,0,56,0,-56
17219,1,1,1282,1741,459
17220,0,0,5,0,-5
17221,1,1,233,1229,996
17222,1,0,12,0,-12
17223,1,1,116,1342,1226
17224,0,0,27,0,-27
17225,1,1,483,1240,757
17226,0,0,158,0,-158
17227,0,0,38,0,-38
17228,0,0,96,0,-96
17229,0,0,13,0,-13
17230,1,1,215,1263,1048
17231,0,0,202,0,-202
17232,1,0,50,0,-50
17233,1,0,18,0,-18
17234,1,0,92,0,-92
17235,1,1,195,1772,1577
17236,1,0,77,0,-77
17237,0,0,52,0,-52
17238,1,0,179,0,-179
17239,0,0,127,0,-127
17240,0,0,40,0,-40
17241,0,0,13,0,-13
17242,0,0,39,0,-39
17243,1,0,49,0,-49
17244,1,1,860,3062,2202
17245,0,0,58,0,-58
17246,0,0,28,0,-28
17247,0,0,27,0,-27
17248,1,0,71,0,-71
17249,1,0,129,0,-129
17250,0,0,40,0,-40
17251,1,0,59,0,-59
17252,0,0,24,0,-24
17253,1,0,67,0,-67
17254,1,0,65,0,-65
17255,1,1,260,1476,1216
17256,0,0,32,0,-32
17257,1,1,46,1603,1557
17258,0,0,75,0,-75
17259,1,1,438,1416,978
17260,0,0,74,0,-74
17261,1,0,132,0,-132
17262,1,0,94,0,-94
17263,1,0,53,0,-53
17264,0,0,33,0,-33
17265,1,1,473,1227,754
17266,1,0,27,0,-27
17267,0,0,1,0,-1
17268,1,1,309,1819,1510
17269,0,0,2,0,-2
17270,1,0,94,0,-94
17271,0,0,80,0,-80
17272,0,0,91,0,-91
17273,1,0,163,0,-163
17274,1,0,25,0,-25
17275,0,0,39,0,-39
17276,0,0,20,0,-20
17277,1,0,13,0,-13
17278,1,1,613,1338,725
17279,1,0,63,0,-63
17280,1,0,44,0,-44
17281,1,0,121,0,-121
17282,1,1,134,1334,1200
17283,1,1,501,1714,1213
17284,1,0,46,0,-46
17285,1,0,28,0,-28
17286,0,0,45,0,-45
17287,0,0,10,0,-10
17288,0,0,5,0,-5
17289,1,1,1377,1228,-149
17290,1,0,14,0,-14
17291,0,0,5,0,-5
17292,0,0,116,0,-116
17293,1,1,1351,1342,-9
17294,0,0,49,0,-49
17295,1,0,21,0,-21
17296,1,1,137,1383,1246
17297,1,0,10,0,-10
17298,1,1,408,1353,945
17299,1,0,119,0,-119
17300,0,0,74,0,-74
17301,1,0,97,0,-97
17302,0,0,3,0,-3
17303,1,0,14,0,-14
17304,1,1,425,1425,1000
17305,1,0,183,0,-183
17306,0,0,95,0,-95
17307,1,1,276,1238,962
17308,1,1,36,1310,1274
17309,1,1,348,1206,858
17310,1,1,42,1345,1303
17311,1,1,27,1579,1552
17312,1,1,565,1362,797
17313,0,0,14,0,-14
17314,1,1,351,2137,1786
17315,1,0,93,0,-93
17316,1,0,108,0,-108
17317,1,1,382,1580,1198
17318,1,0,73,0,-73
17319,1,1,202,1240,1038
17320,1,1,700,1414,714
17321,0,0,165,0,-165
17322,0,0,9,0,-9
17323,1,0,41,0,-41
17324,1,1,234,1311,1077
17325,1,1,221,1340,1119
17326,1,1,1572,1779,207
17327,1,0,87,0,-87
17328,1,0,0,0,0
17329,1,1,196,1266,1070
17330,0,0,51,0,-51
17331,0,0,52,0,-52
17332,1,0,129,0,-129
17333,0,0,21,0,-21
17334,1,0,119,0,-119
17335,1,1,233,2560,2327
17336,0,0,12,0,-12
17337,1,1,424,1593,1169
17338,1,0,8,0,-8
17339,1,0,5,0,-5
17340,1,0,47,0,-47
17341,1,1,234,1206,972
17342,0,0,24,0,-24
17343,1,1,883,2264,1381
17344,1,0,8,0,-8
17345,1,1,129,1977,1848
17346,1,1,1172,1202,30
17347,1,0,109,0,-109
17348,1,1,802,1509,707
17349,0,0,77,0,-77
17350,0,0,28,0,-28
17351,1,0,40,0,-40
17352,0,0,18,0,-18
17353,1,0,45,0,-45
17354,1,0,42,0,-42
17355,0,0,7,0,-7
17356,1,0,6,0,-6
17357,0,0,15,0,-15
17358,1,0,5,0,-5
17359,1,1,1322,1248,-74
17360,0,0,65,0,-65
17361,1,1,349,1432,1083
17362,0,0,0,0,0
17363,1,0,15,0,-15
17364,0,0,147,0,-147
17365,1,1,203,1704,1501
17366,0,0,57,0,-57
17367,1,0,4,0,-4
17368,1,0,20,0,-20
17369,1,1,1279,1601,322
17370,0,0,77,0,-77
17371,1,0,8,0,-8
17372,1,0,56,0,-56
17373,0,0,49,0,-49
17374,0,0,79,0,-79
17375,0,0,207,0,-207
17376,1,0,85,0,-85
17377,1,1,309,3065,2756
17378,1,0,54,0,-54
17379,1,1,529,1626,1097
17380,1,0,8,0,-8
17381,0,0,45,0,-45
17382,1,1,183,1209,1026
17383,1,0,23,0,-23
17384,1,1,716,1612,896
17385,1,0,10,0,-10
17386,0,0,50,0,-50
17387,0,0,230,0,-230
17388,0,0,52,0,-52
17389,0,0,15,0,-15
17390,1,1,363,1416,1053
17391,1,1,293,1727,1434
17392,1,0,109,0,-109
17393,0,0,87,0,-87
17394,1,1,194,1297,1103
17395,0,0,23,0,-23
17396,0,0,63,0,-63
17397,1,0,10,0,-10
17398,1,1,305,1522,1217
17399,0,0,69,0,-69
17400,0,0,27,0,-27
17401,1,1,830,1473,643
17402,1,1,128,2982,2854
17403,0,0,9,0,-9
17404,0,0,11,0,-11
17405,1,1,2602,1283,-1319
17406,0,0,100,0,-100
17407,1,1,94,1275,1181
17408,1,0,5,0,-5
17409,1,0,7,0,-7
17410,1,0,82,0,-82
17411,1,1,839,2288,1449
17412,0,0,26,0,-26
17413,1,1,712,3198,2486
17414,1,1,177,1836,1659
17415,1,0,45,0,-45
17416,1,0,87,0,-87
17417,1,0,33,0,-33
17418,1,0,49,0,-49
17419,0,0,11,0,-11
17420,1,1,899,1469,570
17421,0,0,20,0,-20
17422,0,0,45,0,-45
17423,0,0,68,0,-68
17424,0,0,4,0,-4
17425,1,1,146,1695,1549
17426,1,0,10,0,-10
17427,1,0,110,0,-110
17428,1,1,175,1294,1119
17429,1,1,169,1677,1508
17430,0,0,4,0,-4
17431,1,0,32,0,-32
17432,1,1,1800,1759,-41
17433,1,0,139,0,-139
17434,1,0,148,0,-148
17435,1,1,119,1357,1238
17436,1,1,165,1232,1067
17437,1,1,176,1233,1057
17438,0,0,112,0,-112
17439,1,0,89,0,-89
17440,1,1,843,1307,464
17441,0,0,138,0,-138
17442,0,0,39,0,-39
17443,1,0,46,0,-46
17444,1,1,321,1506,1185
17445,1,1,763,1256,493
17446,1,1,78,1312,1234
17447,1,1,429,1675,1246
17448,0,0,7,0,-7
17449,0,0,3,0,-3
17450,0,0,145,0,-145
17451,1,0,101,0,-101
17452,1,0,93,0,-93
17453,1,1,35,1230,1195
17454,1,0,8,0,-8
17455,1,1,506,1547,1041
17456,1,0,50,0,-50
17457,0,0,119,0,-119
17458,1,0,122,0,-122
17459,0,0,1,0,-1
17460,1,1,776,1324,548
17461,1,1,510,1724,1214
17462,0,0,129,0,-129
17463,0,0,38,0,-38
17464,0,0,73,0,-73
17465,0,0,240,0,-240
17466,1,1,219,2217,1998
17467,1,0,32,0,-32
17468,0,0,42,0,-42
17469,1,0,34,0,-34
17470,1,1,1477,1230,-247
17471,1,1,137,1200,1063
17472,0,0,14,0,-14
17473,1,0,77,0,-77
17474,1,1,335,1610,1275
17475,1,1,200,1263,1063
17476,0,0,39,0,-39
17477,0,0,2,0,-2
17478,1,0,2,0,-2
17479,0,0,21,0,-21
17480,1,0,55,0,-55
17481,0,0,25,0,-25
17482,1,0,24,0,-24
17483,0,0,18,0,-18
17484,0,0,0,0,0
17485,1,1,788,3088,2300
17486,1,0,45,0,-45
17487,0,0,26,0,-26
17488,1,0,6,0,-6
17489,1,0,42,0,-42
17490,0,0,2,0,-2
17491,1,1,37,1266,1229
17492,1,0,70,0,-70
17493,1,0,148,0,-148
17494,1,1,495,1389,894
17495,1,0,35,0,-35
17496,1,1,85,2104,2019
17497,1,0,80,0,-80
17498,0,0,0,0,0
17499,1,1,75,1331,1256
17500,1,1,616,1356,740
17501,1,0,2,0,-2
17502,1,0,61,0,-61
17503,1,1,420,1532,1112
17504,1,0,95,0,-95
17505,0,0,16,0,-16
17506,0,0,3,0,-3
17507,1,0,77,0,-77
17508,1,0,4,0,-4
17509,1,1,657,1677,1020
17510,0,0,7,0,-7
17511,1,0,11,0,-11
17512,1,0,23,0,-23
17513,1,1,1143,1945,802
17514,0,0,67,0,-67
17515,0,0,1,0,-1
17516,0,0,22,0,-22
17517,0,0,48,0,-48
17518,1,1,299,1471,1172
17519,1,0,47,0,-47
17520,1,1,1341,1353,12
17521,1,0,3,0,-3
17522,0,0,24,0,-24
17523,1,0,0,0,0
17524,1,0,89,0,-89
17525,1,0,88,0,-88
17526,0,0,20,0,-20
17527,1,0,42,0,-42
17528,1,1,745,1530,785
17529,0,0,28,0,-28
17530,0,0,112,0,-112
17531,0,0,40,0,-40
17532,1,1,260,1399,1139
17533,1,1,153,2040,1887
17534,1,1,53,1534,1481
17535,1,1,439,1787,1348
17536,0,0,22,0,-22
17537,1,0,0,0,0
17538,1,0,4,0,-4
17539,0,0,14,0,-14
17540,0,0,70,0,-70
17541,1,0,23,0,-23
17542,0,0,28,0,-28
17543,1,1,451,1597,1146
17544,1,1,70,1224,1154
17545,1,0,2,0,-2
17546,1,0,141,0,-141
17547,0,0,168,0,-168
17548,0,0,38,0,-38
17549,1,0,33,0,-33
17550,0,0,4,0,-4
17551,1,0,1,0,-1
17552,0,0,28,0,-28
17553,1,1,182,1820,1638
17554,0,0,1,0,-1
17555,1,0,16,0,-16
17556,1,1,297,1705,1408
17557,1,1,221,1309,1088
17558,0,0,48,0,-48
17559,1,0,125,0,-125
17560,0,0,47,0,-47
17561,0,0,0,0,0
17562,0,0,27,0,-27
17563,0,0,12,0,-12
17564,0,0,25,0,-25
17565,0,0,4,0,-4
17566,0,0,41,0,-41
17567,1,0,27,0,-27
17568,1,1,480,1350,870
17569,1,0,11,0,-11
17570,0,0,27,0,-27
17571,1,1,219,1242,1023
17572,1,0,84,0,-84
17573,1,1,98,1269,1171
17574,1,0,12,0,-12
17575,1,1,1764,1480,-284
17576,0,0,0,0,0
17577,0,0,14,0,-14
17578,1,0,19,0,-19
17579,0,0,20,0,-20
17580,1,1,922,1596,674
17581,1,0,12,0,-12
17582,1,1,1236,1543,307
17583,1,0,1,0,-1
17584,1,1,122,1710,1588
17585,1,0,11,0,-11
17586,1,0,56,0,-56
17587,1,1,277,1483,1206
17588,0,0,8,0,-8
17589,0,0,176,0,-176
17590,0,0,14,0,-14
17591,1,0,16,0,-16
17592,1,0,5,0,-5
17593,0,0,26,0,-26
17594,0,0,239,0,-239
17595,1,0,7,0,-7
17596,1,1,1088,1912,824
17597,1,1,96,1365,1269
17598,1,1,114,1299,1185
17599,1,0,33,0,-33
17600,1,1,444,1571,1127
17601,1,1,776,1491,715
17602,0,0,5,0,-5
17603,1,1,252,1309,1057
17604,1,0,97,0,-97
17605,0,0,20,0,-20
17606,0,0,20,0,-20
17607,0,0,132,0,-132
17608,0,0,32,0,-32
17609,0,0,87,0,-87
17610,0,0,3,0,-3
17611,0,0,49,0,-49
17612,1,1,27,1231,1204
17613,0,0,0,0,0
17614,0,0,26,0,-26
17615,0,0,90,0,-90
17616,1,0,121,0,-121
17617,1,0,75,0,-75
17618,1,1,704,1298,594
17619,1,0,18,0,-18
17620,0,0,38,0,-38
17621,0,0,48,0,-48
17622,1,0,42,0,-42
17623,1,1,650,2103,1453
17624,1,1,1438,1334,-104
17625,1,1,1122,1376,254
17626,1,1,415,1357,942
17627,1,0,17,0,-17
17628,0,0,40,0,-40
17629,1,1,956,1586,630
17630,0,0,1,0,-1
17631,1,0,11,0,-11
17632,0,0,58,0,-58
17633,1,0,49,0,-49
17634,0,0,31,0,-31
17635,1,0,79,0,-79
17636,1,1,782,1211,429
17637,0,0,44,0,-44
17638,1,1,77,1612,1535
17639,1,0,104,0,-104
17640,1,1,291,1439,1148
17641,0,0,22,0,-22
17642,0,0,6,0,-6
17643,0,0,0,0,0
17644,1,1,160,1584,1424
17645,1,1,764,1238,474
17646,1,0,17,0,-17
17647,0,0,7,0,-7
17648,1,0,6,0,-6
17649,0,0,17,0,-17
17650,0,0,24,0,-24
17651,1,0,12,0,-12
17652,1,0,23,0,-23
17653,0,0,8,0,-8
17654,1,0,111,0,-111
17655,0,0,22,0,-22
17656,0,0,15,0,-15
17657,0,0,30,0,-30
17658,0,0,65,0,-65
17659,1,0,40,0,-40
17660,1,1,108,1685,1577
17661,1,1,655,1779,1124
17662,0,0,45,0,-45
17663,1,1,227,1464,1237
17664,1,1,515,1358,843
17665,0,0,57,0,-57
17666,1,0,92,0,-92
17667,1,1,619,1203,584
17668,1,0,46,0,-46
17669,1,1,855,1457,602
17670,0,0,16,0,-16
17671,1,0,4,0,-4
17672,1,0,46,0,-46
17673,1,1,120,1211,1091
17674,0,0,87,0,-87
17675,1,1,617,1579,962
17676,0,0,21,0,-21
17677,0,0,106,0,-106
17678,0,0,70,0,-70
17679,1,1,355,2914,2559
17680,1,1,479,1539,1060
17681,1,1,952,1315,363
17682,1,1,876,2105,1229
17683,1,0,4,0,-4
17684,0,0,34,0,-34
17685,1,0,33,0,-33
17686,1,1,2810,1395,-1415
17687,0,0,37,0,-37
17688,1,0,4,0,-4
17689,1,0,75,0,-75
17690,0,0,74,0,-74
17691,1,1,1047,1547,500
17692,0,0,122,0,-122
17693,1,0,105,0,-105
17694,0,0,29,0,-29
17695,1,0,82,0,-82
17696,0,0,33,0,-33
17697,0,0,18,0,-18
17698,1,0,94,0,-94
17699,0,0,46,0,-46
17700,1,1,479,1434,955
17701,0,0,6,0,-6
17702,1,1,526,1331,805
17703,1,0,33,0,-33
17704,1,1,29,1311,1282
17705,1,0,57,0,-57
17706,0,0,25,0,-25
17707,1,1,182,1297,1115
17708,1,1,140,2221,2081
17709,1,0,27,0,-27
17710,0,0,26,0,-26
17711,0,0,55,0,-55
17712,1,0,39,0,-39
17713,1,0,42,0,-42
17714,0,0,41,0,-41
17715,1,1,588,1289,701
17716,0,0,57,0,-57
17717,0,0,23,0,-23
17718,0,0,149,0,-149
17719,1,0,0,0,0
17720,1,1,43,1340,1297
17721,1,1,97,1854,1757
17722,0,0,69,0,-69
17723,1,1,877,1358,481
17724,1,0,29,0,-29
17725,1,0,12,0,-12
17726,1,1,688,1671,983
17727,1,0,106,0,-106
17728,1,0,6,0,-6
17729,0,0,44,0,-44
17730,1,1,392,1283,891
17731,1,1,285,1501,1216
17732,0,0,71,0,-71
17733,1,0,12,0,-12
17734,1,0,151,0,-151
17735,1,0,113,0,-113
17736,0,0,88,0,-88
17737,1,1,1171,1259,88
17738,0,0,115,0,-115
17739,0,0,29,0,-29
17740,1,0,6,0,-6
17741,0,0,64,0,-64
17742,1,0,35,0,-35
17743,1,1,843,1571,728
17744,1,0,5,0,-5
17745,1,0,16,0,-16
17746,0,0,44,0,-44
17747,1,0,9,0,-9
17748,0,0,87,0,-87
17749,1,1,433,1866,1433
17750,1,0,103,0,-103
17751,0,0,44,0,-44
17752,1,0,19,0,-19
17753,0,0,0,0,0
17754,1,0,13,0,-13
17755,1,1,138,1292,1154
17756,1,1,488,1271,783
17757,0,0,9,0,-9
17758,1,1,51,1370,1319
17759,1,1,944,4583,3639
17760,1,0,23,0,-23
17761,0,0,148,0,-148
17762,1,0,25,0,-25
17763,1,0,77,0,-77
17764,1,0,105,0,-105
17765,1,0,151,0,-151
17766,1,1,362,1312,950
17767,0,0,122,0,-122
17768,0,0,27,0,-27
17769,1,1,247,1210,963
17770,1,1,802,1935,1133
17771,0,0,121,0,-121
17772,1,0,59,0,-59
17773,0,0,113,0,-113
17774,0,0,47,0,-47
17775,0,0,55,0,-55
17776,0,0,19,0,-19
17777,0,0,4,0,-4
17778,0,0,76,0,-76
17779,1,1,143,2434,2291
17780,1,1,269,1572,1303
17781,0,0,107,0,-107
17782,0,0,5,0,-5
17783,0,0,0,0,0
17784,1,0,72,0,-72
17785,1,0,16,0,-16
17786,0,0,15,0,-15
17787,1,1,439,1410,971
17788,1,0,10,0,-10
17789,1,0,46,0,-46
17790,0,0,53,0,-53
17791,1,0,11,0,-11
17792,1,0,73,0,-73
17793,1,0,13,0,-13
17794,0,0,67,0,-67
17795,0,0,2,0,-2
17796,1,0,106,0,-106
17797,0,0,101,0,-101
17798,1,0,70,0,-70
17799,1,1,1037,1407,370
17800,0,0,73,0,-73
17801,0,0,76,0,-76
17802,1,0,2,0,-2
17803,1,1,355,1635,1280
17804,0,0,143,0,-143
17805,0,0,17,0,-17
17806,0,0,8,0,-8
17807,0,0,16,0,-16
17808,0,0,84,0,-84
17809,1,1,362,1229,867
17810,0,0,27,0,-27
17811,0,0,95,0,-95
17812,0,0,71,0,-71
17813,0,0,18,0,-18
17814,0,0,4,0,-4
17815,1,1,811,1567,756
17816,1,0,29,0,-29
17817,1,0,62,0,-62
17818,0,0,24,0,-24
17819,0,0,36,0,-36
17820,1,0,3,0,-3
17821,0,0,42,0,-42
17822,0,0,4,0,-4
17823,0,0,3,0,-3
17824,1,1,418,1204,786
17825,1,0,35,0,-35
17826,0,0,70,0,-70
17827,1,0,7,0,-7
17828,0,0,34,0,-34
17829,0,0,26,0,-26
17830,1,1,520,1306,786
17831,0,0,103,0,-103
17832,1,0,66,0,-66
17833,1,0,8,0,-8
17834,1,1,990,1686,696
17835,1,0,64,0,-64
17836,1,0,142,0,-142
17837,1,0,8,0,-8
17838,0,0,3,0,-3
17839,1,1,911,1364,453
17840,0,0,61,0,-61
17841,1,1,2054,1366,-688
17842,0,0,193,0,-193
17843,1,0,130,0,-130
17844,1,1,382,1251,869
17845,0,0,8,0,-8
17846,1,0,148,0,-148
17847,1,1,434,1391,957
17848,1,0,129,0,-129
17849,0,0,128,0,-128
17850,1,0,6,0,-6
17851,1,1,51,4217,4166
17852,1,1,836,1449,613
17853,1,1,634,1378,744
17854,1,0,203,0,-203
17855,0,0,71,0,-71
17856,0,0,6,0,-6
17857,1,0,20,0,-20
17858,1,0,22,0,-22
17859,1,1,414,2025,1611
17860,1,0,64,0,-64
17861,1,0,3,0,-3
17862,1,0,112,0,-112
17863,0,0,76,0,-76
17864,1,1,1937,1558,-379
17865,1,0,167,0,-167
17866,0,0,0,0,0
17867,1,1,919,1426,507
17868,0,0,7,0,-7
17869,1,1,502,1211,709
17870,1,0,53,0,-53
17871,0,0,95,0,-95
17872,0,0,13,0,-13
17873,1,1,826,1295,469
17874,1,0,12,0,-12
17875,1,1,645,1863,1218
17876,1,1,1447,1394,-53
17877,1,0,66,0,-66
17878,1,1,115,1589,1474
17879,1,0,14,0,-14
17880,1,0,20,0,-20
17881,1,0,65,0,-65
17882,1,1,1563,1314,-249
17883,1,0,47,0,-47
17884,1,1,1064,2328,1264
17885,0,0,95,0,-95
17886,1,0,78,0,-78
17887,1,0,63,0,-63
17888,0,0,56,0,-56
17889,1,1,792,1614,822
17890,1,1,165,1818,1653
17891,1,0,54,0,-54
17892,1,1,365,1312,947
17893,0,0,49,0,-49
17894,0,0,68,0,-68
17895,1,1,125,1235,1110
17896,1,1,941,2839,1898
17897,1,1,81,1219,1138
17898,0,0,37,0,-37
17899,1,0,13,0,-13
17900,0,0,34,0,-34
17901,1,0,41,0,-41
17902,1,0,22,0,-22
17903,1,0,85,0,-85
17904,0,0,196,0,-196
17905,1,0,4,0,-4
17906,1,0,8,0,-8
17907,1,0,64,0,-64
17908,1,0,62,0,-62
17909,1,1,415,1258,843
17910,1,1,361,1225,864
17911,1,0,34,0,-34
17912,1,0,19,0,-19
17913,1,1,705,1623,918
17914,1,0,26,0,-26
17915,1,0,4,0,-4
17916,0,0,10,0,-10
17917,0,0,112,0,-112
17918,0,0,69,0,-69
17919,0,0,86,0,-86
17920,0,0,9,0,-9
17921,0,0,9,0,-9
17922,1,1,642,1866,1224
17923,0,0,5,0,-5
17924,1,0,39,0,-39
17925,1,0,14,0,-14
17926,0,0,44,0,-44
17927,1,0,47,0,-47
17928,0,0,50,0,-50
17929,1,0,96,0,-96
17930,1,1,131,1306,1175
17931,0,0,60,0,-60
17932,0,0,58,0,-58
17933,1,0,66,0,-66
17934,0,0,3,0,-3
17935,1,0,32,0,-32
17936,0,0,10,0,-10
17937,0,0,10,0,-10
17938,0,0,34,0,-34
17939,1,0,79,0,-79
17940,1,0,0,0,0
17941,1,1,361,1534,1173
17942,0,0,14,0,-14
17943,0,0,14,0,-14
17944,1,1,1491,1522,31
17945,1,0,79,0,-79
17946,0,0,9,0,-9
17947,0,0,21,0,-21
17948,0,0,116,0,-116
17949,1,0,9,0,-9
17950,1,0,8,0,-8
17951,1,1,235,2229,1994
17952,0,0,1,0,-1
17953,1,1,396,1389,993
17954,1,1,170,1292,1122
17955,1,1,218,1219,1001
17956,1,0,62,0,-62
17957,1,0,5,0,-5
17958,1,1,88,1651,1563
17959,0,0,5,0,-5
17960,1,0,84,0,-84
17961,0,0,30,0,-30
17962,1,1,130,2722,2592
17963,0,0,7,0,-7
17964,1,0,33,0,-33
17965,0,0,33,0,-33
17966,1,1,334,1386,1052
17967,1,1,177,1269,1092
17968,0,0,26,0,-26
17969,0,0,33,0,-33
17970,1,1,255,1597,1342
17971,0,0,86,0,-86
17972,1,1,820,1454,634
17973,1,1,16,1753,1737
17974,1,1,768,2291,1523
17975,0,0,2,0,-2
17976,0,0,28,0,-28
17977,1,0,17,0,-17
17978,1,1,360,1245,885
17979,1,1,871,4707,3836
17980,0,0,4,0,-4
17981,0,0,1,0,-1
17982,1,1,261,2196,1935
17983,1,1,1272,1209,-63
17984,1,0,4,0,-4
17985,0,0,10,0,-10
17986,0,0,9,0,-9
17987,1,0,49,0,-49
17988,0,0,41,0,-41
17989,1,0,88,0,-88
17990,1,0,18,0,-18
17991,1,1,1232,1339,107
17992,1,0,9,0,-9
17993,1,0,144,0,-144
17994,1,0,66,0,-66
17995,0,0,192,0,-192
17996,1,0,7,0,-7
17997,0,0,60,0,-60
17998,0,0,28,0,-28
17999,1,0,89,0,-89
18000,1,1,449,1878,1429
18001,1,1,331,2175,1844
18002,0,0,29,0,-29
18003,0,0,78,0,-78
18004,1,1,157,1508,1351
18005,0,0,130,0,-130
18006,1,1,124,1794,1670
18007,0,0,1,0,-1
18008,1,1,367,1852,1485
18009,0,0,35,0,-35
18010,1,0,4,0,-4
18011,1,1,776,1676,900
18012,1,1,185,1210,1025
18013,0,0,4,0,-4
18014,0,0,23,0,-23
18015,1,1,672,1612,940
18016,1,1,107,1230,1123
18017,1,1,684,1221,537
18018,1,1,754,1253,499
18019,0,0,59,0,-59
18020,0,0,110,0,-110
18021,1,1,71,1538,1467
18022,1,0,52,0,-52
18023,0,0,162,0,-162
18024,0,0,78,0,-78
18025,1,1,690,1408,718
18026,0,0,48,0,-48
18027,1,1,76,1363,1287
18028,1,1,132,1967,1835
18029,0,0,14,0,-14
18030,1,0,30,0,-30
18031,1,1,703,2084,1381
18032,1,0,14,0,-14
18033,1,0,144,0,-144
18034,0,0,57,0,-57
18035,0,0,78,0,-78
18036,0,0,8,0,-8
18037,0,0,9,0,-9
18038,1,1,374,1271,897
18039,0,0,22,0,-22
18040,1,0,135,0,-135
18041,1,0,6,0,-6
18042,1,1,381,1216,835
18043,1,0,11,0,-11
18044,1,1,439,1419,980
18045,0,0,1,0,-1
18046,1,0,13,0,-13
18047,1,0,41,0,-41
18048,1,0,54,0,-54
18049,1,1,1480,1345,-135
18050,0,0,175,0,-175
18051,0,0,42,0,-42
18052,1,1,22,1367,1345
18053,0,0,43,0,-43
18054,1,0,37,0,-37
18055,1,1,171,1622,1451
18056,1,1,779,1748,969
18057,0,0,12,0,-12
18058,0,0,6,0,-6
18059,1,0,13,0,-13
18060,1,0,3,0,-3
18061,0,0,73,0,-73
18062,0,0,104,0,-104
18063,0,0,163,0,-163
18064,0,0,88,0,-88
18065,0,0,2,0,-2
18066,1,1,114,1639,1525
18067,0,0,75,0,-75
18068,0,0,74,0,-74
18069,1,0,0,0,0
18070,1,0,158,0,-158
18071,1,1,111,1720,1609
18072,1,1,1951,1381,-570
18073,1,0,18,0,-18
18074,1,0,135,0,-135
18075,1,1,243,2357,2114
18076,1,1,821,2173,1352
18077,0,0,27,0,-27
18078,1,1,1108,1396,288
18079,1,0,8,0,-8
18080,0,0,11,0,-11
18081,1,1,121,1264,1143
18082,0,0,18,0,-18
18083,1,0,61,0,-61
18084,0,0,29,0,-29
18085,1,1,462,2023,1561
18086,1,0,8,0,-8
18087,1,1,91,1440,1349
18088,1,1,666,1771,1105
18089,0,0,62,0,-62
18090,1,0,357,0,-357
18091,0,0,48,0,-48
18092,0,0,28,0,-28
18093,0,0,6,0,-6
18094,1,1,1363,1321,-42
18095,0,0,120,0,-120
18096,0,0,17,0,-17
18097,1,1,120,1420,1300
18098,1,1,615,1272,657
18099,1,1,584,1240,656
18100,0,0,133,0,-133
18101,0,0,19,0,-19
18102,1,0,0,0,0
18103,1,1,1430,1226,-204
18104,1,1,319,1279,960
18105,0,0,108,0,-108
18106,1,1,1128,1502,374
18107,1,1,1804,1359,-445
18108,1,0,95,0,-95
18109,0,0,167,0,-167
18110,1,1,120,2904,2784
18111,0,0,47,0,-47
18112,1,1,956,1708,752
18113,0,0,0,0,0
18114,0,0,18,0,-18
18115,1,1,124,3234,3110
18116,1,0,36,0,-36
18117,0,0,255,0,-255
18118,1,1,1064,1671,607
18119,1,1,1240,1365,125
18120,0,0,11,0,-11
18121,0,0,4,0,-4
18122,1,0,104,0,-104
18123,0,0,42,0,-42
18124,1,0,13,0,-13
18125,1,1,224,1375,1151
18126,1,0,60,0,-60
18127,1,0,100,0,-100
18128,1,1,533,1419,886
18129,1,0,62,0,-62
18130,1,1,1259,1814,555
18131,1,0,44,0,-44
18132,0,0,142,0,-142
18133,0,0,14,0,-14
18134,0,0,4,0,-4
18135,0,0,77,0,-77
18136,0,0,68,0,-68
18137,1,0,154,0,-154
18138,1,1,696,1540,844
18139,1,1,616,2017,1401
18140,0,0,41,0,-41
18141,0,0,47,0,-47
18142,0,0,45,0,-45
18143,1,1,144,1346,1202
18144,1,1,663,1841,1178
18145,1,0,98,0,-98
18146,1,1,751,1301,550
18147,0,0,7,0,-7
18148,0,0,1,0,-1
18149,0,0,92,0,-92
18150,1,1,1003,1428,425
18151,0,0,81,0,-81
18152,1,0,119,0,-119
18153,1,1,166,1526,1360
18154,0,0,12,0,-12
18155,1,0,147,0,-147
18156,1,0,37,0,-37
18157,1,0,152,0,-152
18158,0,0,34,0,-34
18159,0,0,35,0,-35
18160,0,0,19,0,-19
18161,1,1,436,1836,1400
18162,1,1,421,1287,866
18163,1,0,98,0,-98
18164,0,0,5,0,-5
18165,1,1,929,1331,402
18166,1,1,358,2480,2122
18167,1,0,18,0,-18
18168,1,0,5,0,-5
18169,0,0,42,0,-42
18170,0,0,106,0,-106
18171,0,0,62,0,-62
18172,1,0,21,0,-21
18173,0,0,27,0,-27
18174,0,0,68,0,-68
18175,1,1,619,1451,832
18176,0,0,45,0,-45
18177,1,1,714,1459,745
18178,1,0,3,0,-3
18179,0,0,7,0,-7
18180,1,0,17,0,-17
18181,1,1,61,1303,1242
18182,1,1,536,1432,896
18183,1,1,262,1280,1018
18184,1,1,190,1242,1052
18185,1,1,592,1463,871
18186,1,1,171,1388,1217
18187,0,0,39,0,-39
18188,0,0,141,0,-141
18189,0,0,48,0,-48
18190,0,0,21,0,-21
18191,0,0,9,0,-9
18192,1,1,935,1254,319
18193,1,1,755,1231,476
18194,1,0,20,0,-20
18195,0,0,43,0,-43
18196,0,0,25,0,-25
18197,1,0,40,0,-40
18198,0,0,45,0,-45
18199,1,1,271,2548,2277
18200,0,0,39,0,-39
18201,0,0,0,0,0
18202,0,0,109,0,-109
18203,1,1,145,1500,1355
18204,1,1,1119,1273,154
18205,1,0,17,0,-17
18206,0,0,61,0,-61
18207,1,0,65,0,-65
18208,1,0,38,0,-38
18209,1,0,45,0,-45
18210,0,0,27,0,-27
18211,1,0,6,0,-6
18212,1,0,14,0,-14
18213,1,1,1067,1363,296
18214,0,0,37,0,-37
18215,1,1,112,1399,1287
18216,1,1,431,1368,937
18217,0,0,48,0,-48
18218,1,0,49,0,-49
18219,0,0,33,0,-33
18220,1,1,47,1271,1224
18221,0,0,2,0,-2
18222,1,0,26,0,-26
18223,1,0,30,0,-30
18224,0,0,2,0,-2
18225,1,0,175,0,-175
18226,1,0,54,0,-54
18227,1,0,3,0,-3
18228,1,0,21,0,-21
18229,0,0,10,0,-10
18230,1,0,73,0,-73
18231,1,1,123,1395,1272
18232,1,0,16,0,-16
18233,1,0,160,0,-160
18234,0,0,3,0,-3
18235,1,0,11,0,-11
18236,1,0,16,0,-16
18237,1,1,327,1981,1654
18238,0,0,78,0,-78
18239,1,0,41,0,-41
18240,0,0,6,0,-6
18241,1,1,21,1985,1964
18242,1,0,52,0,-52
18243,0,0,77,0,-77
18244,0,0,65,0,-65
18245,1,1,522,1424,902
18246,1,1,2516,2280,-236
18247,1,1,636,1405,769
18248,1,1,333,1242,909
18249,1,0,164,0,-164
18250,0,0,39,0,-39
18251,1,0,68,0,-68
18252,1,0,39,0,-39
18253,0,0,47,0,-47
18254,0,0,74,0,-74
18255,1,1,21,1510,1489
18256,0,0,8,0,-8
18257,0,0,50,0,-50
18258,0,0,60,0,-60
18259,0,0,59,0,-59
18260,1,0,11,0,-11
18261,0,0,35,0,-35
18262,1,0,0,0,0
18263,0,0,40,0,-40
18264,1,0,19,0,-19
18265,1,1,176,2147,1971
18266,1,1,1634,1652,18
18267,1,0,11,0,-11
18268,1,1,1255,1783,528
18269,0,0,11,0,-11
18270,1,1,723,1641,918
18271,0,0,8,0,-8
18272,1,0,7,0,-7
18273,1,0,45,0,-45
18274,1,1,215,2008,1793
18275,1,1,92,2325,2233
18276,0,0,12,0,-12
18277,0,0,37,0,-37
18278,1,1,279,1293,1014
18279,1,1,722,1520,798
18280,0,0,25,0,-25
18281,0,0,112,0,-112
18282,1,1,862,1361,499
18283,0,0,93,0,-93
18284,0,0,1,0,-1
18285,1,0,82,0,-82
18286,1,0,123,0,-123
18287,0,0,15,0,-15
18288,1,0,25,0,-25
18289,0,0,50,0,-50
18290,1,0,17,0,-17
18291,1,1,460,1416,956
18292,0,0,100,0,-100
18293,0,0,90,0,-90
18294,1,1,155,3171,3016
18295,0,0,25,0,-25
18296,1,0,183,0,-183
18297,1,0,91,0,-91
18298,0,0,8,0,-8
18299,1,0,32,0,-32
18300,0,0,103,0,-103
18301,1,1,626,1738,1112
18302,0,0,2,0,-2
18303,0,0,30,0,-30
18304,0,0,15,0,-15
18305,0,0,23,0,-23
18306,1,0,25,0,-25
18307,0,0,83,0,-83
18308,0,0,89,0,-89
18309,1,1,2598,1289,-1309
18310,1,0,91,0,-91
18311,1,0,30,0,-30
18312,0,0,57,0,-57
18313,0,0,26,0,-26
18314,1,0,14,0,-14
18315,0,0,24,0,-24
18316,0,0,56,0,-56
18317,1,0,52,0,-52
18318,1,0,89,0,-89
18319,0,0,11,0,-11
18320,0,0,112,0,-112
18321,1,1,1092,1338,246
18322,1,1,902,3181,2279
18323,0,0,2,0,-2
18324,0,0,19,0,-19
18325,1,1,525,2534,2009
18326,0,0,16,0,-16
18327,0,0,0,0,0
18328,1,1,887,1886,999
18329,1,1,512,2081,1569
18330,1,1,244,1463,1219
18331,1,0,31,0,-31
18332,0,0,60,0,-60
18333,0,0,42,0,-42
18334,1,0,15,0,-15
18335,1,0,36,0,-36
18336,1,0,30,0,-30
18337,0,0,71,0,-71
18338,1,0,37,0,-37
18339,1,1,80,1635,1555
18340,1,1,715,1290,575
18341,0,0,237,0,-237
18342,0,0,26,0,-26
18343,1,1,238,1342,1104
18344,0,0,1,0,-1
18345,0,0,73,0,-73
18346,1,0,88,0,-88
18347,1,1,89,2273,2184
18348,0,0,51,0,-51
18349,1,0,6,0,-6
18350,0,0,14,0,-14
18351,0,0,23,0,-23
18352,1,1,370,2284,1914
18353,1,1,630,1575,945
18354,0,0,41,0,-41
18355,1,1,808,1291,483
18356,0,0,10,0,-10
18357,1,1,324,1676,1352
18358,1,1,248,1234,986
18359,1,1,629,2246,1617
18360,1,0,28,0,-28
18361,0,0,19,0,-19
18362,0,0,49,0,-49
18363,1,1,210,1495,1285
18364,1,1,780,1309,529
18365,1,1,1231,1690,459
18366,0,0,3,0,-3
18367,1,1,941,1346,405
18368,0,0,18,0,-18
18369,1,0,14,0,-14
18370,0,0,15,0,-15
18371,0,0,69,0,-69
18372,0,0,181,0,-181
18373,0,0,61,0,-61
18374,0,0,1,0,-1
18375,1,1,416,1282,866
18376,1,0,48,0,-48
18377,1,0,35,0,-35
18378,1,1,629,1216,587
18379,1,1,448,1427,979
18380,1,0,11,0,-11
18381,0,0,124,0,-124
18382,1,1,536,1384,848
18383,1,1,574,1331,757
18384,0,0,20,0,-20
18385,0,0,103,0,-103
18386,0,0,1,0,-1
18387,1,1,479,1505,1026
18388,0,0,55,0,-55
18389,1,1,70,1946,1876
18390,1,1,112,1350,1238
18391,0,0,71,0,-71
18392,0,0,52,0,-52
18393,0,0,9,0,-9
18394,1,0,61,0,-61
18395,1,0,76,0,-76
18396,0,0,10,0,-10
18397,0,0,59,0,-59
18398,0,0,39,0,-39
18399,0,0,96,0,-96
18400,0,0,3,0,-3
18401,1,0,184,0,-184
18402,0,0,4,0,-4
18403,0,0,24,0,-24
18404,0,0,198,0,-198
18405,1,1,41,1226,1185
18406,0,0,8,0,-8
18407,1,1,1157,1596,439
18408,0,0,131,0,-131
18409,0,0,134,0,-134
18410,0,0,14,0,-14
18411,1,1,871,1219,348
18412,1,0,22,0,-22
18413,0,0,73,0,-73
18414,1,1,95,2992,2897
18415,1,1,86,1252,1166
18416,1,1,837,1354,517
18417,0,0,2,0,-2
18418,0,0,9,0,-9
18419,1,0,12,0,-12
18420,1,0,153,0,-153
18421,1,1,164,1729,1565
18422,0,0,87,0,-87
18423,0,0,3,0,-3
18424,1,0,157,0,-157
18425,0,0,76,0,-76
18426,1,1,261,1206,945
18427,0,0,56,0,-56
18428,1,0,117,0,-117
18429,1,0,21,0,-21
18430,1,0,30,0,-30
18431,1,0,47,0,-47
18432,0,0,41,0,-41
18433,1,1,1707,1242,-465
18434,0,0,15,0,-15
18435,1,1,362,1904,1542
18436,1,1,140,3039,2899
18437,0,0,39,0,-39
18438,1,1,1764,1585,-179
18439,1,1,695,1513,818
18440,1,1,78,1202,1124
18441,1,1,878,1742,864
18442,0,0,31,0,-31
18443,1,1,539,2451,1912
18444,1,0,54,0,-54
18445,1,1,85,1242,1157
18446,1,0,2,0,-2
18447,0,0,28,0,-28
18448,1,1,557,1232,675
18449,0,0,12,0,-12
18450,1,0,51,0,-51
18451,1,1,43,1550,1507
18452,0,0,68,0,-68
18453,1,0,73,0,-73
18454,0,0,80,0,-80
18455,1,1,426,2170,1744
18456,1,1,1618,1439,-179
18457,0,0,88,0,-88
18458,0,0,77,0,-77
18459,1,0,31,0,-31
18460,1,1,2309,1348,-961
18461,0,0,94,0,-94
18462,1,1,374,1661,1287
18463,1,1,129,3130,3001
18464,1,1,1842,1413,-429
18465,0,0,10,0,-10
18466,0,0,210,0,-210
18467,1,0,28,0,-28
18468,0,0,104,0,-104
18469,0,0,14,0,-14
18470,0,0,34,0,-34
18471,0,0,50,0,-50
18472,0,0,7,0,-7
18473,1,1,1299,1449,150
18474,0,0,15,0,-15
18475,1,0,91,0,-91
18476,1,0,158,0,-158
18477,1,1,1359,1370,11
18478,1,1,28,1317,1289
18479,1,1,446,1297,851
18480,1,0,13,0,-13
18481,1,0,2,0,-2
18482,1,0,35,0,-35
18483,1,1,304,1314,1010
18484,0,0,149,0,-149
18485,1,1,92,2042,1950
18486,1,0,1,0,-1
18487,0,0,3,0,-3
18488,1,1,508,1211,703
18489,0,0,30,0,-30
18490,0,0,68,0,-68
18491,1,0,1,0,-1
18492,1,0,0,0,0
18493,0,0,69,0,-69
18494,1,1,1658,2057,399
18495,0,0,19,0,-19
18496,0,0,11,0,-11
18497,1,0,30,0,-30
18498,1,1,208,1419,1211
18499,0,0,7,0,-7
18500,0,0,181,0,-181
18501,0,0,77,0,-77
18502,1,0,117,0,-117
18503,0,0,0,0,0
18504,1,0,81,0,-81
18505,0,0,40,0,-40
18506,1,1,132,1690,1558
18507,1,0,175,0,-175
18508,1,1,937,1276,339
18509,1,1,1545,1372,-173
18510,1,1,222,1647,1425
18511,0,0,7,0,-7
18512,1,0,33,0,-33
18513,1,1,152,1274,1122
18514,1,1,349,3235,2886
18515,1,1,436,2097,1661
18516,1,1,1224,1572,348
18517,0,0,36,0,-36
18518,1,0,16,0,-16
18519,1,1,46,1429,1383
18520,1,0,203,0,-203
18521,0,0,10,0,-10
18522,1,0,8,0,-8
18523,0,0,29,0,-29
18524,0,0,1,0,-1
18525,0,0,25,0,-25
18526,0,0,30,0,-30
18527,1,1,2002,1439,-563
18528,1,1,208,1787,1579
18529,1,1,105,1244,1139
18530,1,0,12,0,-12
18531,0,0,44,0,-44
18532,0,0,42,0,-42
18533,0,0,27,0,-27
18534,1,1,502,1363,861
18535,0,0,20,0,-20
18536,0,0,0,0,0
18537,1,1,222,3253,3031
18538,0,0,37,0,-37
18539,1,0,11,0,-11
18540,1,0,6,0,-6
18541,1,0,78,0,-78
18542,1,0,3,0,-3
18543,1,1,166,1387,1221
18544,1,1,1346,1322,-24
18545,1,1,219,1591,1372
18546,1,1,1679,1588,-91
18547,0,0,8,0,-8
18548,0,0,88,0,-88
18549,0,0,166,0,-166
18550,1,1,198,1503,1305
18551,0,0,9,0,-9
18552,1,0,171,0,-171
18553,1,1,1409,1352,-57
18554,1,1,121,1589,1468
18555,0,0,47,0,-47
18556,1,0,152,0,-152
18557,1,0,212,0,-212
18558,0,0,40,0,-40
18559,1,0,16,0,-16
18560,0,0,61,0,-61
18561,0,0,24,0,-24
18562,1,1,3202,1391,-1811
18563,0,0,64,0,-64
18564,0,0,166,0,-166
18565,1,0,57,0,-57
18566,1,0,22,0,-22
18567,1,1,77,1781,1704
18568,0,0,139,0,-139
18569,1,1,324,1319,995
18570,1,1,464,1231,767
18571,1,0,14,0,-14
18572,0,0,146,0,-146
18573,0,0,93,0,-93
18574,0,0,23,0,-23
18575,1,0,0,0,0
18576,1,1,541,1229,688
18577,0,0,2,0,-2
18578,0,0,266,0,-266
18579,0,0,117,0,-117
18580,1,1,183,1294,1111
18581,1,1,1011,1806,795
18582,1,1,999,1575,576
18583,0,0,38,0,-38
18584,0,0,46,0,-46
18585,1,1,792,1871,1079
18586,1,0,140,0,-140
18587,0,0,20,0,-20
18588,1,1,550,1215,665
18589,1,1,18,1220,1202
18590,1,0,86,0,-86
18591,0,0,23,0,-23
18592,0,0,49,0,-49
18593,0,0,11,0,-11
18594,1,0,74,0,-74
18595,1,0,19,0,-19
18596,1,0,88,0,-88
18597,1,0,30,0,-30
18598,1,1,347,1274,927
18599,1,0,0,0,0
18600,1,1,251,1470,1219
18601,0,0,63,0,-63
18602,1,0,53,0,-53
18603,0,0,42,0,-42
18604,0,0,69,0,-69
18605,0,0,38,0,-38
18606,1,0,2,0,-2
18607,1,0,59,0,-59
18608,0,0,115,0,-115
18609,0,0,1,0,-1
18610,1,1,283,1226,943
18611,0,0,3,0,-3
18612,1,1,492,1318,826
18613,1,1,223,1419,1196
18614,0,0,10,0,-10
18615,1,1,229,1220,991
18616,1,1,141,3031,2890
18617,0,0,132,0,-132
18618,1,1,295,1730,1435
18619,0,0,1,0,-1
18620,0,0,161,0,-161
18621,1,1,1668,1241,-427
18622,0,0,0,0,0
18623,1,1,1387,1516,129
18624,0,0,36,0,-36
18625,0,0,8,0,-8
18626,1,1,1023,1366,343
18627,1,0,67,0,-67
18628,1,0,10,0,-10
18629,1,0,99,0,-99
18630,1,0,155,0,-155
18631,0,0,64,0,-64
18632,0,0,35,0,-35
18633,1,0,6,0,-6
18634,1,0,21,0,-21
18635,1,1,382,1647,1265
18636,1,0,28,0,-28
18637,1,0,23,0,-23
18638,0,0,40,0,-40
18639,1,1,776,1552,776
18640,1,0,3,0,-3
18641,0,0,33,0,-33
18642,0,0,62,0,-62
18643,0,0,38,0,-38
18644,1,1,528,1740,1212
18645,1,1,1281,1361,80
18646,1,1,342,1544,1202
18647,0,0,20,0,-20
18648,1,0,64,0,-64
18649,1,1,361,1939,1578
18650,0,0,143,0,-143
18651,1,0,193,0,-193
18652,1,0,27,0,-27
18653,0,0,24,0,-24
18654,0,0,57,0,-57
18655,1,1,608,1277,669
18656,1,1,294,1845,1551
18657,1,0,42,0,-42
18658,1,1,287,1285,998
18659,1,0,8,0,-8
18660,1,0,153,0,-153
18661,1,0,11,0,-11
18662,0,0,33,0,-33
18663,0,0,15,0,-15
18664,1,1,2093,1302,-791
18665,0,0,44,0,-44
18666,1,0,57,0,-57
18667,1,0,43,0,-43
18668,1,1,182,1786,1604
18669,1,1,54,2176,2122
18670,0,0,13,0,-13
18671,1,1,160,2253,2093
18672,1,0,19,0,-19
18673,1,1,140,1464,1324
18674,0,0,97,0,-97
18675,0,0,1,0,-1
18676,1,1,217,1308,1091
18677,1,0,9,0,-9
18678,1,1,1185,1588,403
18679,0,0,209,0,-209
18680,1,0,104,0,-104
18681,1,1,3253,1511,-1742
18682,0,0,16,0,-16
18683,0,0,57,0,-57
18684,1,0,5,0,-5
18685,1,0,90,0,-90
18686,0,0,4,0,-4
18687,1,0,105,0,-105
18688,1,0,28,0,-28
18689,0,0,96,0,-96
18690,0,0,1,0,-1
18691,1,0,22,0,-22
18692,1,1,139,1293,1154
18693,0,0,92,0,-92
18694,0,0,139,0,-139
18695,0,0,15,0,-15
18696,0,0,3,0,-3
18697,1,0,153,0,-153
18698,0,0,6,0,-6
18699,1,0,7,0,-7
18700,1,1,718,1876,1158
18701,0,0,23,0,-23
18702,0,0,46,0,-46
18703,1,1,428,1671,1243
18704,1,0,77,0,-77
18705,0,0,139,0,-139
18706,0,0,40,0,-40
18707,0,0,66,0,-66
18708,1,0,16,0,-16
18709,1,0,4,0,-4
18710,1,1,159,1378,1219
18711,1,1,512,1846,1334
18712,0,0,13,0,-13
18713,0,0,201,0,-201
18714,0,0,18,0,-18
18715,1,1,743,1392,649
18716,1,1,366,2541,2175
18717,0,0,32,0,-32
18718,1,0,53,0,-53
18719,0,0,72,0,-72
18720,1,1,64,1319,1255
18721,1,1,724,1613,889
18722,1,0,1,0,-1
18723,1,1,744,1231,487
18724,1,1,725,1308,583
18725,1,0,1,0,-1
18726,1,0,22,0,-22
18727,0,0,28,0,-28
18728,1,1,825,1210,385
18729,1,0,70,0,-70
18730,1,0,95,0,-95
18731,1,1,316,2567,2251
18732,0,0,81,0,-81
18733,1,0,13,0,-13
18734,1,0,74,0,-74
18735,1,0,80,0,-80
18736,1,1,139,1379,1240
18737,1,1,205,1228,1023
18738,0,0,20,0,-20
18739,0,0,63,0,-63
18740,0,0,2,0,-2
18741,0,0,37,0,-37
18742,1,1,682,1866,1184
18743,0,0,30,0,-30
18744,0,0,9,0,-9
18745,1,0,92,0,-92
18746,1,1,451,1882,1431
18747,0,0,35,0,-35
18748,1,1,148,1291,1143
18749,1,1,400,1666,1266
18750,0,0,12,0,-12
18751,1,1,292,2474,2182
18752,1,0,39,0,-39
18753,1,0,17,0,-17
18754,1,1,101,1283,1182
18755,1,0,11,0,-11
18756,1,1,160,1239,1079
18757,0,0,106,0,-106
18758,1,1,94,1242,1148
18759,1,0,30,0,-30
18760,1,0,87,0,-87
18761,0,0,39,0,-39
18762,1,0,6,0,-6
18763,1,1,442,1385,943
18764,0,0,121,0,-121
18765,1,0,71,0,-71
18766,1,0,65,0,-65
18767,0,0,17,0,-17
18768,1,1,21,1208,1187
18769,0,0,37,0,-37
18770,0,0,15,0,-15
18771,0,0,31,0,-31
18772,1,0,17,0,-17
18773,0,0,25,0,-25
18774,1,1,797,1447,650
18775,1,1,175,1722,1547
18776,1,1,1103,1244,141
18777,1,0,31,0,-31
18778,0,0,7,0,-7
18779,1,1,348,1590,1242
18780,1,1,67,1734,1667
18781,0,0,44,0,-44
18782,1,1,375,1434,1059
18783,1,1,423,1304,881
18784,1,1,173,1276,1103
18785,0,0,6,0,-6
18786,1,1,325,1367,1042
18787,0,0,14,0,-14
18788,1,1,505,1381,876
18789,1,0,85,0,-85
18790,1,1,80,1339,1259
18791,0,0,40,0,-40
18792,1,0,164,0,-164
18793,1,1,634,2243,1609
18794,0,0,2,0,-2
18795,1,0,45,0,-45
18796,1,1,771,1307,536
18797,0,0,34,0,-34
18798,1,0,66,0,-66
18799,1,1,244,1738,1494
18800,1,1,487,1379,892
18801,0,0,29,0,-29
18802,0,0,14,0,-14
18803,1,1,414,1363,949
18804,1,1,299,2229,1930
18805,1,0,12,0,-12
18806,1,0,70,0,-70
18807,0,0,11,0,-11
18808,0,0,9,0,-9
18809,1,0,109,0,-109
18810,1,0,40,0,-40
18811,1,0,17,0,-17
18812,1,1,55,1322,1267
18813,1,1,256,1951,1695
18814,1,1,986,2813,1827
18815,1,1,786,1482,696
18816,0,0,91,0,-91
18817,1,1,153,1393,1240
18818,0,0,128,0,-128
18819,1,1,71,1419,1348
18820,0,0,4,0,-4
18821,0,0,77,0,-77
18822,1,0,5,0,-5
18823,1,0,11,0,-11
18824,1,1,934,1846,912
18825,1,0,41,0,-41
18826,1,1,230,2338,2108
18827,0,0,98,0,-98
18828,1,0,177,0,-177
18829,1,0,5,0,-5
18830,1,1,491,1635,1144
18831,0,0,13,0,-13
18832,1,1,141,1241,1100
18833,1,1,194,1557,1363
18834,1,1,233,2062,1829
18835,0,0,116,0,-116
18836,1,0,13,0,-13
18837,0,0,12,0,-12
18838,1,1,328,2386,2058
18839,1,1,330,2248,1918
18840,0,0,196,0,-196
18841,1,0,54,0,-54
18842,1,0,2,0,-2
18843,1,0,144,0,-144
18844,0,0,225,0,-225
18845,0,0,25,0,-25
18846,0,0,81,0,-81
18847,1,1,493,1413,920
18848,1,1,638,1587,949
18849,1,1,1070,1289,219
18850,0,0,12,0,-12
18851,1,0,63,0,-63
18852,0,0,163,0,-163
18853,0,0,37,0,-37
18854,1,1,182,1344,1162
18855,1,0,25,0,-25
18856,1,1,313,1430,1117
18857,0,0,63,0,-63
18858,1,1,401,1692,1291
18859,0,0,18,0,-18
18860,1,0,86,0,-86
18861,1,1,879,1232,353
18862,0,0,1,0,-1
18863,0,0,3,0,-3
18864,1,1,126,1215,1089
18865,0,0,55,0,-55
18866,1,1,412,2889,2477
18867,0,0,117,0,-117
18868,1,1,462,1359,897
18869,1,1,1319,2239,920
18870,1,1,67,2342,2275
18871,0,0,25,0,-25
18872,1,1,1920,1575,-345
18873,1,0,31,0,-31
18874,0,0,9,0,-9
18875,1,1,637,1499,862
18876,0,0,35,0,-35
18877,0,0,25,0,-25
18878,1,0,21,0,-21
18879,1,1,901,1335,434
18880,0,0,9,0,-9
18881,0,0,1,0,-1
18882,1,1,527,2325,1798
18883,0,0,76,0,-76
18884,0,0,155,0,-155
18885,1,1,380,1449,1069
18886,0,0,64,0,-64
18887,1,0,180,0,-180
18888,1,1,208,1529,1321
18889,1,0,91,0,-91
18890,0,0,5,0,-5
18891,0,0,36,0,-36
18892,1,0,144,0,-144
18893,0,0,55,0,-55
18894,0,0,0,0,0
18895,1,1,449,1288,839
18896,0,0,9,0,-9
18897,1,0,140,0,-140
18898,1,0,141,0,-141
18899,1,1,561,1512,951
18900,0,0,190,0,-190
18901,1,0,14,0,-14
18902,1,1,342,1796,1454
18903,0,0,90,0,-90
18904,0,0,116,0,-116
18905,1,1,747,1484,737
18906,0,0,14,0,-14
18907,1,1,88,1270,1182
18908,0,0,34,0,-34
18909,0,0,101,0,-101
18910,0,0,2,0,-2
18911,0,0,85,0,-85
18912,0,0,55,0,-55
18913,0,0,31,0,-31
18914,0,0,16,0,-16
18915,1,1,159,1279,1120
18916,1,1,1504,2820,1316
18917,0,0,85,0,-85
18918,0,0,43,0,-43
18919,1,0,83,0,-83
18920,1,0,14,0,-14
18921,0,0,3,0,-3
18922,0,0,4,0,-4
18923,0,0,91,0,-91
18924,1,1,378,1869,1491
18925,0,0,9,0,-9
18926,1,1,1126,1505,379
18927,1,1,605,1221,616
18928,1,0,75,0,-75
18929,1,0,15,0,-15
18930,0,0,50,0,-50
18931,1,1,315,1225,910
18932,1,0,7,0,-7
18933,0,0,11,0,-11
18934,0,0,53,0,-53
18935,1,0,26,0,-26
18936,1,0,43,0,-43
18937,1,0,8,0,-8
18938,1,0,10,0,-10
18939,1,1,303,1239,936
18940,1,0,127,0,-127
18941,0,0,46,0,-46
18942,0,0,93,0,-93
18943,0,0,24,0,-24
18944,1,1,724,1247,523
18945,0,0,89,0,-89
18946,1,0,56,0,-56
18947,0,0,64,0,-64
18948,1,1,692,1460,768
18949,1,1,998,1752,754
18950,1,1,458,1262,804
18951,0,0,260,0,-260
18952,1,1,1433,3591,2158
18953,1,1,211,1203,992
18954,0,0,81,0,-81
18955,1,0,12,0,-12
18956,1,0,17,0,-17
18957,1,1,36,1337,1301
18958,0,0,99,0,-99
18959,0,0,59,0,-59
18960,0,0,60,0,-60
18961,1,0,85,0,-85
18962,0,0,139,0,-139
18963,0,0,32,0,-32
18964,0,0,146,0,-146
18965,1,1,71,1519,1448
18966,1,1,711,1254,543
18967,0,0,27,0,-27
18968,0,0,40,0,-40
18969,1,1,1546,1295,-251
18970,1,1,520,2005,1485
18971,1,1,767,1709,942
18972,1,0,50,0,-50
18973,0,0,42,0,-42
18974,1,1,116,2013,1897
18975,1,1,442,1871,1429
18976,0,0,33,0,-33
18977,1,0,28,0,-28
18978,0,0,82,0,-82
18979,1,1,297,1367,1070
18980,1,0,78,0,-78
18981,1,1,327,3596,3269
18982,0,0,14,0,-14
18983,1,1,1961,1696,-265
18984,1,1,664,1224,560
18985,1,0,7,0,-7
18986,0,0,10,0,-10
18987,1,0,22,0,-22
18988,0,0,90,0,-90
18989,1,1,276,1357,1081
18990,1,1,68,1412,1344
18991,1,0,37,0,-37
18992,0,0,169,0,-169
18993,0,0,13,0,-13
18994,1,1,266,1311,1045
18995,0,0,9,0,-9
18996,1,0,34,0,-34
18997,1,1,299,1396,1097
18998,1,0,43,0,-43
18999,0,0,135,0,-135
19000,1,1,145,1213,1068
19001,1,1,1266,1525,259
19002,1,1,399,1219,820
19003,1,1,616,1288,672
19004,1,0,18,0,-18
19005,1,0,58,0,-58
19006,1,0,75,0,-75
19007,0,0,45,0,-45
19008,1,1,358,2142,1784
19009,0,0,7,0,-7
19010,1,0,3,0,-3
19011,1,1,335,2131,1796
19012,0,0,46,0,-46
19013,0,0,26,0,-26
19014,0,0,96,0,-96
19015,1,0,70,0,-70
19016,0,0,58,0,-58
19017,1,1,449,1638,1189
19018,0,0,8,0,-8
19019,1,0,93,0,-93
19020,1,1,613,1350,737
19021,0,0,31,0,-31
19022,1,0,78,0,-78
19023,1,0,110,0,-110
19024,1,1,56,1507,1451
19025,1,1,369,1351,982
19026,1,0,6,0,-6
19027,1,1,252,1660,1408
19028,1,1,204,1498,1294
19029,0,0,25,0,-25
19030,0,0,7,0,-7
19031,1,1,109,1449,1340
19032,0,0,22,0,-22
19033,1,1,103,1451,1348
19034,0,0,9,0,-9
19035,0,0,82,0,-82
19036,0,0,152,0,-152
19037,1,0,8,0,-8
19038,0,0,53,0,-53
19039,0,0,41,0,-41
19040,0,0,56,0,-56
19041,1,1,878,1760,882
19042,1,1,299,1522,1223
19043,0,0,157,0,-157
19044,0,0,5,0,-5
19045,1,0,21,0,-21
19046,0,0,6,0,-6
19047,0,0,0,0,0
19048,1,1,305,1867,1562
19049,1,0,84,0,-84
19050,1,1,194,4085,3891
19051,1,1,112,1217,1105
19052,0,0,89,0,-89
19053,0,0,26,0,-26
19054,1,0,10,0,-10
19055,1,0,4,0,-4
19056,1,1,245,1527,1282
19057,1,1,26,1704,1678
19058,0,0,5,0,-5
19059,0,0,16,0,-16
19060,1,1,350,1265,915
19061,1,1,620,1467,847
19062,1,1,83,1616,1533
19063,1,1,861,2109,1248
19064,0,0,58,0,-58
19065,1,1,58,1506,1448
19066,1,0,78,0,-78
19067,1,0,27,0,-27
19068,0,0,27,0,-27
19069,1,1,594,1327,733
19070,0,0,11,0,-11
19071,1,0,111,0,-111
19072,1,1,1581,1327,-254
19073,1,1,31,1307,1276
19074,0,0,16,0,-16
19075,1,0,170,0,-170
19076,1,1,47,1200,1153
19077,1,0,80,0,-80
19078,1,0,16,0,-16
19079,1,1,587,1314,727
19080,0,0,65,0,-65
19081,0,0,6,0,-6
19082,1,1,586,1474,888
19083,0,0,83,0,-83
19084,1,1,123,1421,1298
19085,1,1,1570,1272,-298
19086,1,1,246,1281,1035
19087,0,0,2,0,-2
19088,0,0,34,0,-34
19089,1,1,137,1295,1158
19090,1,1,1375,1292,-83
19091,1,1,215,1717,1502
19092,1,1,374,1244,870
19093,0,0,19,0,-19
19094,1,0,44,0,-44
19095,0,0,8,0,-8
19096,0,0,9,0,-9
19097,0,0,58,0,-58
19098,0,0,130,0,-130
19099,1,0,46,0,-46
19100,0,0,13,0,-13
19101,0,0,53,0,-53
19102,1,1,419,1340,921
19103,1,1,1074,1211,137
19104,1,0,63,0,-63
19105,1,1,276,1557,1281
19106,0,0,11,0,-11
19107,1,1,217,1347,1130
19108,0,0,18,0,-18
19109,1,0,139,0,-139
19110,1,1,1143,1710,567
19111,1,0,73,0,-73
19112,0,0,86,0,-86
19113,1,1,420,1340,920
19114,1,0,9,0,-9
19115,1,0,39,0,-39
19116,0,0,115,0,-115
19117,0,0,92,0,-92
19118,1,0,39,0,-39
19119,1,1,486,1255,769
19120,1,0,43,0,-43
19121,1,0,6,0,-6
19122,1,0,28,0,-28
19123,0,0,40,0,-40
19124,1,0,27,0,-27
19125,1,0,12,0,-12
19126,1,0,47,0,-47
19127,1,1,217,1703,1486
19128,1,0,129,0,-129
19129,1,0,1,0,-1
19130,1,1,713,1293,580
19131,1,0,14,0,-14
19132,0,0,98,0,-98
19133,1,0,74,0,-74
19134,0,0,86,0,-86
19135,1,1,306,1799,1493
19136,1,1,278,1688,1410
19137,1,1,149,2074,1925
19138,0,0,7,0,-7
19139,1,0,75,0,-75
19140,0,0,10,0,-10
19141,0,0,11,0,-11
19142,0,0,54,0,-54
19143,0,0,19,0,-19
19144,0,0,35,0,-35
19145,1,1,1040,1225,185
19146,0,0,56,0,-56
19147,1,0,73,0,-73
19148,1,1,741,1217,476
19149,0,0,42,0,-42
19150,1,0,31,0,-31
19151,1,0,55,0,-55
19152,1,1,363,2485,2122
19153,1,0,1,0,-1
19154,0,0,8,0,-8
19155,1,1,1148,1377,229
19156,0,0,36,0,-36
19157,0,0,30,0,-30
19158,0,0,19,0,-19
19159,1,0,10,0,-10
19160,0,0,165,0,-165
19161,0,0,97,0,-97
19162,0,0,18,0,-18
19163,0,0,160,0,-160
19164,0,0,115,0,-115
19165,1,1,366,1322,956
19166,0,0,5,0,-5
19167,1,0,3,0,-3
19168,0,0,14,0,-14
19169,0,0,201,0,-201
19170,1,1,502,1660,1158
19171,0,0,8,0,-8
19172,1,0,14,0,-14
19173,1,0,4,0,-4
19174,0,0,11,0,-11
19175,1,0,36,0,-36
19176,1,0,28,0,-28
19177,0,0,53,0,-53
19178,0,0,84,0,-84
19179,1,0,16,0,-16
19180,1,1,339,1525,1186
19181,0,0,27,0,-27
19182,0,0,29,0,-29
19183,1,1,665,1337,672
19184,0,0,4,0,-4
19185,0,0,108,0,-108
19186,1,0,62,0,-62
19187,1,1,488,1623,1135
19188,1,1,143,1642,1499
19189,0,0,18,0,-18
19190,1,0,13,0,-13
19191,1,1,441,1259,818
19192,1,0,17,0,-17
19193,1,1,288,1340,1052
19194,0,0,68,0,-68
19195,1,0,112,0,-112
19196,1,0,139,0,-139
19197,1,0,88,0,-88
19198,0,0,23,0,-23
19199,1,0,20,0,-20
19200,0,0,6,0,-6
19201,0,0,61,0,-61
19202,1,1,358,1277,919
19203,1,0,23,0,-23
19204,0,0,53,0,-53
19205,1,1,16,1492,1476
19206,1,1,311,1700,1389
19207,0,0,189,0,-189
19208,1,0,74,0,-74
19209,1,0,86,0,-86
19210,1,1,286,1662,1376
19211,0,0,22,0,-22
19212,0,0,4,0,-4
19213,0,0,17,0,-17
19214,0,0,131,0,-131
19215,1,1,125,1227,1102
19216,0,0,33,0,-33
19217,1,1,1246,1271,25
19218,1,1,2816,1331,-1485
19219,0,0,5,0,-5
19220,1,1,785,2143,1358
19221,1,1,321,1686,1365
19222,1,1,112,1216,1104
19223,0,0,13,0,-13
19224,1,1,286,1698,1412
19225,0,0,51,0,-51
19226,1,0,42,0,-42
19227,1,1,620,2623,2003
19228,1,0,14,0,-14
19229,1,0,7,0,-7
19230,1,0,65,0,-65
19231,1,1,384,1450,1066
19232,0,0,156,0,-156
19233,0,0,98,0,-98
19234,0,0,21,0,-21
19235,1,0,21,0,-21
19236,0,0,88,0,-88
19237,0,0,196,0,-196
19238,1,1,809,1694,885
19239,0,0,97,0,-97
19240,0,0,64,0,-64
19241,0,0,2,0,-2
19242,1,0,9,0,-9
19243,0,0,37,0,-37
19244,0,0,39,0,-39
19245,1,0,9,0,-9
19246,0,0,100,0,-100
19247,0,0,62,0,-62
19248,1,1,2224,1321,-903
19249,1,1,544,1705,1161
19250,0,0,35,0,-35
19251,1,0,11,0,-11
19252,0,0,55,0,-55
19253,1,0,20,0,-20
19254,1,1,660,6191,5531
19255,0,0,80,0,-80
19256,0,0,10,0,-10
19257,1,1,437,1533,1096
19258,1,0,4,0,-4
19259,1,1,509,1360,851
19260,1,1,107,2115,2008
19261,1,0,53,0,-53
19262,1,0,29,0,-29
19263,0,0,19,0,-19
19264,1,1,81,1208,1127
19265,1,0,70,0,-70
19266,1,1,1201,1270,69
19267,0,0,33,0,-33
19268,0,0,0,0,0
19269,0,0,67,0,-67
19270,0,0,17,0,-17
19271,0,0,225,0,-225
19272,1,0,64,0,-64
19273,1,0,62,0,-62
19274,1,0,22,0,-22
19275,1,0,32,0,-32
19276,1,0,47,0,-47
19277,1,0,0,0,0
19278,1,1,230,1452,1222
19279,0,0,31,0,-31
19280,1,1,1821,1668,-153
19281,0,0,21,0,-21
19282,1,1,356,1780,1424
19283,1,0,109,0,-109
19284,0,0,57,0,-57
19285,0,0,28,0,-28
19286,1,1,299,1856,1557
19287,0,0,5,0,-5
19288,1,0,59,0,-59
19289,0,0,60,0,-60
19290,1,1,72,1279,1207
19291,0,0,71,0,-71
19292,0,0,69,0,-69
19293,0,0,0,0,0
19294,1,1,314,3103,2789
19295,1,1,1695,2231,536
19296,1,1,651,1857,1206
19297,1,0,5,0,-5
19298,0,0,126,0,-126
19299,1,0,41,0,-41
19300,0,0,143,0,-143
19301,1,0,6,0,-6
19302,1,0,79,0,-79
19303,0,0,60,0,-60
19304,1,1,1409,1708,299
19305,1,1,1190,1566,376
19306,1,1,154,1334,1180
19307,1,1,163,1493,1330
19308,0,0,38,0,-38
19309,1,1,1176,3635,2459
19310,1,1,535,2012,1477
19311,0,0,86,0,-86
19312,0,0,35,0,-35
19313,1,1,854,2715,1861
19314,1,1,2895,1203,-1692
19315,1,1,1641,1438,-203
19316,1,1,227,1792,1565
19317,1,0,115,0,-115
19318,0,0,152,0,-152
19319,0,0,53,0,-53
19320,1,0,11,0,-11
19321,1,1,78,1209,1131
19322,1,1,618,1478,860
19323,1,1,191,1886,1695
19324,1,0,161,0,-161
19325,0,0,24,0,-24
19326,1,0,7,0,-7
19327,1,0,60,0,-60
19328,1,0,5,0,-5
19329,0,0,90,0,-90
19330,0,0,0,0,0
19331,0,0,42,0,-42
19332,0,0,28,0,-28
19333,0,0,72,0,-72
19334,1,1,252,1676,1424
19335,1,0,39,0,-39
19336,1,1,126,1566,1440
19337,1,0,111,0,-111
19338,0,0,28,0,-28
19339,1,1,3814,3142,-672
19340,0,0,23,0,-23
19341,1,1,632,2782,2150
19342,0,0,51,0,-51
19343,0,0,5,0,-5
19344,0,0,31,0,-31
19345,0,0,16,0,-16
19346,0,0,30,0,-30
19347,0,0,7,0,-7
19348,1,1,155,2281,2126
19349,1,0,37,0,-37
19350,1,1,91,1226,1135
19351,0,0,45,0,-45
19352,0,0,3,0,-3
19353,0,0,50,0,-50
19354,1,1,199,1690,1491
19355,1,0,152,0,-152
19356,0,0,1,0,-1
19357,1,0,12,0,-12
19358,1,1,1978,2727,749
19359,1,1,727,1279,552
19360,1,1,266,1518,1252
19361,0,0,9,0,-9
19362,0,0,31,0,-31
19363,1,0,97,0,-97
19364,1,1,316,1519,1203
19365,1,0,36,0,-36
19366,1,1,297,1786,1489
19367,1,1,387,1249,862
19368,0,0,33,0,-33
19369,1,1,601,1436,835
19370,1,0,48,0,-48
19371,1,0,12,0,-12
19372,0,0,17,0,-17
19373,0,0,31,0,-31
19374,1,0,33,0,-33
19375,0,0,61,0,-61
19376,0,0,127,0,-127
19377,1,0,11,0,-11
19378,0,0,123,0,-123
19379,1,0,5,0,-5
19380,1,0,9,0,-9
19381,0,0,17,0,-17
19382,1,1,238,1225,987
19383,0,0,15,0,-15
19384,1,1,2079,1698,-381
19385,0,0,42,0,-42
19386,1,1,1081,1225,144
19387,0,0,83,0,-83
19388,0,0,64,0,-64
19389,1,1,490,2058,1568
19390,1,0,6,0,-6
19391,1,1,75,1259,1184
19392,0,0,65,0,-65
19393,1,1,390,1399,1009
19394,1,1,85,1201,1116
19395,1,0,17,0,-17
19396,0,0,24,0,-24
19397,1,0,183,0,-183
19398,1,0,159,0,-159
19399,0,0,17,0,-17
19400,1,0,6,0,-6
19401,1,0,40,0,-40
19402,1,0,9,0,-9
19403,1,0,15,0,-15
19404,1,0,11,0,-11
19405,0,0,83,0,-83
19406,1,1,172,1394,1222
19407,1,0,68,0,-68
19408,0,0,73,0,-73
19409,0,0,113,0,-113
19410,0,0,48,0,-48
19411,0,0,4,0,-4
19412,1,0,11,0,-11
19413,0,0,54,0,-54
19414,1,1,853,2325,1472
19415,1,0,15,0,-15
19416,1,1,263,1253,990
19417,0,0,29,0,-29
19418,1,0,68,0,-68
19419,0,0,43,0,-43
19420,1,0,22,0,-22
19421,0,0,89,0,-89
19422,1,1,585,1349,764
19423,1,1,152,1233,1081
19424,1,0,15,0,-15
19425,1,1,190,1697,1507
19426,0,0,48,0,-48
19427,1,1,49,1314,1265
19428,1,1,148,1228,1080
19429,0,0,28,0,-28
19430,0,0,1,0,-1
19431,1,1,101,2192,2091
19432,1,1,253,1418,1165
19433,1,0,175,0,-175
19434,1,1,206,1339,1133
19435,1,1,749,2004,1255
19436,0,0,35,0,-35
19437,1,1,71,1207,1136
19438,0,0,15,0,-15
19439,0,0,53,0,-53
19440,0,0,40,0,-40
19441,1,1,1124,1251,127
19442,1,0,22,0,-22
19443,0,0,64,0,-64
19444,0,0,8,0,-8
19445,0,0,38,0,-38
19446,1,0,77,0,-77
19447,0,0,69,0,-69
19448,1,1,65,1561,1496
19449,0,0,6,0,-6
19450,1,1,184,1441,1257
19451,1,0,22,0,-22
19452,0,0,69,0,-69
19453,0,0,21,0,-21
19454,0,0,32,0,-32
19455,0,0,35,0,-35
19456,1,0,161,0,-161
19457,0,0,69,0,-69
19458,1,0,149,0,-149
19459,0,0,7,0,-7
19460,1,1,839,1334,495
19461,1,1,532,1443,911
19462,1,1,512,1782,1270
19463,0,0,27,0,-27
19464,1,0,109,0,-109
19465,0,0,41,0,-41
19466,0,0,0,0,0
19467,1,1,648,1578,930
19468,1,1,117,1720,1603
19469,1,0,53,0,-53
19470,0,0,123,0,-123
19471,0,0,131,0,-131
19472,1,1,585,1864,1279
19473,1,1,97,1226,1129
19474,1,0,35,0,-35
19475,1,1,702,1434,732
19476,0,0,57,0,-57
19477,1,0,13,0,-13
19478,0,0,1,0,-1
19479,1,1,1122,1265,143
19480,1,0,34,0,-34
19481,0,0,1,0,-1
19482,1,1,895,1202,307
19483,0,0,48,0,-48
19484,1,0,110,0,-110
19485,0,0,20,0,-20
19486,1,0,6,0,-6
19487,0,0,27,0,-27
19488,1,0,31,0,-31
19489,0,0,22,0,-22
19490,1,1,152,1253,1101
19491,0,0,17,0,-17
19492,1,1,472,2434,1962
19493,1,1,405,1392,987
19494,1,0,75,0,-75
19495,1,0,26,0,-26
19496,1,1,2390,1335,-1055
19497,0,0,43,0,-43
19498,0,0,82,0,-82
19499,0,0,24,0,-24
19500,1,0,1,0,-1
19501,0,0,13,0,-13
19502,1,1,503,1362,859
19503,0,0,53,0,-53
19504,0,0,22,0,-22
19505,1,0,10,0,-10
19506,0,0,119,0,-119
19507,1,1,535,5360,4825
19508,0,0,17,0,-17
19509,0,0,18,0,-18
19510,0,0,63,0,-63
19511,0,0,144,0,-144
19512,0,0,183,0,-183
19513,1,1,1191,1330,139
19514,0,0,29,0,-29
19515,1,0,75,0,-75
19516,0,0,17,0,-17
19517,1,0,33,0,-33
19518,1,1,480,2459,1979
19519,1,0,22,0,-22
19520,1,1,467,1415,948
19521,1,1,142,1871,1729
19522,1,0,51,0,-51
19523,1,0,5,0,-5
19524,0,0,39,0,-39
19525,0,0,25,0,-25
19526,1,0,1,0,-1
19527,1,0,17,0,-17
19528,0,0,83,0,-83
19529,0,0,9,0,-9
19530,1,0,144,0,-144
19531,1,0,13,0,-13
19532,1,0,2,0,-2
19533,0,0,82,0,-82
19534,1,0,139,0,-139
19535,1,1,1199,1355,156
19536,0,0,58,0,-58
19537,1,0,18,0,-18
19538,1,1,463,1414,951
19539,0,0,8,0,-8
19540,1,0,18,0,-18
19541,1,1,314,1790,1476
19542,1,1,161,1304,1143
19543,1,0,25,0,-25
19544,1,0,99,0,-99
19545,0,0,8,0,-8
19546,1,0,42,0,-42
19547,0,0,2,0,-2
19548,1,0,27,0,-27
19549,1,0,1,0,-1
19550,1,0,24,0,-24
19551,1,1,1887,1297,-590
19552,1,1,399,2035,1636
19553,1,1,1280,2746,1466
19554,1,1,312,1410,1098
19555,1,0,2,0,-2
19556,0,0,53,0,-53
19557,1,1,236,1321,1085
19558,0,0,87,0,-87
19559,1,0,6,0,-6
19560,0,0,14,0,-14
19561,0,0,19,0,-19
19562,1,0,13,0,-13
19563,0,0,28,0,-28
19564,1,1,103,1245,1142
19565,1,0,20,0,-20
19566,1,0,73,0,-73
19567,0,0,3,0,-3
19568,0,0,2,0,-2
19569,1,1,93,1423,1330
19570,1,0,23,0,-23
19571,1,0,74,0,-74
19572,1,0,39,0,-39
19573,1,1,431,1490,1059
19574,1,1,546,1252,706
19575,0,0,38,0,-38
19576,1,0,72,0,-72
19577,1,0,16,0,-16
19578,1,1,75,1219,1144
19579,0,0,68,0,-68
19580,1,0,23,0,-23
19581,1,1,121,1794,1673
19582,1,0,112,0,-112
19583,1,1,806,1339,533
19584,1,0,9,0,-9
19585,1,0,24,0,-24
19586,1,0,31,0,-31
19587,1,0,71,0,-71
19588,1,1,1580,1357,-223
19589,1,0,265,0,-265
19590,1,1,592,1659,1067
19591,0,0,1,0,-1
19592,1,1,145,1867,1722
19593,1,0,29,0,-29
19594,1,0,6,0,-6
19595,1,0,43,0,-43
19596,0,0,202,0,-202
19597,1,1,277,1210,933
19598,0,0,51,0,-51
19599,1,0,60,0,-60
19600,0,0,3,0,-3
19601,0,0,34,0,-34
19602,1,1,55,1330,1275
19603,0,0,121,0,-121
19604,0,0,17,0,-17
19605,1,1,355,1487,1132
19606,1,1,119,1452,1333
19607,1,0,36,0,-36
19608,0,0,72,0,-72
19609,1,0,65,0,-65
19610,1,0,137,0,-137
19611,1,0,36,0,-36
19612,1,1,3297,1463,-1834
19613,1,1,51,2149,2098
19614,0,0,115,0,-115
19615,1,1,142,1344,1202
19616,0,0,31,0,-31
19617,0,0,263,0,-263
19618,1,0,48,0,-48
19619,0,0,118,0,-118
19620,0,0,132,0,-132
19621,1,0,20,0,-20
19622,1,1,1164,1369,205
19623,1,1,179,1309,1130
19624,1,1,751,1513,762
19625,1,0,189,0,-189
19626,0,0,70,0,-70
19627,1,0,37,0,-37
19628,0,0,101,0,-101
19629,0,0,32,0,-32
19630,0,0,140,0,-140
19631,0,0,101,0,-101
19632,1,0,98,0,-98
19633,0,0,25,0,-25
19634,0,0,22,0,-22
19635,1,0,46,0,-46
19636,1,0,38,0,-38
19637,1,0,1,0,-1
19638,1,1,936,2048,1112
19639,1,1,100,1509,1409
19640,0,0,2,0,-2
19641,1,0,30,0,-30
19642,1,1,99,1252,1153
19643,1,1,117,1676,1559
19644,1,1,929,1221,292
19645,0,0,54,0,-54
19646,1,1,138,1272,1134
19647,1,0,17,0,-17
19648,1,0,10,0,-10
19649,0,0,35,0,-35
19650,1,0,28,0,-28
19651,1,0,0,0,0
19652,1,1,1280,1524,244
19653,1,1,69,1372,1303
19654,0,0,59,0,-59
19655,0,0,8,0,-8
19656,0,0,62,0,-62
19657,1,1,97,1917,1820
19658,1,1,244,1322,1078
19659,1,0,116,0,-116
19660,0,0,36,0,-36
19661,1,0,84,0,-84
19662,1,1,563,1255,692
19663,0,0,27,0,-27
19664,1,0,37,0,-37
19665,1,0,2,0,-2
19666,1,0,49,0,-49
19667,1,1,176,1424,1248
19668,1,0,50,0,-50
19669,0,0,123,0,-123
19670,1,0,28,0,-28
19671,1,1,1112,1567,455
19672,0,0,78,0,-78
19673,1,1,681,2311,1630
19674,0,0,2,0,-2
19675,0,0,71,0,-71
19676,1,1,565,1627,1062
19677,0,0,31,0,-31
19678,1,0,147,0,-147
19679,0,0,50,0,-50
19680,0,0,0,0,0
19681,0,0,5,0,-5
19682,0,0,18,0,-18
19683,0,0,14,0,-14
19684,1,0,160,0,-160
19685,1,0,8,0,-8
19686,1,1,423,1367,944
19687,1,1,119,1356,1237
19688,1,1,288,2190,1902
19689,1,0,13,0,-13
19690,1,1,234,1444,1210
19691,0,0,110,0,-110
19692,0,0,123,0,-123
19693,1,0,4,0,-4
19694,1,1,409,2119,1710
19695,1,1,633,1474,841
19696,1,1,723,1319,596
19697,1,0,38,0,-38
19698,1,0,9,0,-9
19699,0,0,16,0,-16
19700,1,1,117,1402,1285
19701,0,0,6,0,-6
19702,0,0,2,0,-2
19703,1,0,78,0,-78
19704,1,1,106,2307,2201
19705,1,0,69,0,-69
19706,1,1,436,1728,1292
19707,1,0,23,0,-23
19708,0,0,64,0,-64
19709,1,1,239,1378,1139
19710,0,0,0,0,0
19711,1,1,85,1653,1568
19712,1,1,202,1630,1428
19713,1,1,278,1438,1160
19714,1,0,56,0,-56
19715,1,1,301,1574,1273
19716,1,1,828,1713,885
19717,1,0,17,0,-17
19718,1,1,1052,1551,499
19719,1,0,11,0,-11
19720,0,0,23,0,-23
19721,0,0,0,0,0
19722,1,0,22,0,-22
19723,0,0,0,0,0
19724,0,0,6,0,-6
19725,1,1,334,1330,996
19726,0,0,3,0,-3
19727,0,0,39,0,-39
19728,0,0,165,0,-165
19729,1,0,1,0,-1
19730,1,0,26,0,-26
19731,0,0,4,0,-4
19732,0,0,0,0,0
19733,1,0,59,0,-59
19734,1,1,68,1221,1153
19735,1,0,132,0,-132
19736,1,0,23,0,-23
19737,0,0,0,0,0
19738,0,0,64,0,-64
19739,1,1,157,1493,1336
19740,1,0,33,0,-33
19741,1,1,98,1269,1171
19742,1,1,723,1646,923
19743,1,0,19,0,-19
19744,1,0,8,0,-8
19745,1,0,23,0,-23
19746,1,1,77,1803,1726
19747,1,0,43,0,-43
19748,0,0,19,0,-19
19749,0,0,22,0,-22
19750,1,1,261,1991,1730
19751,0,0,19,0,-19
19752,0,0,473,0,-473
19753,1,0,23,0,-23
19754,0,0,52,0,-52
19755,0,0,36,0,-36
19756,1,1,177,2022,1845
19757,0,0,20,0,-20
19758,1,0,54,0,-54
19759,0,0,49,0,-49
19760,1,1,212,2263,2051
19761,0,0,30,0,-30
19762,1,1,299,1615,1316
19763,1,0,31,0,-31
19764,0,0,5,0,-5
19765,1,0,92,0,-92
19766,0,0,61,0,-61
19767,0,0,151,0,-151
19768,0,0,24,0,-24
19769,1,1,162,1261,1099
19770,0,0,9,0,-9
19771,1,0,125,0,-125
19772,1,1,1193,1349,156
19773,0,0,59,0,-59
19774,0,0,29,0,-29
19775,1,0,115,0,-115
19776,0,0,66,0,-66
19777,1,1,500,1477,977
19778,1,0,0,0,0
19779,1,0,46,0,-46
19780,1,1,547,1987,1440
19781,1,0,46,0,-46
19782,1,1,186,1588,1402
19783,1,1,1152,2619,1467
19784,0,0,15,0,-15
19785,0,0,73,0,-73
19786,0,0,23,0,-23
19787,0,0,24,0,-24
19788,1,0,43,0,-43
19789,0,0,49,0,-49
19790,1,1,1119,1621,502
19791,0,0,7,0,-7
19792,1,1,648,1265,617
19793,0,0,2,0,-2
19794,0,0,18,0,-18
19795,0,0,54,0,-54
19796,1,0,68,0,-68
19797,1,1,613,1297,684
19798,0,0,7,0,-7
19799,1,0,2,0,-2
19800,1,1,286,1285,999
19801,1,0,143,0,-143
19802,0,0,5,0,-5
19803,0,0,18,0,-18
19804,1,1,394,1540,1146
19805,0,0,4,0,-4
19806,1,0,46,0,-46
19807,0,0,137,0,-137
19808,0,0,21,0,-21
19809,1,1,379,2073,1694
19810,1,0,33,0,-33
19811,0,0,84,0,-84
19812,1,0,190,0,-190
19813,1,0,30,0,-30
19814,1,0,16,0,-16
19815,1,0,34,0,-34
19816,0,0,36,0,-36
19817,1,0,13,0,-13
19818,1,1,434,1335,901
19819,1,0,178,0,-178
19820,1,0,9,0,-9
19821,1,1,417,1248,831
19822,1,1,161,1643,1482
19823,0,0,16,0,-16
19824,1,0,57,0,-57
19825,1,0,96,0,-96
19826,0,0,20,0,-20
19827,1,0,4,0,-4
19828,1,1,2819,2210,-609
19829,1,1,191,1931,1740
19830,0,0,5,0,-5
19831,1,1,171,1308,1137
19832,1,1,728,1425,697
19833,0,0,35,0,-35
19834,0,0,18,0,-18
19835,0,0,10,0,-10
19836,0,0,24,0,-24
19837,0,0,46,0,-46
19838,1,1,312,1267,955
19839,1,0,86,0,-86
19840,1,1,2328,1376,-952
19841,1,1,98,1553,1455
19842,1,0,26,0,-26
19843,1,0,118,0,-118
19844,1,0,81,0,-81
19845,1,1,1548,4841,3293
19846,1,1,732,1227,495
19847,1,1,139,1498,1359
19848,0,0,11,0,-11
19849,1,0,105,0,-105
19850,1,1,194,1522,1328
19851,1,0,102,0,-102
19852,1,0,38,0,-38
19853,1,1,88,1311,1223
19854,1,1,674,1400,726
19855,1,0,50,0,-50
19856,1,1,97,1681,1584
19857,1,0,15,0,-15
19858,0,0,1,0,-1
19859,1,1,815,1696,881
19860,0,0,62,0,-62
19861,0,0,84,0,-84
19862,1,1,1124,1926,802
19863,1,0,92,0,-92
19864,0,0,6,0,-6
19865,1,0,16,0,-16
19866,1,0,83,0,-83
19867,1,0,15,0,-15
19868,0,0,35,0,-35
19869,1,1,116,1222,1106
19870,1,1,138,1630,1492
19871,0,0,42,0,-42
19872,0,0,33,0,-33
19873,1,0,62,0,-62
19874,0,0,82,0,-82
19875,1,1,825,1397,572
19876,0,0,42,0,-42
19877,1,1,26,1309,1283
19878,1,1,134,8215,8081
19879,1,1,619,1448,829
19880,0,0,38,0,-38
19881,1,0,4,0,-4
19882,1,1,703,1320,617
19883,0,0,40,0,-40
19884,1,1,188,2300,2112
19885,0,0,66,0,-66
19886,1,0,128,0,-128
19887,1,0,140,0,-140
19888,1,0,28,0,-28
19889,1,1,89,1339,1250
19890,0,0,57,0,-57
19891,0,0,35,0,-35
19892,1,0,135,0,-135
19893,1,1,551,1582,1031
19894,1,0,33,0,-33
19895,0,0,23,0,-23
19896,0,0,56,0,-56
19897,1,0,31,0,-31
19898,0,0,5,0,-5
19899,1,0,55,0,-55
19900,1,1,566,1880,1314
19901,1,0,0,0,0
19902,1,1,130,1301,1171
19903,1,0,102,0,-102
19904,1,0,41,0,-41
19905,1,1,21,2218,2197
19906,0,0,49,0,-49
19907,1,0,18,0,-18
19908,0,0,79,0,-79
19909,0,0,53,0,-53
19910,0,0,29,0,-29
19911,1,0,6,0,-6
19912,0,0,7,0,-7
19913,0,0,62,0,-62
19914,0,0,78,0,-78
19915,1,0,72,0,-72
19916,0,0,57,0,-57
19917,0,0,23,0,-23
19918,1,0,3,0,-3
19919,1,1,119,3226,3107
19920,0,0,37,0,-37
19921,0,0,198,0,-198
19922,0,0,7,0,-7
19923,0,0,16,0,-16
19924,0,0,1,0,-1
19925,1,1,1238,1784,546
19926,0,0,8,0,-8
19927,1,0,9,0,-9
19928,1,1,314,1439,1125
19929,1,1,951,1671,720
19930,1,1,337,2188,1851
19931,1,1,76,1547,1471
19932,1,1,436,1812,1376
19933,0,0,143,0,-143
19934,1,0,2,0,-2
19935,0,0,79,0,-79
19936,1,0,115,0,-115
19937,0,0,30,0,-30
19938,0,0,27,0,-27
19939,0,0,115,0,-115
19940,1,0,2,0,-2
19941,1,1,1796,1590,-206
19942,0,0,150,0,-150
19943,1,0,16,0,-16
19944,0,0,8,0,-8
19945,1,0,20,0,-20
19946,1,1,63,1477,1414
19947,0,0,184,0,-184
19948,1,0,39,0,-39
19949,1,1,592,1437,845
19950,1,0,25,0,-25
19951,1,1,950,1518,568
19952,1,0,23,0,-23
19953,0,0,1,0,-1
19954,1,1,150,2446,2296
19955,1,1,484,1470,986
19956,1,1,517,1988,1471
19957,1,1,208,1250,1042
19958,1,1,38,1249,1211
19959,0,0,0,0,0
19960,1,0,5,0,-5
19961,1,0,71,0,-71
19962,1,0,172,0,-172
19963,1,1,91,1685,1594
19964,1,0,4,0,-4
19965,1,0,16,0,-16
19966,0,0,87,0,-87
19967,0,0,2,0,-2
19968,1,0,9,0,-9
19969,1,1,241,1423,1182
19970,1,0,148,0,-148
19971,0,0,11,0,-11
19972,1,1,50,1858,1808
19973,0,0,32,0,-32
19974,0,0,58,0,-58
19975,1,1,302,1281,979
19976,0,0,2,0,-2
19977,0,0,97,0,-97
19978,0,0,0,0,0
19979,0,0,45,0,-45
19980,1,0,44,0,-44
19981,0,0,67,0,-67
19982,0,0,15,0,-15
19983,0,0,7,0,-7
19984,1,0,40,0,-40
19985,0,0,16,0,-16
19986,1,1,498,1390,892
19987,0,0,218,0,-218
19988,1,1,1044,1259,215
19989,1,1,249,1900,1651
19990,1,1,14,1538,1524
19991,0,0,46,0,-46
19992,1,1,893,1307,414
19993,0,0,88,0,-88
19994,1,0,9,0,-9
19995,1,1,189,1681,1492
19996,0,0,67,0,-67
19997,1,1,130,1961,1831
19998,1,0,56,0,-56
19999,1,1,117,1252,1135
20000,1,0,22,0,-22
20001,0,0,31,0,-31
20002,1,1,344,1339,995
20003,0,0,101,0,-101
20004,0,0,17,0,-17
20005,0,0,20,0,-20
20006,1,0,76,0,-76
20007,0,0,35,0,-35
20008,1,0,34,0,-34
20009,0,0,30,0,-30
20010,0,0,10,0,-10
20011,1,0,129,0,-129
20012,1,0,23,0,-23
20013,1,1,313,1820,1507
20014,1,1,571,2019,1448
20015,0,0,96,0,-96
20016,0,0,175,0,-175
20017,1,1,142,1322,1180
20018,1,1,1042,1225,183
20019,1,1,1707,1370,-337
20020,1,1,608,1313,705
20021,1,0,54,0,-54
20022,1,0,3,0,-3
20023,1,1,95,1412,1317
20024,1,1,1022,1204,182
20025,1,0,98,0,-98
20026,1,1,207,1787,1580
20027,0,0,27,0,-27
20028,0,0,9,0,-9
20029,0,0,3,0,-3
20030,0,0,6,0,-6
20031,1,1,630,1436,806
20032,0,0,26,0,-26
20033,0,0,127,0,-127
20034,0,0,41,0,-41
20035,1,1,658,2096,1438
20036,1,0,1,0,-1
20037,1,0,49,0,-49
20038,1,1,197,2320,2123
20039,1,1,166,1694,1528
20040,0,0,22,0,-22
20041,1,1,785,1234,449
20042,1,0,48,0,-48
20043,1,0,8,0,-8
20044,0,0,178,0,-178
20045,1,1,554,1203,649
20046,0,0,46,0,-46
20047,0,0,8,0,-8
20048,1,0,55,0,-55
20049,0,0,1,0,-1
20050,1,0,59,0,-59
20051,0,0,14,0,-14
20052,0,0,91,0,-91
20053,1,0,10,0,-10
20054,0,0,14,0,-14
20055,1,0,23,0,-23
20056,1,1,959,1571,612
20057,1,0,3,0,-3
20058,1,0,98,0,-98
20059,0,0,10,0,-10
20060,0,0,48,0,-48
20061,1,1,30,1308,1278
20062,1,1,88,1923,1835
20063,0,0,24,0,-24
20064,1,1,1115,1660,545
20065,0,0,254,0,-254
20066,1,0,5,0,-5
20067,1,1,226,1455,1229
20068,1,1,166,1589,1423
20069,0,0,5,0,-5
20070,0,0,6,0,-6
20071,0,0,40,0,-40
20072,1,1,31,1460,1429
20073,1,0,49,0,-49
20074,1,0,50,0,-50
20075,0,0,29,0,-29
20076,1,0,58,0,-58
20077,1,1,3108,1673,-1435
20078,0,0,23,0,-23
20079,0,0,11,0,-11
20080,1,0,119,0,-119
20081,0,0,49,0,-49
20082,1,0,46,0,-46
20083,1,1,1362,1473,111
20084,1,0,4,0,-4
20085,0,0,60,0,-60
20086,1,0,64,0,-64
20087,1,1,202,1349,1147
20088,1,0,78,0,-78
20089,1,0,136,0,-136
20090,1,1,1887,1298,-589
20091,1,1,1008,1420,412
20092,1,0,59,0,-59
20093,0,0,76,0,-76
20094,0,0,38,0,-38
20095,1,0,0,0,0
20096,0,0,94,0,-94
20097,1,1,503,1203,700
20098,0,0,28,0,-28
20099,1,0,126,0,-126
20100,1,1,420,2608,2188
20101,0,0,64,0,-64
20102,1,0,88,0,-88
20103,1,0,5,0,-5
20104,0,0,56,0,-56
20105,0,0,73,0,-73
20106,0,0,4,0,-4
20107,0,0,29,0,-29
20108,1,1,657,1201,544
20109,0,0,7,0,-7
20110,1,1,89,1254,1165
20111,0,0,23,0,-23
20112,1,1,1275,1502,227
20113,1,0,58,0,-58
20114,0,0,15,0,-15
20115,0,0,238,0,-238
20116,1,0,3,0,-3
20117,0,0,9,0,-9
20118,1,0,21,0,-21
20119,0,0,82,0,-82
20120,0,0,77,0,-77
20121,0,0,50,0,-50
20122,1,0,239,0,-239
20123,0,0,203,0,-203
20124,1,1,478,3461,2983
20125,1,1,670,1326,656
20126,1,0,40,0,-40
20127,1,1,563,2746,2183
20128,0,0,28,0,-28
20129,1,0,25,0,-25
20130,0,0,29,0,-29
20131,1,0,39,0,-39
20132,1,0,44,0,-44
20133,0,0,107,0,-107
20134,1,0,54,0,-54
20135,1,0,106,0,-106
20136,1,0,4,0,-4
20137,1,0,14,0,-14
20138,0,0,12,0,-12
20139,0,0,2,0,-2
20140,1,1,654,1818,1164
20141,1,0,177,0,-177
20142,0,0,10,0,-10
20143,1,0,3,0,-3
20144,1,0,104,0,-104
20145,1,0,62,0,-62
20146,0,0,208,0,-208
20147,1,0,36,0,-36
20148,1,1,913,1269,356
20149,1,0,161,0,-161
20150,1,1,935,1342,407
20151,0,0,101,0,-101
20152,1,1,786,1399,613
20153,1,1,153,1324,1171
20154,1,1,63,1338,1275
20155,0,0,114,0,-114
20156,1,0,0,0,0
20157,1,0,77,0,-77
20158,1,0,146,0,-146
20159,1,1,654,1312,658
20160,0,0,63,0,-63
20161,1,0,51,0,-51
20162,1,0,214,0,-214
20163,0,0,145,0,-145
20164,1,1,360,1279,919
20165,1,0,32,0,-32
20166,1,0,40,0,-40
20167,0,0,173,0,-173
20168,0,0,76,0,-76
20169,0,0,12,0,-12
20170,1,1,776,1271,495
20171,0,0,95,0,-95
20172,1,1,456,1427,971
20173,0,0,6,0,-6
20174,0,0,19,0,-19
20175,1,0,8,0,-8
20176,0,0,24,0,-24
20177,0,0,26,0,-26
20178,0,0,88,0,-88
20179,0,0,121,0,-121
20180,1,1,259,1686,1427
20181,0,0,28,0,-28
20182,0,0,21,0,-21
20183,0,0,146,0,-146
20184,0,0,11,0,-11
20185,0,0,29,0,-29
20186,0,0,1,0,-1
20187,0,0,21,0,-21
20188,1,1,98,1238,1140
20189,1,1,194,2745,2551
20190,0,0,1,0,-1
20191,1,0,37,0,-37
20192,0,0,52,0,-52
20193,1,1,229,1448,1219
20194,0,0,117,0,-117
20195,1,1,259,1204,945
20196,1,0,2,0,-2
20197,1,0,45,0,-45
20198,0,0,43,0,-43
20199,1,1,896,1215,319
20200,0,0,36,0,-36
20201,1,0,14,0,-14
20202,1,0,12,0,-12
20203,1,0,13,0,-13
20204,0,0,0,0,0
20205,1,0,102,0,-102
20206,1,1,376,1670,1294
20207,0,0,92,0,-92
20208,0,0,60,0,-60
20209,1,1,403,1442,1039
20210,1,0,204,0,-204
20211,1,0,18,0,-18
20212,1,0,50,0,-50
20213,0,0,148,0,-148
20214,1,0,47,0,-47
20215,0,0,58,0,-58
20216,0,0,26,0,-26
20217,1,1,91,1893,1802
20218,1,1,944,1232,288
20219,1,1,1042,1272,230
20220,1,1,203,1466,1263
20221,1,1,339,1276,937
20222,0,0,107,0,-107
20223,1,0,119,0,-119
20224,0,0,26,0,-26
20225,1,1,368,1213,845
20226,0,0,2,0,-2
20227,1,0,21,0,-21
20228,1,1,3149,1591,-1558
20229,1,1,221,1681,1460
20230,1,0,30,0,-30
20231,1,0,24,0,-24
20232,1,1,872,1291,419
20233,0,0,512,0,-512
20234,0,0,2,0,-2
20235,1,1,214,1737,1523
20236,0,0,1,0,-1
20237,1,1,388,1633,1245
20238,1,0,99,0,-99
20239,1,1,74,1316,1242
20240,0,0,60,0,-60
20241,1,0,28,0,-28
20242,0,0,0,0,0
20243,0,0,120,0,-120
20244,1,0,59,0,-59
20245,1,1,44,1390,1346
20246,1,1,460,1202,742
20247,1,1,251,1620,1369
20248,1,0,39,0,-39
20249,1,1,747,1655,908
20250,0,0,58,0,-58
20251,1,0,62,0,-62
20252,1,1,336,1372,1036
20253,1,0,137,0,-137
20254,0,0,36,0,-36
20255,1,0,31,0,-31
20256,0,0,38,0,-38
20257,0,0,34,0,-34
20258,0,0,11,0,-11
20259,1,1,430,1335,905
20260,0,0,16,0,-16
20261,0,0,120,0,-120
20262,1,1,744,1481,737
20263,1,0,9,0,-9
20264,1,1,717,1218,501
20265,1,0,43,0,-43
20266,1,1,136,1490,1354
20267,0,0,34,0,-34
20268,0,0,2,0,-2
20269,0,0,32,0,-32
20270,1,0,2,0,-2
20271,0,0,32,0,-32
20272,1,1,597,1490,893
20273,0,0,0,0,0
20274,0,0,3,0,-3
20275,1,0,53,0,-53
20276,0,0,27,0,-27
20277,1,1,159,1333,1174
20278,1,0,57,0,-57
20279,1,0,70,0,-70
20280,0,0,42,0,-42
20281,1,1,106,1290,1184
20282,0,0,92,0,-92
20283,1,0,11,0,-11
20284,0,0,1,0,-1
20285,1,1,90,1839,1749
20286,1,0,44,0,-44
20287,0,0,43,0,-43
20288,1,0,116,0,-116
20289,1,0,52,0,-52
20290,1,1,344,1672,1328
20291,1,1,754,1558,804
20292,0,0,11,0,-11
20293,0,0,82,0,-82
20294,0,0,7,0,-7
20295,0,0,20,0,-20
20296,0,0,8,0,-8
20297,1,0,11,0,-11
20298,0,0,76,0,-76
20299,0,0,111,0,-111
20300,1,1,273,1330,1057
20301,1,0,13,0,-13
20302,1,1,537,1896,1359
20303,0,0,48,0,-48
20304,1,0,90,0,-90
20305,1,0,59,0,-59
20306,0,0,51,0,-51
20307,0,0,27,0,-27
20308,0,0,3,0,-3
20309,1,0,27,0,-27
20310,1,0,68,0,-68
20311,1,0,11,0,-11
20312,1,1,158,1285,1127
20313,0,0,24,0,-24
20314,0,0,6,0,-6
20315,1,0,15,0,-15
20316,1,1,1281,1212,-69
20317,0,0,22,0,-22
20318,0,0,74,0,-74
20319,1,0,75,0,-75
20320,0,0,3,0,-3
20321,0,0,17,0,-17
20322,1,0,30,0,-30
20323,0,0,74,0,-74
20324,1,1,487,3253,2766
20325,0,0,33,0,-33
20326,1,0,22,0,-22
20327,1,0,13,0,-13
20328,1,1,586,2340,1754
20329,0,0,47,0,-47
20330,0,0,4,0,-4
20331,1,0,10,0,-10
20332,0,0,31,0,-31
20333,1,0,2,0,-2
20334,1,0,10,0,-10
20335,1,1,653,1429,776
20336,1,0,69,0,-69
20337,1,0,35,0,-35
20338,1,0,59,0,-59
20339,0,0,74,0,-74
20340,1,1,288,1540,1252
20341,0,0,38,0,-38
20342,0,0,250,0,-250
20343,0,0,75,0,-75
20344,0,0,8,0,-8
20345,0,0,18,0,-18
20346,0,0,22,0,-22
20347,0,0,23,0,-23
20348,1,1,108,1224,1116
20349,1,1,1242,1322,80
20350,0,0,76,0,-76
20351,1,0,14,0,-14
20352,1,0,20,0,-20
20353,0,0,40,0,-40
20354,0,0,47,0,-47
20355,1,1,2182,1302,-880
20356,0,0,6,0,-6
20357,0,0,54,0,-54
20358,1,1,385,1874,1489
20359,0,0,60,0,-60
20360,0,0,26,0,-26
20361,0,0,33,0,-33
20362,0,0,1,0,-1
20363,1,0,0,0,0
20364,0,0,215,0,-215
20365,0,0,387,0,-387
20366,1,0,21,0,-21
20367,1,0,24,0,-24
20368,0,0,83,0,-83
20369,1,1,291,1565,1274
20370,0,0,35,0,-35
20371,0,0,27,0,-27
20372,0,0,16,0,-16
20373,1,1,881,1219,338
20374,1,1,166,1322,1156
20375,1,1,1056,1467,411
20376,0,0,15,0,-15
20377,0,0,66,0,-66
20378,0,0,50,0,-50
20379,1,0,15,0,-15
20380,1,0,70,0,-70
20381,1,0,26,0,-26
20382,0,0,5,0,-5
20383,1,0,47,0,-47
20384,1,1,762,1328,566
20385,1,1,156,2339,2183
20386,1,1,670,1253,583
20387,0,0,23,0,-23
20388,0,0,81,0,-81
20389,0,0,30,0,-30
20390,1,1,963,1557,594
20391,1,1,567,1505,938
20392,0,0,13,0,-13
20393,0,0,205,0,-205
20394,0,0,6,0,-6
20395,1,1,192,1304,1112
20396,1,1,767,1506,739
20397,1,0,34,0,-34
20398,0,0,36,0,-36
20399,1,1,196,1400,1204
20400,1,1,501,1287,786
20401,1,0,17,0,-17
20402,0,0,14,0,-14
20403,0,0,147,0,-147
20404,1,1,403,1762,1359
20405,1,0,47,0,-47
20406,1,1,509,3332,2823
20407,1,0,46,0,-46
20408,0,0,27,0,-27
20409,0,0,14,0,-14
20410,1,0,152,0,-152
20411,0,0,42,0,-42
20412,0,0,6,0,-6
20413,1,1,132,1938,1806
20414,0,0,6,0,-6
20415,0,0,43,0,-43
20416,0,0,12,0,-12
20417,1,0,0,0,0
20418,1,0,60,0,-60
20419,0,0,8,0,-8
20420,1,1,1173,1220,47
20421,1,1,89,1210,1121
20422,0,0,52,0,-52
20423,0,0,104,0,-104
20424,1,1,620,1428,808
20425,0,0,12,0,-12
20426,0,0,183,0,-183
20427,1,1,472,1248,776
20428,1,1,241,6792,6551
20429,0,0,93,0,-93
20430,1,1,960,2636,1676
20431,1,0,36,0,-36
20432,0,0,55,0,-55
20433,1,1,1223,3623,2400
20434,0,0,1,0,-1
20435,0,0,135,0,-135
20436,0,0,7,0,-7
20437,1,0,58,0,-58
20438,0,0,165,0,-165
20439,1,1,1014,1268,254
20440,1,1,212,1414,1202
20441,1,1,799,4905,4106
20442,1,1,263,1349,1086
20443,0,0,29,0,-29
20444,0,0,53,0,-53
20445,0,0,44,0,-44
20446,0,0,17,0,-17
20447,1,1,1211,1712,501
20448,1,0,35,0,-35
20449,1,0,24,0,-24
20450,0,0,41,0,-41
20451,0,0,116,0,-116
20452,0,0,5,0,-5
20453,1,1,196,1287,1091
20454,1,1,1962,1276,-686
20455,0,0,24,0,-24
20456,1,1,405,2583,2178
20457,0,0,184,0,-184
20458,1,0,51,0,-51
20459,0,0,14,0,-14
20460,1,0,43,0,-43
20461,1,1,279,1876,1597
20462,1,1,838,1238,400
20463,1,0,29,0,-29
20464,0,0,58,0,-58
20465,1,0,31,0,-31
20466,1,1,426,1609,1183
20467,1,1,351,1924,1573
20468,1,1,1446,2849,1403
20469,1,1,301,1223,922
20470,1,1,15,1313,1298
20471,1,0,17,0,-17
20472,1,0,4,0,-4
20473,1,1,150,1267,1117
20474,1,0,186,0,-186
20475,0,0,13,0,-13
20476,0,0,92,0,-92
20477,1,0,227,0,-227
20478,0,0,2,0,-2
20479,0,0,19,0,-19
20480,1,1,514,1327,813
20481,1,1,246,1965,1719
20482,1,1,495,1389,894
20483,0,0,27,0,-27
20484,1,1,410,1366,956
20485,1,1,874,1300,426
20486,1,1,203,1221,1018
20487,1,0,17,0,-17
20488,1,1,1521,1712,191
20489,1,0,24,0,-24
20490,0,0,18,0,-18
20491,1,1,888,1398,510
20492,1,1,264,1287,1023
20493,1,0,54,0,-54
20494,0,0,54,0,-54
20495,1,1,669,1320,651
20496,1,1,206,1973,1767
20497,1,0,15,0,-15
20498,1,1,439,1705,1266
20499,1,0,23,0,-23
20500,1,0,51,0,-51
20501,0,0,15,0,-15
20502,1,1,1255,1634,379
20503,1,1,255,1491,1236
20504,0,0,110,0,-110
20505,0,0,5,0,-5
20506,1,0,28,0,-28
20507,1,1,349,1592,1243
20508,0,0,35,0,-35
20509,1,1,1490,1492,2
20510,1,0,0,0,0
20511,0,0,85,0,-85
20512,0,0,7,0,-7
20513,1,0,92,0,-92
20514,1,1,474,1450,976
20515,0,0,48,0,-48
20516,0,0,38,0,-38
20517,1,1,1809,1311,-498
20518,1,1,165,1764,1599
20519,1,1,1492,1203,-289
20520,1,1,599,1254,655
20521,1,0,180,0,-180
20522,1,0,112,0,-112
20523,1,1,740,1274,534
20524,1,0,166,0,-166
20525,1,1,287,1461,1174
20526,0,0,26,0,-26
20527,1,0,11,0,-11
20528,1,1,168,1650,1482
20529,1,0,114,0,-114
20530,1,0,32,0,-32
20531,1,0,112,0,-112
20532,1,0,5,0,-5
20533,1,1,195,1711,1516
20534,1,1,803,1658,855
20535,1,1,801,1715,914
20536,1,1,580,1446,866
20537,1,1,625,1637,1012
20538,1,0,35,0,-35
20539,0,0,20,0,-20
20540,1,0,18,0,-18
20541,1,1,1246,1380,134
20542,0,0,3,0,-3
20543,1,1,307,1385,1078
20544,0,0,6,0,-6
20545,0,0,4,0,-4
20546,1,1,227,1460,1233
20547,1,1,150,1691,1541
20548,0,0,17,0,-17
20549,0,0,1,0,-1
20550,1,0,4,0,-4
20551,0,0,1,0,-1
20552,0,0,14,0,-14
20553,0,0,27,0,-27
20554,1,0,90,0,-90
20555,1,1,356,1326,970
20556,1,0,40,0,-40
20557,1,1,1645,1446,-199
20558,1,0,39,0,-39
20559,1,0,71,0,-71
20560,0,0,9,0,-9
20561,1,0,32,0,-32
20562,0,0,27,0,-27
20563,1,1,88,1568,1480
20564,1,0,68,0,-68
20565,1,0,96,0,-96
20566,1,0,54,0,-54
20567,1,0,17,0,-17
20568,0,0,8,0,-8
20569,0,0,39,0,-39
20570,1,0,58,0,-58
20571,1,1,237,1804,1567
20572,0,0,164,0,-164
20573,1,0,133,0,-133
20574,0,0,8,0,-8
20575,0,0,35,0,-35
20576,0,0,73,0,-73
20577,0,0,48,0,-48
20578,1,1,650,1495,845
20579,1,0,41,0,-41
20580,0,0,19,0,-19
20581,1,0,85,0,-85
20582,1,0,178,0,-178
20583,0,0,91,0,-91
20584,1,0,3,0,-3
20585,1,0,144,0,-144
20586,1,1,799,1571,772
20587,0,0,4,0,-4
20588,1,1,131,1252,1121
20589,1,0,27,0,-27
20590,1,1,420,1412,992
20591,1,1,483,1207,724
20592,1,0,13,0,-13
20593,1,0,182,0,-182
20594,1,1,278,1974,1696
20595,0,0,107,0,-107
20596,0,0,32,0,-32
20597,0,0,71,0,-71
20598,1,1,1409,1402,-7
20599,1,1,1086,1367,281
20600,0,0,142,0,-142
20601,1,0,67,0,-67
20602,1,0,104,0,-104
20603,0,0,132,0,-132
20604,1,0,24,0,-24
20605,1,0,32,0,-32
20606,0,0,184,0,-184
20607,1,0,8,0,-8
20608,0,0,33,0,-33
20609,0,0,10,0,-10
20610,0,0,10,0,-10
20611,1,1,367,1201,834
20612,1,1,641,1759,1118
20613,0,0,12,0,-12
20614,1,1,480,1685,1205
20615,0,0,90,0,-90
20616,1,1,1556,1779,223
20617,0,0,31,0,-31
20618,0,0,46,0,-46
20619,1,0,33,0,-33
20620,0,0,32,0,-32
20621,1,0,12,0,-12
20622,1,1,683,1262,579
20623,1,1,2052,1970,-82
20624,1,0,44,0,-44
20625,1,1,152,1902,1750
20626,0,0,6,0,-6
20627,0,0,21,0,-21
20628,1,1,208,1700,1492
20629,0,0,16,0,-16
20630,0,0,21,0,-21
20631,1,0,4,0,-4
20632,1,1,1480,1336,-144
20633,1,1,68,1573,1505
20634,1,0,20,0,-20
20635,1,1,307,1349,1042
20636,1,1,1199,1419,220
20637,1,1,2135,2465,330
20638,1,0,120,0,-120
20639,0,0,64,0,-64
20640,1,1,404,1479,1075
20641,1,1,877,1267,390
20642,0,0,69,0,-69
20643,1,0,158,0,-158
20644,0,0,4,0,-4
20645,0,0,126,0,-126
20646,1,1,980,1264,284
20647,1,1,101,1995,1894
20648,1,0,77,0,-77
20649,1,1,84,1373,1289
20650,1,0,39,0,-39
20651,1,0,33,0,-33
20652,1,1,809,1291,482
20653,1,0,97,0,-97
20654,0,0,29,0,-29
20655,0,0,18,0,-18
20656,1,0,102,0,-102
20657,0,0,16,0,-16
20658,1,1,909,2271,1362
20659,0,0,27,0,-27
20660,0,0,10,0,-10
20661,1,1,197,1381,1184
20662,1,1,100,2007,1907
20663,1,1,519,1888,1369
20664,0,0,41,0,-41
20665,1,1,356,1316,960
20666,1,0,46,0,-46
20667,0,0,89,0,-89
20668,0,0,49,0,-49
20669,0,0,55,0,-55
20670,1,1,558,2015,1457
20671,0,0,41,0,-41
20672,0,0,1,0,-1
20673,1,1,2288,1321,-967
20674,1,0,114,0,-114
20675,1,0,7,0,-7
20676,0,0,15,0,-15
20677,1,1,336,1481,1145
20678,1,0,5,0,-5
20679,1,1,486,2800,2314
20680,0,0,25,0,-25
20681,1,0,15,0,-15
20682,1,1,550,1334,784
20683,1,1,165,1323,1158
20684,0,0,45,0,-45
20685,1,0,13,0,-13
20686,1,1,2154,1364,-790
20687,1,1,356,1228,872
20688,1,1,488,1259,771
20689,1,1,312,1959,1647
20690,0,0,25,0,-25
20691,0,0,128,0,-128
20692,0,0,57,0,-57
20693,1,1,234,1637,1403
20694,1,0,67,0,-67
20695,1,0,51,0,-51
20696,0,0,47,0,-47
20697,1,0,100,0,-100
20698,0,0,3,0,-3
20699,1,1,572,1399,827
20700,1,0,70,0,-70
20701,1,0,33,0,-33
20702,1,1,110,1446,1336
20703,1,0,14,0,-14
20704,1,1,113,1406,1293
20705,1,1,340,1732,1392
20706,1,0,41,0,-41
20707,0,0,50,0,-50
20708,1,1,114,1266,1152
20709,0,0,33,0,-33
20710,0,0,96,0,-96
20711,0,0,61,0,-61
20712,1,0,20,0,-20
20713,1,1,195,1843,1648
20714,1,1,426,1396,970
20715,0,0,66,0,-66
20716,1,0,25,0,-25
20717,1,1,498,1338,840
20718,0,0,127,0,-127
20719,1,1,1049,1295,246
20720,0,0,12,0,-12
20721,1,1,554,1666,1112
20722,1,1,116,1986,1870
20723,0,0,51,0,-51
20724,0,0,28,0,-28
20725,1,1,599,2431,1832
20726,1,0,5,0,-5
20727,1,0,8,0,-8
20728,1,1,526,1237,711
20729,0,0,15,0,-15
20730,0,0,47,0,-47
20731,1,0,26,0,-26
20732,1,0,72,0,-72
20733,0,0,0,0,0
20734,1,0,90,0,-90
20735,0,0,56,0,-56
20736,1,1,866,2924,2058
20737,0,0,8,0,-8
20738,0,0,40,0,-40
20739,1,0,4,0,-4
20740,0,0,23,0,-23
20741,1,1,516,3214,2698
20742,0,0,42,0,-42
20743,1,1,293,1760,1467
20744,1,1,208,1354,1146
20745,0,0,1,0,-1
20746,1,0,82,0,-82
20747,1,0,1,0,-1
20748,1,1,1203,1631,428
20749,1,0,39,0,-39
20750,0,0,227,0,-227
20751,0,0,39,0,-39
20752,1,1,306,1407,1101
20753,1,0,36,0,-36
20754,0,0,3,0,-3
20755,0,0,31,0,-31
20756,1,0,12,0,-12
20757,0,0,102,0,-102
20758,1,0,136,0,-136
20759,0,0,19,0,-19
20760,1,0,69,0,-69
20761,1,1,431,1374,943
20762,0,0,89,0,-89
20763,1,1,655,1743,1088
20764,0,0,30,0,-30
20765,1,0,96,0,-96
20766,0,0,15,0,-15
20767,1,0,50,0,-50
20768,1,1,16,1288,1272
20769,1,1,1172,1227,55
20770,1,1,32,2516,2484
20771,1,0,173,0,-173
20772,0,0,84,0,-84
20773,1,0,13,0,-13
20774,1,0,39,0,-39
20775,1,1,1168,2216,1048
20776,1,0,11,0,-11
20777,0,0,140,0,-140
20778,1,1,220,2009,1789
20779,1,1,264,1324,1060
20780,1,0,177,0,-177
20781,0,0,4,0,-4
20782,1,0,1,0,-1
20783,1,0,16,0,-16
20784,1,0,59,0,-59
20785,1,0,2,0,-2
20786,1,1,90,1215,1125
20787,0,0,3,0,-3
20788,1,0,40,0,-40
20789,1,0,26,0,-26
20790,1,1,526,1588,1062
20791,1,0,59,0,-59
20792,0,0,1,0,-1
20793,1,1,324,1211,887
20794,0,0,15,0,-15
20795,1,1,406,1265,859
20796,1,1,628,1732,1104
20797,0,0,18,0,-18
20798,1,0,94,0,-94
20799,1,1,202,1275,1073
20800,0,0,23,0,-23
20801,1,1,592,1377,785
20802,1,0,75,0,-75
20803,1,1,960,1894,934
20804,1,1,104,1631,1527
20805,0,0,9,0,-9
20806,1,0,22,0,-22
20807,1,1,245,1783,1538
20808,1,0,2,0,-2
20809,1,1,1104,1538,434
20810,0,0,27,0,-27
20811,0,0,174,0,-174
20812,1,1,1448,1369,-79
20813,1,0,59,0,-59
20814,1,0,45,0,-45
20815,1,0,142,0,-142
20816,0,0,26,0,-26
20817,0,0,87,0,-87
20818,1,0,9,0,-9
20819,1,1,94,2184,2090
20820,0,0,96,0,-96
20821,0,0,12,0,-12
20822,0,0,17,0,-17
20823,1,1,79,1261,1182
20824,1,0,262,0,-262
20825,0,0,4,0,-4
20826,0,0,8,0,-8
20827,1,1,602,1574,972
20828,0,0,80,0,-80
20829,1,1,99,1298,1199
20830,1,1,101,1265,1164
20831,1,0,60,0,-60
20832,0,0,195,0,-195
20833,1,0,20,0,-20
20834,1,1,672,1221,549
20835,0,0,41,0,-41
20836,1,0,69,0,-69
20837,1,0,13,0,-13
20838,1,0,40,0,-40
20839,1,1,1344,1356,12
20840,0,0,20,0,-20
20841,0,0,8,0,-8
20842,0,0,23,0,-23
20843,1,0,329,0,-329
20844,0,0,32,0,-32
20845,0,0,10,0,-10
20846,0,0,42,0,-42
20847,0,0,4,0,-4
20848,1,0,14,0,-14
20849,1,0,27,0,-27
20850,0,0,115,0,-115
20851,1,1,673,1287,614
20852,0,0,23,0,-23
20853,1,0,12,0,-12
20854,1,1,365,1388,1023
20855,1,0,7,0,-7
20856,0,0,1,0,-1
20857,0,0,75,0,-75
20858,1,1,961,1984,1023
20859,1,0,1,0,-1
20860,0,0,6,0,-6
20861,1,1,468,1332,864
20862,0,0,9,0,-9
20863,1,1,1857,1280,-577
20864,1,1,788,1344,556
20865,1,1,551,1280,729
20866,1,0,67,0,-67
20867,1,0,37,0,-37
20868,1,1,147,2403,2256
20869,0,0,11,0,-11
20870,0,0,147,0,-147
20871,1,0,1,0,-1
20872,1,1,1260,1307,47
20873,1,0,18,0,-18
20874,1,1,323,1290,967
20875,1,0,6,0,-6
20876,1,0,32,0,-32
20877,1,1,266,1214,948
20878,1,0,20,0,-20
20879,0,0,25,0,-25
20880,0,0,11,0,-11
20881,1,0,104,0,-104
20882,1,0,27,0,-27
20883,0,0,15,0,-15
20884,0,0,32,0,-32
20885,1,0,72,0,-72
20886,0,0,64,0,-64
20887,0,0,123,0,-123
20888,0,0,62,0,-62
20889,0,0,72,0,-72
20890,0,0,32,0,-32
20891,0,0,21,0,-21
20892,1,1,550,1797,1247
20893,1,1,45,1222,1177
20894,1,0,66,0,-66
20895,1,0,54,0,-54
20896,1,0,40,0,-40
20897,0,0,124,0,-124
20898,1,0,30,0,-30
20899,1,0,6,0,-6
20900,1,0,9,0,-9
20901,0,0,109,0,-109
20902,1,1,154,2168,2014
20903,1,1,49,1314,1265
20904,0,0,17,0,-17
20905,1,0,84,0,-84
20906,1,0,3,0,-3
20907,0,0,24,0,-24
20908,1,0,39,0,-39
20909,0,0,92,0,-92
20910,0,0,21,0,-21
20911,1,0,6,0,-6
20912,1,0,44,0,-44
20913,0,0,116,0,-116
20914,1,0,38,0,-38
20915,1,1,262,1682,1420
20916,0,0,4,0,-4
20917,1,1,111,2821,2710
20918,0,0,15,0,-15
20919,1,0,31,0,-31
20920,1,1,110,1345,1235
20921,1,1,230,1255,1025
20922,1,1,238,2293,2055
20923,0,0,1,0,-1
20924,1,0,95,0,-95
20925,0,0,42,0,-42
20926,1,0,153,0,-153
20927,0,0,55,0,-55
20928,1,1,310,1545,1235
20929,1,0,36,0,-36
20930,1,0,10,0,-10
20931,1,1,138,1350,1212
20932,0,0,113,0,-113
20933,0,0,3,0,-3
20934,1,1,199,1257,1058
20935,1,1,179,1941,1762
20936,1,1,842,2115,1273
20937,1,1,127,2290,2163
20938,0,0,57,0,-57
20939,1,1,469,1419,950
20940,1,0,50,0,-50
20941,0,0,30,0,-30
20942,1,1,209,2107,1898
20943,1,1,329,1231,902
20944,0,0,48,0,-48
20945,0,0,24,0,-24
20946,1,1,501,1257,756
20947,1,1,170,1309,1139
20948,1,1,129,1310,1181
20949,0,0,73,0,-73
20950,0,0,46,0,-46
20951,1,0,35,0,-35
20952,0,0,27,0,-27
20953,1,1,61,1692,1631
20954,0,0,25,0,-25
20955,1,0,13,0,-13
20956,0,0,8,0,-8
20957,0,0,10,0,-10
20958,1,0,62,0,-62
20959,1,0,54,0,-54
20960,0,0,52,0,-52
20961,1,0,5,0,-5
20962,1,0,21,0,-21
20963,1,1,583,1638,1055
20964,0,0,11,0,-11
20965,1,0,237,0,-237
20966,0,0,66,0,-66
20967,0,0,96,0,-96
20968,1,1,1272,1324,52
20969,0,0,156,0,-156
20970,0,0,2,0,-2
20971,0,0,53,0,-53
20972,1,1,2574,1393,-1181
20973,1,0,2,0,-2
20974,1,1,173,1308,1135
20975,0,0,40,0,-40
20976,0,0,0,0,0
20977,0,0,27,0,-27
20978,0,0,10,0,-10
20979,0,0,79,0,-79
20980,0,0,15,0,-15
20981,0,0,45,0,-45
20982,1,1,133,1355,1222
20983,0,0,181,0,-181
20984,1,0,14,0,-14
20985,0,0,9,0,-9
20986,0,0,31,0,-31
20987,1,1,933,1552,619
20988,1,0,8,0,-8
20989,0,0,22,0,-22
20990,1,1,823,1548,725
20991,0,0,33,0,-33
20992,1,0,29,0,-29
20993,0,0,7,0,-7
20994,0,0,45,0,-45
20995,1,0,13,0,-13
20996,0,0,28,0,-28
20997,1,1,56,1222,1166
20998,1,0,7,0,-7
20999,0,0,14,0,-14
21000,1,1,1183,1395,212
21001,1,0,10,0,-10
21002,0,0,108,0,-108
21003,0,0,47,0,-47
21004,0,0,66,0,-66
21005,0,0,188,0,-188
21006,1,0,36,0,-36
21007,0,0,12,0,-12
21008,1,1,1389,1387,-2
21009,1,0,24,0,-24
21010,0,0,48,0,-48
21011,1,0,154,0,-154
21012,1,0,3,0,-3
21013,0,0,38,0,-38
21014,1,0,27,0,-27
21015,0,0,39,0,-39
21016,1,1,528,1323,795
21017,0,0,5,0,-5
21018,1,1,727,1276,549
21019,0,0,26,0,-26
21020,0,0,40,0,-40
21021,1,0,32,0,-32
21022,1,0,44,0,-44
21023,1,1,263,1266,1003
21024,1,1,905,1994,1089
21025,0,0,42,0,-42
21026,1,1,791,1251,460
21027,1,0,80,0,-80
21028,0,0,19,0,-19
21029,1,1,1080,1369,289
21030,1,0,15,0,-15
21031,0,0,51,0,-51
21032,1,0,1,0,-1
21033,0,0,8,0,-8
21034,1,1,794,1489,695
21035,0,0,60,0,-60
21036,0,0,31,0,-31
21037,0,0,40,0,-40
21038,0,0,179,0,-179
21039,1,1,1374,1553,179
21040,1,0,29,0,-29
21041,1,0,58,0,-58
21042,1,0,30,0,-30
21043,0,0,149,0,-149
21044,0,0,197,0,-197
21045,1,1,480,1269,789
21046,0,0,64,0,-64
21047,1,0,17,0,-17
21048,0,0,28,0,-28
21049,0,0,26,0,-26
21050,0,0,81,0,-81
21051,0,0,94,0,-94
21052,0,0,43,0,-43
21053,0,0,20,0,-20
21054,1,1,707,1859,1152
21055,0,0,19,0,-19
21056,1,1,2463,1320,-1143
21057,1,1,423,1520,1097
21058,0,0,32,0,-32
21059,1,0,8,0,-8
21060,1,1,41,1992,1951
21061,1,1,1486,1539,53
21062,0,0,94,0,-94
21063,0,0,91,0,-91
21064,1,1,277,2480,2203
21065,1,1,125,2863,2738
21066,0,0,7,0,-7
21067,1,0,44,0,-44
21068,1,0,51,0,-51
21069,1,1,391,1205,814
21070,0,0,71,0,-71
21071,1,1,606,1770,1164
21072,1,0,20,0,-20
21073,0,0,28,0,-28
21074,0,0,16,0,-16
21075,1,1,444,1405,961
21076,1,0,81,0,-81
21077,1,0,0,0,0
21078,0,0,65,0,-65
21079,1,1,864,1254,390
21080,1,1,154,1227,1073
21081,0,0,33,0,-33
21082,0,0,12,0,-12
21083,1,0,71,0,-71
21084,0,0,72,0,-72
21085,0,0,13,0,-13
21086,1,0,67,0,-67
21087,1,0,51,0,-51
21088,0,0,39,0,-39
21089,0,0,106,0,-106
21090,1,0,108,0,-108
21091,1,0,96,0,-96
21092,1,1,219,1260,1041
21093,0,0,17,0,-17
21094,0,0,123,0,-123
21095,0,0,43,0,-43
21096,0,0,13,0,-13
21097,0,0,3,0,-3
21098,0,0,43,0,-43
21099,0,0,24,0,-24
21100,0,0,37,0,-37
21101,1,1,656,1331,675
21102,0,0,47,0,-47
21103,1,1,183,1289,1106
21104,1,0,114,0,-114
21105,1,1,134,1397,1263
21106,1,0,28,0,-28
21107,1,0,42,0,-42
21108,0,0,123,0,-123
21109,1,1,101,2042,1941
21110,0,0,4,0,-4
21111,1,1,195,1691,1496
21112,1,0,26,0,-26
21113,0,0,41,0,-41
21114,0,0,38,0,-38
21115,0,0,14,0,-14
21116,0,0,152,0,-152
21117,1,0,182,0,-182
21118,0,0,13,0,-13
21119,0,0,30,0,-30
21120,1,0,119,0,-119
21121,1,1,190,1396,1206
21122,1,0,10,0,-10
21123,1,0,4,0,-4
21124,0,0,44,0,-44
21125,1,0,44,0,-44
21126,0,0,36,0,-36
21127,1,0,0,0,0
21128,1,0,10,0,-10
21129,0,0,31,0,-31
21130,0,0,29,0,-29
21131,1,1,419,1660,1241
21132,1,1,129,1235,1106
21133,0,0,39,0,-39
21134,1,0,152,0,-152
21135,1,1,1123,1607,484
21136,0,0,79,0,-79
21137,0,0,62,0,-62
21138,0,0,66,0,-66
21139,1,0,63,0,-63
21140,1,1,1888,1567,-321
21141,1,1,1208,1637,429
21142,1,0,100,0,-100
21143,1,1,1707,1839,132
21144,1,1,290,1413,1123
21145,0,0,87,0,-87
21146,0,0,16,0,-16
21147,1,0,4,0,-4
21148,0,0,34,0,-34
21149,1,1,345,1224,879
21150,0,0,2,0,-2
21151,1,0,2,0,-2
21152,1,0,19,0,-19
21153,0,0,46,0,-46
21154,1,1,287,2060,1773
21155,1,0,84,0,-84
21156,1,0,0,0,0
21157,0,0,30,0,-30
21158,0,0,75,0,-75
21159,1,1,2071,1515,-556
21160,1,1,391,1363,972
21161,1,0,136,0,-136
21162,1,1,548,2180,1632
21163,0,0,1,0,-1
21164,1,1,282,1281,999
21165,1,0,94,0,-94
21166,0,0,3,0,-3
21167,0,0,107,0,-107
21168,1,1,200,2328,2128
21169,0,0,6,0,-6
21170,1,0,47,0,-47
21171,0,0,19,0,-19
21172,1,0,16,0,-16
21173,1,1,279,1661,1382
21174,1,0,66,0,-66
21175,0,0,102,0,-102
21176,1,0,106,0,-106
21177,0,0,57,0,-57
21178,1,0,33,0,-33
21179,1,1,386,1866,1480
21180,1,1,278,1226,948
21181,1,1,140,1360,1220
21182,1,0,119,0,-119
21183,1,0,42,0,-42
21184,1,1,30,1766,1736
21185,0,0,1,0,-1
21186,1,1,43,1334,1291
21187,0,0,58,0,-58
21188,1,0,12,0,-12
21189,1,0,65,0,-65
21190,0,0,90,0,-90
21191,1,0,13,0,-13
21192,1,1,732,1311,579
21193,0,0,2,0,-2
21194,1,1,89,2147,2058
21195,1,0,10,0,-10
21196,0,0,107,0,-107
21197,1,1,1371,1635,264
21198,1,0,16,0,-16
21199,1,0,2,0,-2
21200,1,0,2,0,-2
21201,1,1,335,1215,880
21202,1,0,11,0,-11
21203,0,0,52,0,-52
21204,1,0,47,0,-47
21205,1,1,246,1542,1296
21206,0,0,16,0,-16
21207,1,1,539,1231,692
21208,0,0,146,0,-146
21209,1,0,12,0,-12
21210,0,0,106,0,-106
21211,1,0,55,0,-55
21212,1,1,177,1267,1090
21213,0,0,25,0,-25
21214,1,0,47,0,-47
21215,1,1,1147,2688,1541
21216,1,0,105,0,-105
21217,1,0,38,0,-38
21218,0,0,32,0,-32
21219,0,0,23,0,-23
21220,1,1,194,1229,1035
21221,1,1,421,2139,1718
21222,1,1,48,1718,1670
21223,0,0,62,0,-62
21224,1,1,122,1253,1131
21225,0,0,89,0,-89
21226,1,0,57,0,-57
21227,1,1,376,11000,10624
21228,1,0,51,0,-51
21229,0,0,3,0,-3
21230,1,0,9,0,-9
21231,0,0,19,0,-19
21232,0,0,53,0,-53
21233,0,0,63,0,-63
21234,0,0,18,0,-18
21235,1,0,49,0,-49
21236,1,1,1237,1264,27
21237,1,0,61,0,-61
21238,1,1,458,1204,746
21239,1,0,16,0,-16
21240,0,0,134,0,-134
21241,1,0,16,0,-16
21242,1,0,25,0,-25
21243,1,1,476,1225,749
21244,1,1,458,1969,1511
21245,1,1,505,1587,1082
21246,1,0,5,0,-5
21247,1,1,1441,1332,-109
21248,1,0,10,0,-10
21249,0,0,126,0,-126
21250,1,1,893,1327,434
21251,0,0,67,0,-67
21252,0,0,69,0,-69
21253,1,0,17,0,-17
21254,1,1,202,1289,1087
21255,1,0,41,0,-41
21256,0,0,30,0,-30
21257,0,0,271,0,-271
21258,1,0,89,0,-89
21259,0,0,89,0,-89
21260,1,1,292,1321,1029
21261,1,1,330,1915,1585
21262,0,0,44,0,-44
21263,1,1,370,1244,874
21264,1,1,812,2688,1876
21265,0,0,14,0,-14
21266,1,1,871,1962,1091
21267,0,0,36,0,-36
21268,1,1,23,1448,1425
21269,1,1,398,2343,1945
21270,1,0,34,0,-34
21271,1,0,37,0,-37
21272,1,1,100,1807,1707
21273,0,0,96,0,-96
21274,1,1,364,1203,839
21275,1,0,10,0,-10
21276,1,0,8,0,-8
21277,1,0,139,0,-139
21278,1,1,2063,1441,-622
21279,0,0,65,0,-65
21280,0,0,33,0,-33
21281,1,1,522,2329,1807
21282,0,0,26,0,-26
21283,1,0,27,0,-27
21284,1,1,732,1382,650
21285,0,0,35,0,-35
21286,1,0,20,0,-20
21287,1,1,116,2507,2391
21288,0,0,34,0,-34
21289,1,0,46,0,-46
21290,1,0,59,0,-59
21291,1,1,290,1358,1068
21292,1,1,526,1247,721
21293,1,0,76,0,-76
21294,0,0,1,0,-1
21295,1,1,870,1255,385
21296,1,0,8,0,-8
21297,1,1,100,1258,1158
21298,1,1,539,3933,3394
21299,0,0,67,0,-67
21300,0,0,88,0,-88
21301,1,1,232,1633,1401
21302,0,0,11,0,-11
21303,1,1,684,2400,1716
21304,1,0,79,0,-79
21305,1,1,625,1632,1007
21306,1,0,2,0,-2
21307,0,0,27,0,-27
21308,1,0,169,0,-169
21309,0,0,73,0,-73
21310,0,0,69,0,-69
21311,0,0,69,0,-69
21312,1,1,82,1503,1421
21313,0,0,27,0,-27
21314,1,1,297,1213,916
21315,0,0,9,0,-9
21316,1,1,907,1225,318
21317,1,1,636,1235,599
21318,1,1,119,1453,1334
21319,1,0,30,0,-30
21320,0,0,37,0,-37
21321,0,0,0,0,0
21322,1,1,327,1307,980
21323,0,0,84,0,-84
21324,0,0,13,0,-13
21325,0,0,27,0,-27
21326,1,1,320,1549,1229
21327,1,0,8,0,-8
21328,1,1,589,1275,686
21329,1,1,764,2653,1889
21330,0,0,4,0,-4
21331,1,0,13,0,-13
21332,1,0,135,0,-135
21333,1,1,76,1351,1275
21334,1,0,12,0,-12
21335,0,0,20,0,-20
21336,0,0,16,0,-16
21337,0,0,31,0,-31
21338,1,1,308,1369,1061
21339,1,1,680,1995,1315
21340,1,1,149,1351,1202
21341,0,0,149,0,-149
21342,1,0,25,0,-25
21343,0,0,25,0,-25
21344,1,1,1370,1467,97
21345,0,0,29,0,-29
21346,1,1,1344,2527,1183
21347,0,0,115,0,-115
21348,0,0,60,0,-60
21349,0,0,14,0,-14
21350,1,1,660,3714,3054
21351,1,1,446,2344,1898
21352,0,0,30,0,-30
21353,1,1,187,1348,1161
21354,0,0,132,0,-132
21355,0,0,111,0,-111
21356,0,0,13,0,-13
21357,1,1,1758,1609,-149
21358,1,0,192,0,-192
21359,1,0,162,0,-162
21360,0,0,88,0,-88
21361,1,1,12,1831,1819
21362,1,0,6,0,-6
21363,1,1,380,1485,1105
21364,1,0,10,0,-10
21365,1,1,458,1851,1393
21366,1,1,149,2216,2067
21367,1,0,5,0,-5
21368,1,0,148,0,-148
21369,1,0,86,0,-86
21370,1,1,671,1212,541
21371,1,0,32,0,-32
21372,1,0,97,0,-97
21373,1,0,15,0,-15
21374,0,0,121,0,-121
21375,0,0,10,0,-10
21376,1,1,1096,1398,302
21377,1,0,39,0,-39
21378,1,0,13,0,-13
21379,1,0,72,0,-72
21380,1,1,1001,1572,571
21381,1,1,287,1570,1283
21382,0,0,103,0,-103
21383,1,1,565,1381,816
21384,1,0,25,0,-25
21385,1,1,289,2538,2249
21386,1,1,394,1234,840
21387,0,0,5,0,-5
21388,1,1,175,1283,1108
21389,0,0,0,0,0
21390,1,1,104,1719,1615
21391,1,0,55,0,-55
21392,1,0,112,0,-112
21393,1,0,66,0,-66
21394,1,0,103,0,-103
21395,1,0,2,0,-2
21396,1,1,804,1364,560
21397,0,0,50,0,-50
21398,0,0,28,0,-28
21399,1,1,1163,1253,90
21400,1,1,848,1212,364
21401,1,0,11,0,-11
21402,0,0,9,0,-9
21403,0,0,37,0,-37
21404,1,0,9,0,-9
21405,1,1,665,1730,1065
21406,0,0,51,0,-51
21407,1,0,110,0,-110
21408,0,0,0,0,0
21409,1,1,661,1554,893
21410,1,0,133,0,-133
21411,0,0,5,0,-5
21412,1,0,42,0,-42
21413,1,1,1714,1212,-502
21414,0,0,20,0,-20
21415,0,0,19,0,-19
21416,1,0,77,0,-77
21417,1,1,156,1673,1517
21418,1,1,931,1353,422
21419,0,0,123,0,-123
21420,1,0,269,0,-269
21421,1,0,57,0,-57
21422,1,1,526,1775,1249
21423,0,0,41,0,-41
21424,0,0,46,0,-46
21425,0,0,61,0,-61
21426,1,0,167,0,-167
21427,1,1,589,1278,689
21428,1,0,15,0,-15
21429,1,0,43,0,-43
21430,0,0,158,0,-158
21431,1,1,129,1581,1452
21432,1,1,114,1469,1355
21433,1,0,115,0,-115
21434,1,0,14,0,-14
21435,1,1,95,1358,1263
21436,1,0,26,0,-26
21437,1,1,315,1518,1203
21438,1,1,39,1267,1228
21439,1,1,819,1421,602
21440,1,0,159,0,-159
21441,0,0,2,0,-2
21442,1,1,113,1234,1121
21443,0,0,4,0,-4
21444,1,0,142,0,-142
21445,1,0,111,0,-111
21446,0,0,41,0,-41
21447,1,0,46,0,-46
21448,1,0,174,0,-174
21449,1,1,1636,2013,377
21450,1,0,132,0,-132
21451,0,0,78,0,-78
21452,0,0,102,0,-102
21453,1,1,786,1241,455
21454,1,1,512,1318,806
21455,1,1,628,1429,801
21456,1,0,9,0,-9
21457,1,0,48,0,-48
21458,1,1,932,1305,373
21459,1,1,578,1452,874
21460,0,0,42,0,-42
21461,1,1,902,1965,1063
21462,1,1,467,1212,745
21463,0,0,2,0,-2
21464,0,0,13,0,-13
21465,1,0,22,0,-22
21466,1,0,38,0,-38
21467,1,0,78,0,-78
21468,0,0,41,0,-41
21469,1,0,25,0,-25
21470,1,0,54,0,-54
21471,0,0,20,0,-20
21472,1,1,61,1353,1292
21473,1,1,824,1879,1055
21474,0,0,74,0,-74
21475,0,0,10,0,-10
21476,1,1,1690,1825,135
21477,1,1,1129,1209,80
21478,1,0,37,0,-37
21479,1,1,268,1339,1071
21480,1,0,38,0,-38
21481,1,1,1195,1589,394
21482,0,0,100,0,-100
21483,1,1,1396,1245,-151
21484,1,0,47,0,-47
21485,1,1,388,2088,1700
21486,1,0,40,0,-40
21487,0,0,20,0,-20
21488,0,0,117,0,-117
21489,1,1,292,1269,977
21490,0,0,27,0,-27
21491,1,0,16,0,-16
21492,0,0,52,0,-52
21493,0,0,6,0,-6
21494,0,0,1,0,-1
21495,0,0,39,0,-39
21496,1,0,15,0,-15
21497,0,0,28,0,-28
21498,0,0,59,0,-59
21499,1,0,305,0,-305
21500,1,1,324,1334,1010
21501,1,0,202,0,-202
21502,1,0,88,0,-88
21503,1,1,1469,1561,92
21504,0,0,20,0,-20
21505,1,1,632,1204,572
21506,1,0,115,0,-115
21507,1,0,33,0,-33
21508,0,0,41,0,-41
21509,1,1,154,1703,1549
21510,0,0,189,0,-189
21511,0,0,59,0,-59
21512,0,0,54,0,-54
21513,1,0,52,0,-52
21514,0,0,41,0,-41
21515,0,0,99,0,-99
21516,1,1,208,1383,1175
21517,1,1,793,1899,1106
21518,1,0,11,0,-11
21519,1,1,549,2188,1639
21520,1,1,246,1433,1187
21521,1,0,103,0,-103
21522,1,1,398,1360,962
21523,1,0,20,0,-20
21524,1,0,69,0,-69
21525,0,0,53,0,-53
21526,1,1,98,1283,1185
21527,0,0,53,0,-53
21528,1,1,108,1282,1174
21529,0,0,22,0,-22
21530,0,0,82,0,-82
21531,0,0,3,0,-3
21532,0,0,5,0,-5
21533,1,0,45,0,-45
21534,1,1,1606,1214,-392
21535,1,1,265,1964,1699
21536,1,0,68,0,-68
21537,1,1,34,2652,2618
21538,1,1,318,1252,934
21539,0,0,20,0,-20
21540,0,0,46,0,-46
21541,1,0,7,0,-7
21542,1,1,134,1259,1125
21543,1,0,42,0,-42
21544,1,0,62,0,-62
21545,0,0,13,0,-13
21546,0,0,7,0,-7
21547,0,0,72,0,-72
21548,1,1,766,1261,495
21549,1,0,91,0,-91
21550,1,1,145,1272,1127
21551,0,0,19,0,-19
21552,0,0,48,0,-48
21553,1,0,12,0,-12
21554,1,1,205,1698,1493
21555,1,0,4,0,-4
21556,1,0,60,0,-60
21557,0,0,103,0,-103
21558,1,0,46,0,-46
21559,1,1,510,1287,777
21560,0,0,5,0,-5
21561,0,0,29,0,-29
21562,1,1,298,1208,910
21563,0,0,1,0,-1
21564,1,0,133,0,-133
21565,1,1,62,1450,1388
21566,1,1,895,2000,1105
21567,1,0,64,0,-64
21568,1,0,18,0,-18
21569,0,0,2,0,-2
21570,1,0,40,0,-40
21571,1,0,91,0,-91
21572,1,1,171,1343,1172
21573,0,0,2,0,-2
21574,1,1,535,2125,1590
21575,1,0,177,0,-177
21576,1,1,1402,1785,383
21577,0,0,55,0,-55
21578,1,0,40,0,-40
21579,1,1,323,1427,1104
21580,0,0,48,0,-48
21581,1,0,57,0,-57
21582,1,0,35,0,-35
21583,1,1,467,1222,755
21584,0,0,64,0,-64
21585,0,0,21,0,-21
21586,0,0,3,0,-3
21587,1,0,8,0,-8
21588,0,0,13,0,-13
21589,1,0,33,0,-33
21590,0,0,116,0,-116
21591,0,0,21,0,-21
21592,1,1,146,1288,1142
21593,0,0,39,0,-39
21594,1,0,50,0,-50
21595,0,0,9,0,-9
21596,0,0,143,0,-143
21597,0,0,23,0,-23
21598,0,0,31,0,-31
21599,1,1,182,1396,1214
21600,1,1,661,2142,1481
21601,1,0,3,0,-3
21602,0,0,8,0,-8
21603,0,0,0,0,0
21604,1,0,82,0,-82
21605,0,0,77,0,-77
21606,1,0,76,0,-76
21607,0,0,42,0,-42
21608,0,0,32,0,-32
21609,1,1,287,1474,1187
21610,1,1,307,1430,1123
21611,0,0,26,0,-26
21612,1,1,143,1240,1097
21613,1,0,33,0,-33
21614,1,0,101,0,-101
21615,0,0,118,0,-118
21616,0,0,80,0,-80
21617,1,1,1131,1423,292
21618,0,0,0,0,0
21619,0,0,213,0,-213
21620,1,1,154,1281,1127
21621,0,0,54,0,-54
21622,1,0,0,0,0
21623,0,0,39,0,-39
21624,1,0,119,0,-119
21625,1,0,8,0,-8
21626,1,1,327,1213,886
21627,1,0,49,0,-49
21628,1,1,854,1370,516
21629,1,0,3,0,-3
21630,1,0,64,0,-64
21631,1,1,328,1384,1056
21632,1,0,86,0,-86
21633,1,0,117,0,-117
21634,1,0,50,0,-50
21635,1,0,188,0,-188
21636,0,0,42,0,-42
21637,1,0,36,0,-36
21638,1,0,50,0,-50
21639,1,1,87,1698,1611
21640,0,0,45,0,-45
21641,1,0,13,0,-13
21642,1,1,808,1453,645
21643,1,0,53,0,-53
21644,0,0,92,0,-92
21645,1,1,197,1517,1320
21646,1,0,10,0,-10
21647,1,0,35,0,-35
21648,1,1,455,1282,827
21649,0,0,115,0,-115
21650,1,0,86,0,-86
21651,1,1,549,3694,3145
21652,1,1,1628,2718,1090
21653,1,1,1256,1200,-56
21654,1,1,342,1314,972
21655,1,1,150,1460,1310
21656,1,1,358,1401,1043
21657,0,0,30,0,-30
21658,1,1,622,1205,583
21659,0,0,2,0,-2
21660,0,0,58,0,-58
21661,1,1,280,1209,929
21662,1,0,34,0,-34
21663,1,0,111,0,-111
21664,0,0,19,0,-19
21665,1,0,70,0,-70
21666,1,0,29,0,-29
21667,0,0,18,0,-18
21668,0,0,28,0,-28
21669,0,0,290,0,-290
21670,1,0,10,0,-10
21671,1,0,22,0,-22
21672,1,1,45,1761,1716
21673,1,0,121,0,-121
21674,1,0,1,0,-1
21675,0,0,85,0,-85
21676,1,0,71,0,-71
21677,1,0,11,0,-11
21678,1,0,36,0,-36
21679,1,0,53,0,-53
21680,1,1,442,1319,877
21681,0,0,16,0,-16
21682,1,0,71,0,-71
21683,0,0,20,0,-20
21684,0,0,27,0,-27
21685,1,1,864,1667,803
21686,1,1,1169,1875,706
21687,1,1,271,1532,1261
21688,1,0,14,0,-14
21689,1,0,57,0,-57
21690,1,0,145,0,-145
21691,0,0,86,0,-86
21692,0,0,1,0,-1
21693,0,0,91,0,-91
21694,0,0,2,0,-2
21695,0,0,37,0,-37
21696,0,0,48,0,-48
21697,1,0,135,0,-135
21698,1,1,36,2736,2700
21699,1,0,91,0,-91
21700,1,1,1068,1492,424
21701,1,0,32,0,-32
21702,1,0,94,0,-94
21703,1,0,96,0,-96
21704,0,0,9,0,-9
21705,1,0,73,0,-73
21706,0,0,99,0,-99
21707,0,0,6,0,-6
21708,0,0,19,0,-19
21709,0,0,6,0,-6
21710,0,0,15,0,-15
21711,1,1,382,1350,968
21712,1,1,970,1293,323
21713,1,1,471,1227,756
21714,1,1,318,1306,988
21715,1,1,419,1270,851
21716,1,1,483,1228,745
21717,1,1,249,1389,1140
21718,0,0,29,0,-29
21719,1,0,16,0,-16
21720,1,0,72,0,-72
21721,0,0,133,0,-133
21722,1,0,82,0,-82
21723,1,1,23,1686,1663
21724,1,1,1341,1321,-20
21725,0,0,9,0,-9
21726,1,1,100,2237,2137
21727,1,1,58,1782,1724
21728,1,0,1,0,-1
21729,1,0,31,0,-31
21730,1,0,52,0,-52
21731,1,0,41,0,-41
21732,1,1,177,1219,1042
21733,0,0,4,0,-4
21734,1,0,49,0,-49
21735,0,0,5,0,-5
21736,0,0,1,0,-1
21737,1,0,65,0,-65
21738,0,0,25,0,-25
21739,0,0,22,0,-22
21740,0,0,81,0,-81
21741,1,1,42,1485,1443
21742,1,1,205,1590,1385
21743,1,0,54,0,-54
21744,1,0,79,0,-79
21745,1,0,55,0,-55
21746,0,0,14,0,-14
21747,1,1,458,1571,1113
21748,1,0,15,0,-15
21749,1,0,26,0,-26
21750,1,1,959,2258,1299
21751,0,0,32,0,-32
21752,1,0,1,0,-1
21753,1,1,47,1870,1823
21754,1,1,127,1643,1516
21755,1,0,40,0,-40
21756,1,0,79,0,-79
21757,0,0,10,0,-10
21758,1,1,102,1232,1130
21759,0,0,7,0,-7
21760,0,0,16,0,-16
21761,1,0,2,0,-2
21762,0,0,100,0,-100
21763,1,1,299,1821,1522
21764,0,0,9,0,-9
21765,1,0,20,0,-20
21766,0,0,10,0,-10
21767,0,0,14,0,-14
21768,1,1,122,1380,1258
21769,1,1,374,1329,955
21770,1,0,37,0,-37
21771,1,0,2,0,-2
21772,0,0,76,0,-76
21773,1,0,19,0,-19
21774,0,0,19,0,-19
21775,1,1,470,2365,1895
21776,0,0,59,0,-59
21777,0,0,28,0,-28
21778,1,0,21,0,-21
21779,0,0,103,0,-103
21780,1,1,991,2152,1161
21781,1,1,1077,1338,261
21782,1,1,1943,1230,-713
21783,1,1,804,1364,560
21784,1,1,289,1625,1336
21785,0,0,42,0,-42
21786,1,0,95,0,-95
21787,0,0,88,0,-88
21788,0,0,5,0,-5
21789,1,1,483,7002,6519
21790,1,0,15,0,-15
21791,1,0,5,0,-5
21792,1,0,109,0,-109
21793,1,0,4,0,-4
21794,1,0,2,0,-2
21795,0,0,19,0,-19
21796,1,0,75,0,-75
21797,0,0,25,0,-25
21798,1,1,229,1250,1021
21799,1,1,209,3107,2898
21800,1,1,99,1332,1233
21801,0,0,70,0,-70
21802,1,0,85,0,-85
21803,1,0,198,0,-198
21804,1,1,93,1373,1280
21805,0,0,154,0,-154
21806,1,1,51,1448,1397
21807,1,0,0,0,0
21808,1,0,18,0,-18
21809,1,1,753,1579,826
21810,0,0,17,0,-17
21811,0,0,268,0,-268
21812,1,1,701,1968,1267
21813,1,1,767,1402,635
21814,0,0,29,0,-29
21815,1,1,536,1242,706
21816,0,0,25,0,-25
21817,1,0,64,0,-64
21818,1,0,65,0,-65
21819,1,1,521,1210,689
21820,0,0,148,0,-148
21821,0,0,73,0,-73
21822,1,0,52,0,-52
21823,1,1,193,1471,1278
21824,1,1,317,1550,1233
21825,0,0,2,0,-2
21826,0,0,4,0,-4
21827,1,1,317,1341,1024
21828,1,1,1009,1291,282
21829,1,0,116,0,-116
21830,0,0,38,0,-38
21831,1,1,568,1253,685
21832,0,0,53,0,-53
21833,1,0,19,0,-19
21834,1,0,49,0,-49
21835,1,1,385,1681,1296
21836,0,0,27,0,-27
21837,0,0,14,0,-14
21838,1,1,623,1597,974
21839,0,0,45,0,-45
21840,1,1,212,1728,1516
21841,0,0,1,0,-1
21842,0,0,64,0,-64
21843,1,0,4,0,-4
21844,0,0,160,0,-160
21845,1,0,74,0,-74
21846,1,0,76,0,-76
21847,1,0,157,0,-157
21848,0,0,27,0,-27
21849,1,0,27,0,-27
21850,0,0,7,0,-7
21851,0,0,25,0,-25
21852,0,0,46,0,-46
21853,1,0,100,0,-100
21854,0,0,3,0,-3
21855,1,1,340,1536,1196
21856,0,0,70,0,-70
21857,1,0,24,0,-24
21858,0,0,27,0,-27
21859,1,0,4,0,-4
21860,1,1,362,1266,904
21861,1,0,31,0,-31
21862,0,0,41,0,-41
21863,0,0,12,0,-12
21864,1,0,41,0,-41
21865,1,1,662,1361,699
21866,1,0,125,0,-125
21867,0,0,59,0,-59
21868,1,0,3,0,-3
21869,0,0,92,0,-92
21870,1,1,266,1304,1038
21871,1,1,511,1897,1386
21872,1,0,42,0,-42
21873,1,1,222,1810,1588
21874,1,1,124,1386,1262
21875,0,0,19,0,-19
21876,1,0,34,0,-34
21877,1,1,829,1663,834
21878,0,0,12,0,-12
21879,1,0,13,0,-13
21880,1,0,54,0,-54
21881,1,1,578,1615,1037
21882,1,0,28,0,-28
21883,0,0,57,0,-57
21884,1,1,35,2144,2109
21885,1,0,71,0,-71
21886,1,0,11,0,-11
21887,0,0,3,0,-3
21888,1,0,3,0,-3
21889,1,0,137,0,-137
21890,1,1,99,1361,1262
21891,1,0,28,0,-28
21892,0,0,5,0,-5
21893,0,0,26,0,-26
21894,1,1,530,3126,2596
21895,0,0,53,0,-53
21896,1,0,75,0,-75
21897,0,0,26,0,-26
21898,0,0,31,0,-31
21899,1,0,41,0,-41
21900,1,1,123,1587,1464
21901,1,0,60,0,-60
21902,1,0,76,0,-76
21903,0,0,21,0,-21
21904,0,0,55,0,-55
21905,1,0,56,0,-56
21906,1,1,227,1682,1455
21907,1,0,25,0,-25
21908,1,0,70,0,-70
21909,1,0,59,0,-59
21910,1,0,33,0,-33
21911,0,0,47,0,-47
21912,1,1,258,1851,1593
21913,1,0,98,0,-98
21914,0,0,18,0,-18
21915,0,0,36,0,-36
21916,0,0,0,0,0
21917,1,1,621,1425,804
21918,0,0,44,0,-44
21919,1,1,554,2511,1957
21920,1,0,19,0,-19
21921,0,0,101,0,-101
21922,0,0,33,0,-33
21923,1,1,1732,2255,523
21924,0,0,68,0,-68
21925,0,0,74,0,-74
21926,1,0,58,0,-58
21927,0,0,23,0,-23
21928,1,1,1137,1287,150
21929,1,1,296,1299,1003
21930,1,0,11,0,-11
21931,1,1,438,2437,1999
21932,0,0,92,0,-92
21933,0,0,58,0,-58
21934,1,0,60,0,-60
21935,0,0,28,0,-28
21936,1,0,134,0,-134
21937,0,0,6,0,-6
21938,0,0,41,0,-41
21939,1,0,31,0,-31
21940,1,0,18,0,-18
21941,1,1,356,1432,1076
21942,1,1,271,3391,3120
21943,1,1,117,1292,1175
21944,1,0,15,0,-15
21945,1,0,74,0,-74
21946,1,0,11,0,-11
21947,1,1,1354,1251,-103
21948,1,1,225,1292,1067
21949,1,0,38,0,-38
21950,1,1,267,1324,1057
21951,0,0,46,0,-46
21952,1,0,27,0,-27
21953,1,1,842,1221,379
21954,0,0,47,0,-47
21955,0,0,17,0,-17
21956,1,1,671,1214,543
21957,1,0,75,0,-75
21958,0,0,118,0,-118
21959,0,0,30,0,-30
21960,1,0,18,0,-18
21961,1,1,619,1641,1022
21962,0,0,48,0,-48
21963,0,0,2,0,-2
21964,0,0,114,0,-114
21965,1,1,393,2690,2297
21966,1,1,59,1288,1229
21967,1,1,829,1455,626
21968,0,0,19,0,-19
21969,1,1,843,1659,816
21970,0,0,9,0,-9
21971,1,1,164,1866,1702
21972,1,0,18,0,-18
21973,0,0,17,0,-17
21974,1,0,98,0,-98
21975,0,0,10,0,-10
21976,0,0,36,0,-36
21977,1,1,2011,1737,-274
21978,1,0,61,0,-61
21979,0,0,29,0,-29
21980,0,0,98,0,-98
21981,1,0,21,0,-21
21982,1,1,1089,1337,248
21983,0,0,55,0,-55
21984,0,0,10,0,-10
21985,1,1,390,1541,1151
21986,1,0,81,0,-81
21987,1,1,278,2252,1974
21988,0,0,68,0,-68
21989,1,0,64,0,-64
21990,1,0,9,0,-9
21991,1,1,442,1456,1014
21992,1,1,271,1234,963
21993,0,0,7,0,-7
21994,0,0,192,0,-192
21995,1,1,371,1558,1187
21996,1,0,133,0,-133
21997,1,0,137,0,-137
21998,0,0,39,0,-39
21999,1,0,35,0,-35
22000,1,1,483,1266,783
22001,0,0,145,0,-145
22002,0,0,3,0,-3
22003,1,1,232,1337,1105
22004,1,1,55,1382,1327
22005,1,0,44,0,-44
22006,0,0,59,0,-59
22007,0,0,143,0,-143
22008,1,0,50,0,-50
22009,0,0,228,0,-228
22010,0,0,35,0,-35
22011,0,0,2,0,-2
22012,1,1,1113,1869,756
22013,1,0,1,0,-1
22014,0,0,10,0,-10
22015,1,1,242,1208,966
22016,0,0,5,0,-5
22017,1,1,321,1666,1345
22018,0,0,7,0,-7
22019,1,1,940,1530,590
22020,0,0,132,0,-132
22021,1,1,676,1563,887
22022,1,1,641,1344,703
22023,0,0,52,0,-52
22024,1,0,13,0,-13
22025,1,0,70,0,-70
22026,1,0,114,0,-114
22027,1,1,73,1619,1546
22028,1,0,19,0,-19
22029,0,0,45,0,-45
22030,0,0,156,0,-156
22031,1,0,20,0,-20
22032,0,0,39,0,-39
22033,1,0,44,0,-44
22034,1,1,69,3101,3032
22035,0,0,18,0,-18
22036,1,1,529,1360,831
22037,1,0,49,0,-49
22038,1,1,463,1320,857
22039,1,1,129,1334,1205
22040,0,0,52,0,-52
22041,0,0,12,0,-12
22042,0,0,13,0,-13
22043,1,1,1399,1244,-155
22044,0,0,24,0,-24
22045,1,1,710,1410,700
22046,0,0,21,0,-21
22047,1,1,93,1384,1291
22048,1,0,110,0,-110
22049,1,1,498,1219,721
22050,1,0,1,0,-1
22051,1,1,683,1601,918
22052,0,0,39,0,-39
22053,0,0,10,0,-10
22054,1,1,536,1291,755
22055,0,0,18,0,-18
22056,0,0,78,0,-78
22057,1,1,315,1367,1052
22058,1,0,158,0,-158
22059,0,0,116,0,-116
22060,0,0,54,0,-54
22061,0,0,1,0,-1
22062,1,0,59,0,-59
22063,1,1,816,1272,456
22064,0,0,5,0,-5
22065,0,0,142,0,-142
22066,1,1,334,1318,984
22067,0,0,40,0,-40
22068,1,1,353,1214,861
22069,0,0,11,0,-11
22070,0,0,15,0,-15
22071,1,1,102,1305,1203
22072,1,0,19,0,-19
22073,1,0,3,0,-3
22074,0,0,52,0,-52
22075,0,0,85,0,-85
22076,0,0,22,0,-22
22077,1,1,616,1356,740
22078,0,0,61,0,-61
22079,1,1,300,1208,908
22080,0,0,188,0,-188
22081,1,1,634,1231,597
22082,1,1,196,1580,1384
22083,1,0,18,0,-18
22084,1,1,595,1532,937
22085,0,0,19,0,-19
22086,1,0,36,0,-36
22087,0,0,5,0,-5
22088,1,1,297,1493,1196
22089,1,1,818,1248,430
22090,1,0,46,0,-46
22091,0,0,2,0,-2
22092,0,0,35,0,-35
22093,0,0,48,0,-48
22094,0,0,27,0,-27
22095,1,0,46,0,-46
22096,1,0,87,0,-87
22097,0,0,28,0,-28
22098,1,1,85,1232,1147
22099,1,0,27,0,-27
22100,1,0,3,0,-3
22101,1,1,996,1912,916
22102,1,0,82,0,-82
22103,0,0,20,0,-20
22104,1,0,33,0,-33
22105,1,1,27,2040,2013
22106,0,0,78,0,-78
22107,1,0,2,0,-2
22108,1,0,6,0,-6
22109,1,0,0,0,0
22110,0,0,42,0,-42
22111,0,0,17,0,-17
22112,0,0,15,0,-15
22113,1,1,454,1385,931
22114,1,1,177,1269,1092
22115,1,1,598,1972,1374
22116,0,0,12,0,-12
22117,0,0,59,0,-59
22118,0,0,19,0,-19
22119,0,0,20,0,-20
22120,0,0,14,0,-14
22121,1,1,316,1220,904
22122,1,1,123,3256,3133
22123,1,1,36,1329,1293
22124,1,1,161,3048,2887
22125,1,1,538,1207,669
22126,0,0,22,0,-22
22127,0,0,333,0,-333
22128,1,1,608,2779,2171
22129,1,1,849,1273,424
22130,1,0,54,0,-54
22131,1,1,512,2122,1610
22132,1,1,203,1271,1068
22133,0,0,162,0,-162
22134,1,1,559,1561,1002
22135,1,1,325,2035,1710
22136,1,0,65,0,-65
22137,1,1,304,2460,2156
22138,0,0,26,0,-26
22139,0,0,65,0,-65
22140,1,1,1613,1553,-60
22141,1,1,576,1601,1025
22142,1,1,370,1351,981
22143,1,0,44,0,-44
22144,0,0,46,0,-46
22145,1,1,1160,1271,111
22146,1,0,14,0,-14
22147,1,1,513,1290,777
22148,0,0,54,0,-54
22149,1,1,757,1208,451
22150,1,0,18,0,-18
22151,1,0,16,0,-16
22152,0,0,101,0,-101
22153,1,1,309,1479,1170
22154,0,0,94,0,-94
22155,0,0,29,0,-29
22156,1,0,34,0,-34
22157,0,0,37,0,-37
22158,1,1,50,1241,1191
22159,1,0,1,0,-1
22160,1,1,518,1256,738
22161,1,1,154,1569,1415
22162,1,0,116,0,-116
22163,1,1,788,1357,569
22164,1,0,21,0,-21
22165,1,1,907,1531,624
22166,0,0,98,0,-98
22167,1,0,47,0,-47
22168,1,0,50,0,-50
22169,0,0,114,0,-114
22170,0,0,29,0,-29
22171,0,0,26,0,-26
22172,1,1,636,1229,593
22173,1,1,428,3676,3248
22174,0,0,4,0,-4
22175,0,0,1,0,-1
22176,1,1,802,1261,459
22177,1,1,683,5140,4457
22178,0,0,44,0,-44
22179,0,0,33,0,-33
22180,0,0,14,0,-14
22181,1,1,644,1286,642
22182,1,1,267,1346,1079
22183,0,0,90,0,-90
22184,1,0,22,0,-22
22185,1,0,27,0,-27
22186,1,0,48,0,-48
22187,1,0,27,0,-27
22188,0,0,142,0,-142
22189,0,0,7,0,-7
22190,0,0,29,0,-29
22191,1,1,110,3247,3137
22192,1,1,69,1604,1535
22193,1,0,156,0,-156
22194,1,0,94,0,-94
22195,0,0,120,0,-120
22196,1,1,841,1276,435
22197,1,1,41,1301,1260
22198,1,1,356,1346,990
22199,0,0,39,0,-39
22200,0,0,41,0,-41
22201,1,0,74,0,-74
22202,0,0,68,0,-68
22203,0,0,49,0,-49
22204,0,0,47,0,-47
22205,1,1,179,1245,1066
22206,1,1,91,1577,1486
22207,1,0,95,0,-95
22208,1,1,35,1284,1249
22209,1,0,64,0,-64
22210,1,0,27,0,-27
22211,1,1,1716,2184,468
22212,1,1,318,1773,1455
22213,0,0,7,0,-7
22214,0,0,99,0,-99
22215,0,0,33,0,-33
22216,1,0,64,0,-64
22217,1,0,34,0,-34
22218,0,0,24,0,-24
22219,0,0,191,0,-191
22220,1,1,194,1298,1104
22221,1,0,12,0,-12
22222,0,0,84,0,-84
22223,1,0,47,0,-47
22224,1,0,28,0,-28
22225,1,0,128,0,-128
22226,0,0,50,0,-50
22227,1,0,216,0,-216
22228,1,0,10,0,-10
22229,1,1,631,3099,2468
22230,0,0,112,0,-112
22231,1,1,218,1470,1252
22232,0,0,71,0,-71
22233,0,0,6,0,-6
22234,1,0,34,0,-34
22235,1,1,1053,1360,307
22236,0,0,21,0,-21
22237,1,0,0,0,0
22238,1,0,8,0,-8
22239,1,0,19,0,-19
22240,0,0,7,0,-7
22241,0,0,33,0,-33
22242,1,1,990,1833,843
22243,1,1,540,1523,983
22244,1,0,54,0,-54
22245,0,0,25,0,-25
22246,1,1,71,2036,1965
22247,1,1,329,1397,1068
22248,0,0,11,0,-11
22249,1,1,860,1306,446
22250,1,1,777,1404,627
22251,1,0,86,0,-86
22252,1,0,17,0,-17
22253,0,0,27,0,-27
22254,0,0,7,0,-7
22255,0,0,86,0,-86
22256,0,0,5,0,-5
22257,1,1,233,1291,1058
22258,0,0,37,0,-37
22259,0,0,38,0,-38
22260,0,0,129,0,-129
22261,1,0,9,0,-9
22262,1,0,67,0,-67
22263,1,1,1179,1330,151
22264,1,1,270,1478,1208
22265,1,1,148,1294,1146
22266,1,1,35,1316,1281
22267,1,0,66,0,-66
22268,0,0,26,0,-26
22269,1,0,19,0,-19
22270,1,0,4,0,-4
22271,1,0,35,0,-35
22272,1,1,979,1396,417
22273,1,0,41,0,-41
22274,1,1,1442,1662,220
22275,1,1,110,1302,1192
22276,1,0,0,0,0
22277,1,1,28,1761,1733
22278,1,0,35,0,-35
22279,1,1,262,2102,1840
22280,0,0,27,0,-27
22281,0,0,23,0,-23
22282,0,0,128,0,-128
22283,0,0,372,0,-372
22284,1,0,136,0,-136
22285,1,1,202,1391,1189
22286,0,0,32,0,-32
22287,0,0,33,0,-33
22288,1,0,33,0,-33
22289,1,1,177,1232,1055
22290,1,1,178,1440,1262
22291,1,1,1152,1222,70
22292,1,0,21,0,-21
22293,0,0,70,0,-70
22294,0,0,39,0,-39
22295,0,0,86,0,-86
22296,1,1,82,1376,1294
22297,0,0,22,0,-22
22298,0,0,55,0,-55
22299,0,0,360,0,-360
22300,1,1,430,1447,1017
22301,0,0,2,0,-2
22302,1,0,5,0,-5
22303,1,1,284,1528,1244
22304,1,0,146,0,-146
22305,1,1,523,1348,825
22306,0,0,131,0,-131
22307,1,1,726,1328,602
22308,1,1,178,1203,1025
22309,1,1,212,4271,4059
22310,0,0,9,0,-9
22311,1,1,296,1484,1188
22312,1,0,72,0,-72
22313,0,0,116,0,-116
22314,1,1,672,1252,580
22315,1,0,37,0,-37
22316,1,1,52,1815,1763
22317,1,0,32,0,-32
22318,1,1,495,1205,710
22319,0,0,6,0,-6
22320,1,1,190,1341,1151
22321,1,1,43,1775,1732
22322,1,0,63,0,-63
22323,0,0,79,0,-79
22324,1,0,62,0,-62
22325,1,0,21,0,-21
22326,1,1,125,1283,1158
22327,1,0,18,0,-18
22328,0,0,34,0,-34
22329,0,0,70,0,-70
22330,1,1,338,1229,891
22331,0,0,35,0,-35
22332,1,0,135,0,-135
22333,0,0,13,0,-13
22334,1,0,2,0,-2
22335,1,1,363,1573,1210
22336,1,0,12,0,-12
22337,1,1,339,2185,1846
22338,0,0,1,0,-1
22339,1,1,2162,1215,-947
22340,1,1,1107,1787,680
22341,0,0,17,0,-17
22342,1,1,120,1257,1137
22343,0,0,58,0,-58
22344,0,0,28,0,-28
22345,0,0,17,0,-17
22346,0,0,36,0,-36
22347,1,1,204,1481,1277
22348,1,1,627,1812,1185
22349,1,1,128,1229,1101
22350,0,0,11,0,-11
22351,0,0,67,0,-67
22352,1,1,204,1352,1148
22353,0,0,34,0,-34
22354,1,1,666,1869,1203
22355,1,0,73,0,-73
22356,1,1,1730,1384,-346
22357,0,0,10,0,-10
22358,1,0,224,0,-224
22359,1,0,1,0,-1
22360,1,0,50,0,-50
22361,1,1,1400,1850,450
22362,1,0,0,0,0
22363,1,0,5,0,-5
22364,0,0,117,0,-117
22365,1,0,23,0,-23
22366,0,0,69,0,-69
22367,1,0,89,0,-89
22368,0,0,11,0,-11
22369,1,0,2,0,-2
22370,1,1,388,1347,959
22371,1,1,635,1407,772
22372,1,0,1,0,-1
22373,1,0,9,0,-9
22374,1,1,434,1411,977
22375,1,1,223,1538,1315
22376,1,1,347,1379,1032
22377,1,1,313,1798,1485
22378,1,0,27,0,-27
22379,1,0,10,0,-10
22380,0,0,24,0,-24
22381,1,0,293,0,-293
22382,1,1,990,1657,667
22383,0,0,15,0,-15
22384,1,0,14,0,-14
22385,0,0,77,0,-77
22386,1,1,550,1455,905
22387,1,1,177,1226,1049
22388,1,1,572,2328,1756
22389,1,1,1074,1315,241
22390,1,1,270,1426,1156
22391,0,0,30,0,-30
22392,0,0,302,0,-302
22393,0,0,0,0,0
22394,1,0,208,0,-208
22395,1,0,50,0,-50
22396,1,0,176,0,-176
22397,1,1,541,1414,873
22398,0,0,18,0,-18
22399,1,0,3,0,-3
22400,0,0,113,0,-113
22401,1,0,16,0,-16
22402,1,1,243,1590,1347
22403,1,0,12,0,-12
22404,0,0,39,0,-39
22405,0,0,62,0,-62
22406,1,1,1286,1314,28
22407,1,1,922,1507,585
22408,1,0,86,0,-86
22409,0,0,20,0,-20
22410,1,1,231,1476,1245
22411,1,0,22,0,-22
22412,1,1,1498,1343,-155
22413,1,0,13,0,-13
22414,0,0,76,0,-76
22415,1,1,611,1208,597
22416,0,0,26,0,-26
22417,1,0,1,0,-1
22418,0,0,25,0,-25
22419,0,0,4,0,-4
22420,1,1,355,4169,3814
22421,1,1,64,1493,1429
22422,0,0,55,0,-55
22423,0,0,16,0,-16
22424,1,0,7,0,-7
22425,0,0,146,0,-146
22426,1,1,269,1359,1090
22427,0,0,4,0,-4
22428,0,0,16,0,-16
22429,0,0,60,0,-60
22430,1,1,598,1292,694
22431,1,0,84,0,-84
22432,0,0,39,0,-39
22433,0,0,46,0,-46
22434,1,1,293,1516,1223
22435,1,0,32,0,-32
22436,1,1,1976,1581,-395
22437,1,0,28,0,-28
22438,1,0,117,0,-117
22439,1,1,381,1240,859
22440,0,0,106,0,-106
22441,1,1,221,1532,1311
22442,0,0,8,0,-8
22443,1,0,0,0,0
22444,0,0,10,0,-10
22445,0,0,28,0,-28
22446,1,0,76,0,-76
22447,1,0,17,0,-17
22448,1,1,949,1372,423
22449,1,1,208,1311,1103
22450,1,0,58,0,-58
22451,0,0,32,0,-32
22452,1,0,29,0,-29
22453,0,0,14,0,-14
22454,0,0,221,0,-221
22455,1,0,4,0,-4
22456,1,0,28,0,-28
22457,1,1,1325,1350,25
22458,1,1,270,1528,1258
22459,1,1,58,1984,1926
22460,0,0,9,0,-9
22461,1,0,23,0,-23
22462,1,1,461,1219,758
22463,0,0,0,0,0
22464,0,0,71,0,-71
22465,0,0,12,0,-12
22466,0,0,3,0,-3
22467,1,1,292,1224,932
22468,0,0,4,0,-4
22469,0,0,48,0,-48
22470,1,1,340,1223,883
22471,0,0,74,0,-74
22472,1,0,50,0,-50
22473,0,0,176,0,-176
22474,0,0,22,0,-22
22475,1,0,13,0,-13
22476,1,1,260,1206,946
22477,1,0,43,0,-43
22478,1,1,143,1402,1259
22479,0,0,51,0,-51
22480,0,0,7,0,-7
22481,0,0,61,0,-61
22482,1,0,12,0,-12
22483,1,0,93,0,-93
22484,1,0,25,0,-25
22485,1,1,679,1438,759
22486,1,1,315,2023,1708
22487,1,1,44,1254,1210
22488,1,0,20,0,-20
22489,1,1,1077,1559,482
22490,1,1,70,1259,1189
22491,0,0,49,0,-49
22492,1,0,4,0,-4
22493,1,0,391,0,-391
22494,1,0,56,0,-56
22495,1,0,22,0,-22
22496,0,0,199,0,-199
22497,1,0,18,0,-18
22498,1,1,155,1739,1584
22499,0,0,28,0,-28
22500,1,1,304,1486,1182
22501,1,1,179,1447,1268
22502,1,1,1028,1232,204
22503,1,1,284,1860,1576
22504,1,0,11,0,-11
22505,1,1,444,1799,1355
22506,0,0,117,0,-117
22507,1,0,148,0,-148
22508,0,0,2,0,-2
22509,0,0,66,0,-66
22510,0,0,35,0,-35
22511,0,0,18,0,-18
22512,1,0,20,0,-20
22513,1,0,18,0,-18
22514,1,1,403,1651,1248
22515,0,0,121,0,-121
22516,1,1,599,2724,2125
22517,1,0,22,0,-22
22518,1,0,6,0,-6
22519,1,1,541,1408,867
22520,0,0,32,0,-32
22521,0,0,87,0,-87
22522,1,0,32,0,-32
22523,0,0,25,0,-25
22524,1,0,59,0,-59
22525,0,0,58,0,-58
22526,1,0,6,0,-6
22527,1,0,222,0,-222
22528,0,0,16,0,-16
22529,1,0,88,0,-88
22530,0,0,90,0,-90
22531,1,0,47,0,-47
22532,1,0,4,0,-4
22533,0,0,52,0,-52
22534,1,1,172,1487,1315
22535,1,0,80,0,-80
22536,1,0,176,0,-176
22537,1,0,123,0,-123
22538,1,0,52,0,-52
22539,0,0,37,0,-37
22540,1,0,25,0,-25
22541,0,0,2,0,-2
22542,1,1,225,1373,1148
22543,0,0,28,0,-28
22544,0,0,86,0,-86
22545,1,1,461,1934,1473
22546,1,0,17,0,-17
22547,1,1,335,1272,937
22548,1,1,528,1341,813
22549,0,0,153,0,-153
22550,1,0,22,0,-22
22551,1,0,37,0,-37
22552,1,0,24,0,-24
22553,1,1,385,1225,840
22554,1,1,597,3434,2837
22555,0,0,18,0,-18
22556,1,0,87,0,-87
22557,1,1,89,1367,1278
22558,0,0,11,0,-11
22559,1,0,42,0,-42
22560,1,1,734,1577,843
22561,1,1,273,1202,929
22562,1,0,39,0,-39
22563,0,0,155,0,-155
22564,1,1,1456,1533,77
22565,0,0,5,0,-5
22566,1,0,52,0,-52
22567,0,0,8,0,-8
22568,0,0,12,0,-12
22569,0,0,53,0,-53
22570,1,1,316,1278,962
22571,0,0,24,0,-24
22572,1,1,128,2764,2636
22573,0,0,33,0,-33
22574,1,0,42,0,-42
22575,0,0,6,0,-6
22576,1,0,2,0,-2
22577,1,0,6,0,-6
22578,0,0,73,0,-73
22579,0,0,2,0,-2
22580,1,1,1556,1937,381
22581,1,1,97,1755,1658
22582,1,1,218,1508,1290
22583,0,0,7,0,-7
22584,1,1,1387,1672,285
22585,1,0,110,0,-110
22586,1,1,318,3273,2955
22587,0,0,44,0,-44
22588,0,0,31,0,-31
22589,0,0,10,0,-10
22590,0,0,228,0,-228
22591,1,1,619,1211,592
22592,0,0,71,0,-71
22593,0,0,2,0,-2
22594,0,0,6,0,-6
22595,1,0,15,0,-15
22596,0,0,60,0,-60
22597,1,1,1384,1207,-177
22598,0,0,66,0,-66
22599,1,1,922,1563,641
22600,0,0,63,0,-63
22601,0,0,66,0,-66
22602,0,0,119,0,-119
22603,1,0,20,0,-20
22604,0,0,34,0,-34
22605,1,0,97,0,-97
22606,1,1,112,1240,1128
22607,0,0,17,0,-17
22608,1,1,1141,1383,242
22609,0,0,66,0,-66
22610,1,1,1417,1491,74
22611,0,0,176,0,-176
22612,1,0,39,0,-39
22613,0,0,111,0,-111
22614,1,1,678,2150,1472
22615,1,0,30,0,-30
22616,0,0,29,0,-29
22617,0,0,7,0,-7
22618,0,0,200,0,-200
22619,1,1,361,1586,1225
22620,1,0,181,0,-181
22621,0,0,23,0,-23
22622,1,1,185,1345,1160
22623,0,0,91,0,-91
22624,1,0,94,0,-94
22625,0,0,5,0,-5
22626,1,0,7,0,-7
22627,1,0,9,0,-9
22628,1,0,36,0,-36
22629,0,0,79,0,-79
22630,0,0,8,0,-8
22631,1,0,2,0,-2
22632,1,1,438,1250,812
22633,0,0,156,0,-156
22634,1,0,8,0,-8
22635,0,0,107,0,-107
22636,0,0,20,0,-20
22637,1,0,112,0,-112
22638,1,0,18,0,-18
22639,0,0,19,0,-19
22640,1,1,405,3442,3037
22641,1,1,1319,1304,-15
22642,1,1,1029,4054,3025
22643,0,0,158,0,-158
22644,1,0,77,0,-77
22645,0,0,16,0,-16
22646,1,1,450,1263,813
22647,1,1,819,1275,456
22648,1,1,142,1598,1456
22649,0,0,80,0,-80
22650,1,0,15,0,-15
22651,1,0,9,0,-9
22652,0,0,99,0,-99
22653,1,1,38,1260,1222
22654,1,1,197,1253,1056
22655,1,0,21,0,-21
22656,1,0,14,0,-14
22657,1,0,191,0,-191
22658,0,0,27,0,-27
22659,0,0,22,0,-22
22660,1,1,533,1455,922
22661,1,0,30,0,-30
22662,0,0,0,0,0
22663,1,0,78,0,-78
22664,1,1,68,1373,1305
22665,1,1,464,1391,927
22666,1,0,48,0,-48
22667,0,0,11,0,-11
22668,1,0,87,0,-87
22669,1,0,70,0,-70
22670,1,1,384,1352,968
22671,0,0,96,0,-96
22672,0,0,31,0,-31
22673,1,0,12,0,-12
22674,0,0,197,0,-197
22675,0,0,2,0,-2
22676,0,0,227,0,-227
22677,1,1,1097,1525,428
22678,1,0,30,0,-30
22679,0,0,33,0,-33
22680,1,0,3,0,-3
22681,1,1,911,1334,423
22682,0,0,72,0,-72
22683,1,0,23,0,-23
22684,0,0,14,0,-14
22685,1,0,1,0,-1
22686,1,0,1,0,-1
22687,1,0,15,0,-15
22688,1,1,657,2370,1713
22689,1,0,10,0,-10
22690,1,1,569,1514,945
22691,1,1,508,1967,1459
22692,1,1,571,1383,812
22693,0,0,1,0,-1
22694,1,0,35,0,-35
22695,0,0,10,0,-10
22696,0,0,10,0,-10
22697,1,1,725,1241,516
22698,0,0,41,0,-41
22699,1,1,661,1277,616
22700,1,1,596,1284,688
22701,1,1,984,1785,801
22702,1,0,217,0,-217
22703,1,1,962,1414,452
22704,1,1,300,1372,1072
22705,1,0,24,0,-24
22706,1,1,256,1256,1000
22707,1,1,888,1513,625
22708,0,0,1,0,-1
22709,1,1,554,1219,665
22710,0,0,17,0,-17
22711,0,0,14,0,-14
22712,1,0,54,0,-54
22713,1,0,51,0,-51
22714,0,0,2,0,-2
22715,1,0,25,0,-25
22716,1,0,31,0,-31
22717,1,0,12,0,-12
22718,0,0,10,0,-10
22719,1,0,10,0,-10
22720,0,0,63,0,-63
22721,0,0,64,0,-64
22722,0,0,17,0,-17
22723,0,0,21,0,-21
22724,0,0,27,0,-27
22725,1,0,88,0,-88
22726,1,0,184,0,-184
22727,0,0,15,0,-15
22728,0,0,33,0,-33
22729,0,0,5,0,-5
22730,0,0,69,0,-69
22731,0,0,60,0,-60
22732,0,0,80,0,-80
22733,1,1,528,1587,1059
22734,1,0,87,0,-87
22735,0,0,5,0,-5
22736,0,0,149,0,-149
22737,1,1,491,2484,1993
22738,1,0,3,0,-3
22739,1,0,173,0,-173
22740,1,0,71,0,-71
22741,1,1,2332,2271,-61
22742,0,0,39,0,-39
22743,0,0,15,0,-15
22744,0,0,9,0,-9
22745,1,1,499,1343,844
22746,1,1,2183,2042,-141
22747,0,0,24,0,-24
22748,1,1,846,1490,644
22749,0,0,32,0,-32
22750,1,1,575,1216,641
22751,1,1,158,2254,2096
22752,1,1,291,1539,1248
22753,1,0,15,0,-15
22754,1,0,37,0,-37
22755,1,1,1418,1224,-194
22756,1,1,312,1547,1235
22757,1,1,528,1660,1132
22758,0,0,33,0,-33
22759,0,0,33,0,-33
22760,1,0,16,0,-16
22761,1,0,138,0,-138
22762,1,1,796,1415,619
22763,1,1,89,1692,1603
22764,1,0,17,0,-17
22765,0,0,65,0,-65
22766,0,0,9,0,-9
22767,1,1,32,1228,1196
22768,0,0,188,0,-188
22769,0,0,69,0,-69
22770,1,0,136,0,-136
22771,0,0,38,0,-38
22772,0,0,34,0,-34
22773,1,0,51,0,-51
22774,0,0,49,0,-49
22775,0,0,41,0,-41
22776,0,0,35,0,-35
22777,1,1,385,1210,825
22778,0,0,87,0,-87
22779,1,1,164,1451,1287
22780,1,0,43,0,-43
22781,0,0,66,0,-66
22782,1,0,1,0,-1
22783,0,0,140,0,-140
22784,1,0,132,0,-132
22785,1,0,128,0,-128
22786,1,0,45,0,-45
22787,1,0,86,0,-86
22788,0,0,34,0,-34
22789,1,0,24,0,-24
22790,1,0,101,0,-101
22791,1,1,192,1297,1105
22792,1,1,396,1443,1047
22793,0,0,113,0,-113
22794,0,0,19,0,-19
22795,1,1,473,1209,736
22796,0,0,18,0,-18
22797,0,0,100,0,-100
22798,1,0,5,0,-5
22799,1,1,1495,1454,-41
22800,0,0,2,0,-2
22801,0,0,76,0,-76
22802,1,0,9,0,-9
22803,1,1,47,1569,1522
22804,1,0,24,0,-24
22805,1,0,43,0,-43
22806,1,1,334,2422,2088
22807,1,1,441,1336,895
22808,0,0,38,0,-38
22809,0,0,65,0,-65
22810,1,1,479,1223,744
22811,1,1,1124,1288,164
22812,1,0,48,0,-48
22813,1,1,1297,2117,820
22814,0,0,180,0,-180
22815,1,1,989,1485,496
22816,1,0,76,0,-76
22817,0,0,8,0,-8
22818,0,0,88,0,-88
22819,1,1,479,1344,865
22820,0,0,1,0,-1
22821,1,1,1043,1384,341
22822,0,0,44,0,-44
22823,1,1,657,1814,1157
22824,0,0,12,0,-12
22825,0,0,50,0,-50
22826,1,0,74,0,-74
22827,0,0,38,0,-38
22828,1,1,314,2087,1773
22829,0,0,0,0,0
22830,1,1,161,1404,1243
22831,1,1,541,1318,777
22832,1,0,4,0,-4
22833,0,0,57,0,-57
22834,0,0,3,0,-3
22835,1,0,108,0,-108
22836,1,1,122,1423,1301
22837,0,0,4,0,-4
22838,1,0,241,0,-241
22839,1,1,1444,1352,-92
22840,1,0,26,0,-26
22841,1,1,949,1389,440
22842,0,0,46,0,-46
22843,1,1,349,1242,893
22844,1,1,472,1513,1041
22845,0,0,53,0,-53
22846,0,0,55,0,-55
22847,1,0,98,0,-98
22848,0,0,162,0,-162
22849,0,0,10,0,-10
22850,1,1,108,1231,1123
22851,1,0,27,0,-27
22852,0,0,46,0,-46
22853,0,0,20,0,-20
22854,1,0,18,0,-18
22855,1,0,11,0,-11
22856,0,0,155,0,-155
22857,1,0,33,0,-33
22858,1,1,324,1207,883
22859,1,1,717,1250,533
22860,1,1,724,1245,521
22861,0,0,47,0,-47
22862,1,1,729,1345,616
22863,1,0,136,0,-136
22864,1,0,31,0,-31
22865,0,0,62,0,-62
22866,0,0,173,0,-173
22867,0,0,170,0,-170
22868,0,0,52,0,-52
22869,1,1,387,1425,1038
22870,1,1,92,3725,3633
22871,1,1,426,1794,1368
22872,1,0,16,0,-16
22873,1,0,13,0,-13
22874,0,0,32,0,-32
22875,1,0,26,0,-26
22876,1,1,455,1290,835
22877,0,0,7,0,-7
22878,0,0,32,0,-32
22879,1,0,7,0,-7
22880,1,0,56,0,-56
22881,0,0,21,0,-21
22882,0,0,35,0,-35
22883,1,0,42,0,-42
22884,1,1,1235,1330,95
22885,0,0,142,0,-142
22886,0,0,61,0,-61
22887,0,0,117,0,-117
22888,1,1,500,2884,2384
22889,0,0,72,0,-72
22890,1,1,591,1300,709
22891,1,1,314,1301,987
22892,0,0,87,0,-87
22893,1,1,303,1362,1059
22894,0,0,142,0,-142
22895,1,0,6,0,-6
22896,0,0,60,0,-60
22897,0,0,38,0,-38
22898,0,0,77,0,-77
22899,1,0,20,0,-20
22900,1,0,12,0,-12
22901,1,0,14,0,-14
22902,0,0,34,0,-34
22903,1,0,92,0,-92
22904,1,0,31,0,-31
22905,0,0,64,0,-64
22906,0,0,9,0,-9
22907,1,0,29,0,-29
22908,1,0,32,0,-32
22909,0,0,53,0,-53
22910,1,1,76,1583,1507
22911,1,1,436,1401,965
22912,1,1,102,1250,1148
22913,1,0,147,0,-147
22914,0,0,19,0,-19
22915,0,0,47,0,-47
22916,1,1,541,1273,732
22917,1,0,3,0,-3
22918,0,0,110,0,-110
22919,1,1,150,2099,1949
22920,0,0,31,0,-31
22921,1,0,24,0,-24
22922,1,1,124,1207,1083
22923,0,0,115,0,-115
22924,0,0,3,0,-3
22925,0,0,13,0,-13
22926,1,1,1082,1319,237
22927,1,1,140,1206,1066
22928,1,1,815,1493,678
22929,0,0,56,0,-56
22930,0,0,58,0,-58
22931,0,0,9,0,-9
22932,1,1,208,1701,1493
22933,0,0,145,0,-145
22934,1,1,119,1288,1169
22935,1,0,39,0,-39
22936,1,0,110,0,-110
22937,0,0,138,0,-138
22938,0,0,73,0,-73
22939,0,0,27,0,-27
22940,0,0,6,0,-6
22941,1,1,960,1280,320
22942,1,1,939,1453,514
22943,1,0,10,0,-10
22944,1,0,36,0,-36
22945,0,0,68,0,-68
22946,1,0,16,0,-16
22947,0,0,85,0,-85
22948,0,0,19,0,-19
22949,0,0,107,0,-107
22950,1,0,47,0,-47
22951,1,1,1527,1227,-300
22952,1,1,191,1295,1104
22953,0,0,123,0,-123
22954,0,0,3,0,-3
22955,1,1,293,2640,2347
22956,1,0,14,0,-14
22957,1,0,8,0,-8
22958,1,1,382,2014,1632
22959,1,0,19,0,-19
22960,1,1,787,1334,547
22961,0,0,3,0,-3
22962,1,1,475,1304,829
22963,1,0,27,0,-27
22964,1,1,155,1571,1416
22965,0,0,4,0,-4
22966,1,0,39,0,-39
22967,0,0,12,0,-12
22968,0,0,53,0,-53
22969,0,0,22,0,-22
22970,0,0,9,0,-9
22971,1,1,398,1204,806
22972,1,1,128,1349,1221
22973,1,1,217,1648,1431
22974,0,0,16,0,-16
22975,0,0,66,0,-66
22976,1,1,435,1450,1015
22977,1,0,80,0,-80
22978,0,0,29,0,-29
22979,0,0,21,0,-21
22980,1,0,55,0,-55
22981,1,1,399,2682,2283
22982,0,0,39,0,-39
22983,1,1,44,2429,2385
22984,1,0,21,0,-21
22985,0,0,65,0,-65
22986,1,0,17,0,-17
22987,0,0,108,0,-108
22988,1,1,474,1417,943
22989,1,0,23,0,-23
22990,0,0,61,0,-61
22991,1,0,270,0,-270
22992,0,0,209,0,-209
22993,0,0,103,0,-103
22994,0,0,38,0,-38
22995,0,0,5,0,-5
22996,0,0,25,0,-25
22997,0,0,134,0,-134
22998,1,1,762,1520,758
22999,1,0,20,0,-20
23000,1,1,275,3037,2762
23001,1,1,1017,1282,265
23002,1,0,13,0,-13
23003,0,0,41,0,-41
23004,1,1,1316,1327,11
23005,0,0,139,0,-139
23006,0,0,128,0,-128
23007,0,0,81,0,-81
23008,1,1,959,1334,375
23009,0,0,28,0,-28
23010,1,0,131,0,-131
23011,0,0,32,0,-32
23012,1,1,183,1207,1024
23013,0,0,222,0,-222
23014,0,0,9,0,-9
23015,1,0,54,0,-54
23016,0,0,42,0,-42
23017,0,0,24,0,-24
23018,1,0,130,0,-130
23019,1,1,3366,1325,-2041
23020,0,0,41,0,-41
23021,1,0,24,0,-24
23022,1,0,20,0,-20
23023,0,0,15,0,-15
23024,1,1,172,1385,1213
23025,1,0,0,0,0
23026,1,1,478,1864,1386
23027,0,0,37,0,-37
23028,0,0,85,0,-85
23029,1,0,27,0,-27
23030,1,1,186,1435,1249
23031,1,1,457,2148,1691
23032,1,0,58,0,-58
23033,1,0,16,0,-16
23034,0,0,9,0,-9
23035,1,0,16,0,-16
23036,0,0,9,0,-9
23037,1,0,24,0,-24
23038,1,1,734,1321,587
23039,1,1,590,1428,838
23040,1,0,13,0,-13
23041,1,0,91,0,-91
23042,1,0,58,0,-58
23043,1,0,16,0,-16
23044,0,0,111,0,-111
23045,1,0,0,0,0
23046,0,0,45,0,-45
23047,1,1,490,1656,1166
23048,1,0,2,0,-2
23049,0,0,67,0,-67
23050,0,0,181,0,-181
23051,0,0,64,0,-64
23052,0,0,80,0,-80
23053,0,0,119,0,-119
23054,0,0,8,0,-8
23055,1,1,732,1295,563
23056,1,0,14,0,-14
23057,0,0,13,0,-13
23058,0,0,45,0,-45
23059,1,1,743,2234,1491
23060,0,0,113,0,-113
23061,0,0,118,0,-118
23062,0,0,67,0,-67
23063,0,0,62,0,-62
23064,1,0,256,0,-256
23065,0,0,0,0,0
23066,0,0,24,0,-24
23067,0,0,9,0,-9
23068,1,0,48,0,-48
23069,1,0,77,0,-77
23070,1,1,221,1228,1007
23071,1,0,31,0,-31
23072,1,0,0,0,0
23073,0,0,60,0,-60
23074,1,0,119,0,-119
23075,1,1,1065,1752,687
23076,0,0,31,0,-31
23077,0,0,3,0,-3
23078,1,1,440,1369,929
23079,0,0,44,0,-44
23080,1,0,0,0,0
23081,1,0,150,0,-150
23082,1,0,92,0,-92
23083,1,1,657,1362,705
23084,1,1,353,1459,1106
23085,0,0,73,0,-73
23086,1,0,45,0,-45
23087,1,1,141,1235,1094
23088,1,0,2,0,-2
23089,1,0,40,0,-40
23090,0,0,42,0,-42
23091,0,0,87,0,-87
23092,1,0,43,0,-43
23093,0,0,47,0,-47
23094,1,0,6,0,-6
23095,1,0,49,0,-49
23096,1,0,34,0,-34
23097,1,1,520,1600,1080
23098,1,1,854,1361,507
23099,0,0,39,0,-39
23100,0,0,32,0,-32
23101,1,1,374,1671,1297
23102,0,0,8,0,-8
23103,0,0,129,0,-129
23104,0,0,20,0,-20
23105,1,0,55,0,-55
23106,1,0,114,0,-114
23107,1,1,197,4488,4291
23108,0,0,65,0,-65
23109,0,0,14,0,-14
23110,1,0,74,0,-74
23111,0,0,19,0,-19
23112,1,0,58,0,-58
23113,1,1,187,1385,1198
23114,1,0,58,0,-58
23115,1,1,380,1316,936
23116,1,1,98,1393,1295
23117,1,0,75,0,-75
23118,1,1,334,1426,1092
23119,0,0,9,0,-9
23120,1,1,324,1573,1249
23121,1,0,75,0,-75
23122,1,0,2,0,-2
23123,0,0,62,0,-62
23124,0,0,0,0,0
23125,0,0,93,0,-93
23126,0,0,75,0,-75
23127,1,1,988,1370,382
23128,1,1,436,1526,1090
23129,0,0,48,0,-48
23130,0,0,224,0,-224
23131,0,0,109,0,-109
23132,0,0,84,0,-84
23133,0,0,0,0,0
23134,0,0,30,0,-30
23135,0,0,104,0,-104
23136,1,0,4,0,-4
23137,0,0,0,0,0
23138,0,0,10,0,-10
23139,0,0,1,0,-1
23140,1,1,182,1520,1338
23141,0,0,94,0,-94
23142,1,0,29,0,-29
23143,1,1,910,1342,432
23144,1,0,7,0,-7
23145,1,1,89,1377,1288
23146,1,0,42,0,-42
23147,0,0,89,0,-89
23148,0,0,1,0,-1
23149,1,0,7,0,-7
23150,1,0,13,0,-13
23151,1,1,441,1394,953
23152,1,0,5,0,-5
23153,1,0,11,0,-11
23154,1,1,543,1305,762
23155,0,0,5,0,-5
23156,1,0,192,0,-192
23157,1,1,143,1294,1151
23158,0,0,97,0,-97
23159,1,0,50,0,-50
23160,0,0,10,0,-10
23161,0,0,47,0,-47
23162,0,0,61,0,-61
23163,0,0,45,0,-45
23164,1,1,149,1420,1271
23165,1,0,9,0,-9
23166,0,0,71,0,-71
23167,1,1,739,1208,469
23168,1,1,271,2003,1732
23169,0,0,22,0,-22
23170,1,1,192,1523,1331
23171,0,0,31,0,-31
23172,1,1,817,1457,640
23173,1,0,14,0,-14
23174,1,1,57,1416,1359
23175,0,0,43,0,-43
23176,0,0,32,0,-32
23177,0,0,40,0,-40
23178,0,0,28,0,-28
23179,1,0,2,0,-2
23180,0,0,50,0,-50
23181,1,1,699,1578,879
23182,1,0,54,0,-54
23183,1,0,27,0,-27
23184,1,1,675,1334,659
23185,1,0,6,0,-6
23186,1,1,73,1591,1518
23187,0,0,67,0,-67
23188,1,0,87,0,-87
23189,1,0,6,0,-6
23190,1,0,87,0,-87
23191,1,0,17,0,-17
23192,0,0,1,0,-1
23193,1,1,148,1308,1160
23194,1,0,209,0,-209
23195,1,1,103,1389,1286
23196,1,1,1001,1208,207
23197,0,0,12,0,-12
23198,1,0,146,0,-146
23199,0,0,19,0,-19
23200,1,0,15,0,-15
23201,0,0,72,0,-72
23202,1,0,12,0,-12
23203,0,0,20,0,-20
23204,0,0,8,0,-8
23205,1,1,626,1734,1108
23206,1,1,2207,1909,-298
23207,0,0,17,0,-17
23208,1,0,42,0,-42
23209,0,0,10,0,-10
23210,1,0,126,0,-126
23211,0,0,47,0,-47
23212,0,0,6,0,-6
23213,0,0,10,0,-10
23214,1,1,119,1252,1133
23215,1,1,285,1238,953
23216,1,0,43,0,-43
23217,1,1,472,1340,868
23218,0,0,11,0,-11
23219,1,0,13,0,-13
23220,0,0,70,0,-70
23221,0,0,104,0,-104
23222,0,0,59,0,-59
23223,1,0,3,0,-3
23224,0,0,36,0,-36
23225,1,1,334,2849,2515
23226,1,1,2914,1209,-1705
23227,1,1,270,1234,964
23228,0,0,9,0,-9
23229,1,1,1244,1232,-12
23230,1,1,103,2077,1974
23231,0,0,7,0,-7
23232,1,1,716,1229,513
23233,1,0,76,0,-76
23234,1,1,363,1506,1143
23235,1,0,129,0,-129
23236,1,1,403,1396,993
23237,0,0,22,0,-22
23238,1,0,21,0,-21
23239,1,1,1319,1310,-9
23240,0,0,83,0,-83
23241,0,0,44,0,-44
23242,0,0,5,0,-5
23243,0,0,51,0,-51
23244,1,1,431,1736,1305
23245,1,1,367,1402,1035
23246,1,0,1,0,-1
23247,1,1,732,1220,488
23248,1,0,42,0,-42
23249,0,0,50,0,-50
23250,0,0,8,0,-8
23251,1,0,3,0,-3
23252,1,1,95,1518,1423
23253,1,0,45,0,-45
23254,1,1,1896,1203,-693
23255,0,0,112,0,-112
23256,0,0,0,0,0
23257,1,1,896,1468,572
23258,0,0,10,0,-10
23259,0,0,82,0,-82
23260,1,1,838,1224,386
23261,1,0,36,0,-36
23262,1,0,56,0,-56
23263,1,1,182,1225,1043
23264,1,0,178,0,-178
23265,1,1,377,1360,983
23266,0,0,34,0,-34
23267,0,0,87,0,-87
23268,1,0,2,0,-2
23269,1,1,234,1309,1075
23270,1,1,25,1319,1294
23271,1,0,13,0,-13
23272,0,0,2,0,-2
23273,1,0,2,0,-2
23274,1,1,309,3242,2933
23275,1,1,130,1639,1509
23276,1,0,68,0,-68
23277,0,0,24,0,-24
23278,1,1,724,1766,1042
23279,0,0,9,0,-9
23280,1,1,300,2426,2126
23281,0,0,45,0,-45
23282,0,0,77,0,-77
23283,1,1,233,1216,983
23284,0,0,19,0,-19
23285,1,0,59,0,-59
23286,0,0,63,0,-63
23287,1,0,39,0,-39
23288,1,0,30,0,-30
23289,0,0,87,0,-87
23290,0,0,76,0,-76
23291,1,0,281,0,-281
23292,0,0,118,0,-118
23293,0,0,17,0,-17
23294,0,0,21,0,-21
23295,0,0,5,0,-5
23296,1,1,1684,1712,28
23297,1,0,22,0,-22
23298,1,0,0,0,0
23299,0,0,31,0,-31
23300,1,1,536,1387,851
23301,1,1,46,1495,1449
23302,1,1,25,1709,1684
23303,1,1,61,1591,1530
23304,0,0,53,0,-53
23305,0,0,49,0,-49
23306,0,0,125,0,-125
23307,1,0,60,0,-60
23308,1,0,73,0,-73
23309,1,0,16,0,-16
23310,0,0,39,0,-39
23311,1,0,139,0,-139
23312,1,0,34,0,-34
23313,0,0,70,0,-70
23314,0,0,231,0,-231
23315,0,0,31,0,-31
23316,1,1,65,1274,1209
23317,0,0,1,0,-1
23318,1,1,310,1242,932
23319,0,0,24,0,-24
23320,1,0,90,0,-90
23321,1,1,2466,1606,-860
23322,1,0,6,0,-6
23323,1,0,8,0,-8
23324,1,0,27,0,-27
23325,0,0,67,0,-67
23326,1,1,172,1274,1102
23327,0,0,7,0,-7
23328,1,1,45,1434,1389
23329,1,1,298,1236,938
23330,1,1,710,1564,854
23331,0,0,57,0,-57
23332,0,0,38,0,-38
23333,1,1,3,1320,1317
23334,0,0,16,0,-16
23335,0,0,144,0,-144
23336,0,0,80,0,-80
23337,1,1,190,1327,1137
23338,1,0,76,0,-76
23339,0,0,61,0,-61
23340,1,1,250,1766,1516
23341,0,0,4,0,-4
23342,1,0,17,0,-17
23343,1,0,83,0,-83
23344,0,0,5,0,-5
23345,1,0,129,0,-129
23346,0,0,30,0,-30
23347,1,0,8,0,-8
23348,1,1,508,1578,1070
23349,1,0,30,0,-30
23350,1,1,653,1905,1252
23351,1,0,65,0,-65
23352,1,1,454,1200,746
23353,1,1,242,1217,975
23354,1,1,217,1635,1418
23355,1,1,948,1328,380
23356,0,0,13,0,-13
23357,0,0,0,0,0
23358,1,0,60,0,-60
23359,0,0,13,0,-13
23360,0,0,44,0,-44
23361,1,1,51,1988,1937
23362,1,1,174,1984,1810
23363,0,0,23,0,-23
23364,1,1,561,1336,775
23365,1,1,126,1548,1422
23366,1,1,51,1566,1515
23367,0,0,5,0,-5
23368,1,0,76,0,-76
23369,0,0,54,0,-54
23370,1,0,35,0,-35
23371,0,0,17,0,-17
23372,1,0,33,0,-33
23373,0,0,16,0,-16
23374,0,0,30,0,-30
23375,1,0,43,0,-43
23376,1,1,393,1581,1188
23377,0,0,89,0,-89
23378,1,0,124,0,-124
23379,1,0,83,0,-83
23380,1,0,16,0,-16
23381,0,0,62,0,-62
23382,0,0,56,0,-56
23383,1,1,237,1235,998
23384,1,0,23,0,-23
23385,0,0,9,0,-9
23386,0,0,116,0,-116
23387,0,0,1,0,-1
23388,1,1,42,1329,1287
23389,0,0,45,0,-45
23390,1,0,11,0,-11
23391,1,1,338,1219,881
23392,1,0,18,0,-18
23393,0,0,76,0,-76
23394,1,0,91,0,-91
23395,1,0,17,0,-17
23396,0,0,22,0,-22
23397,1,1,395,2056,1661
23398,0,0,9,0,-9
23399,0,0,6,0,-6
23400,0,0,183,0,-183
23401,1,1,154,1360,1206
23402,1,1,382,1488,1106
23403,0,0,58,0,-58
23404,1,0,88,0,-88
23405,1,1,493,1617,1124
23406,0,0,59,0,-59
23407,1,0,0,0,0
23408,0,0,3,0,-3
23409,1,1,543,1306,763
23410,1,1,73,1688,1615
23411,1,0,8,0,-8
23412,0,0,89,0,-89
23413,1,0,65,0,-65
23414,0,0,18,0,-18
23415,1,0,0,0,0
23416,1,0,3,0,-3
23417,1,1,203,1212,1009
23418,1,1,472,1622,1150
23419,1,0,89,0,-89
23420,1,0,58,0,-58
23421,1,0,303,0,-303
23422,1,1,216,2096,1880
23423,1,0,31,0,-31
23424,0,0,49,0,-49
23425,0,0,24,0,-24
23426,0,0,0,0,0
23427,0,0,43,0,-43
23428,0,0,54,0,-54
23429,1,1,850,1266,416
23430,1,0,20,0,-20
23431,1,1,75,2174,2099
23432,0,0,23,0,-23
23433,0,0,3,0,-3
23434,0,0,11,0,-11
23435,1,1,483,1364,881
23436,0,0,2,0,-2
23437,0,0,34,0,-34
23438,1,0,31,0,-31
23439,0,0,81,0,-81
23440,0,0,11,0,-11
23441,0,0,69,0,-69
23442,1,0,41,0,-41
23443,1,1,620,1210,590
23444,0,0,0,0,0
23445,0,0,28,0,-28
23446,1,0,85,0,-85
23447,0,0,95,0,-95
23448,1,0,349,0,-349
23449,1,1,622,1362,740
23450,0,0,2,0,-2
23451,0,0,54,0,-54
23452,0,0,12,0,-12
23453,1,0,28,0,-28
23454,0,0,40,0,-40
23455,0,0,45,0,-45
23456,0,0,37,0,-37
23457,0,0,17,0,-17
23458,1,1,210,1596,1386
23459,1,0,34,0,-34
23460,1,1,49,1233,1184
23461,0,0,98,0,-98
23462,0,0,253,0,-253
23463,0,0,106,0,-106
23464,0,0,83,0,-83
23465,1,1,1536,1286,-250
23466,1,0,110,0,-110
23467,0,0,89,0,-89
23468,1,0,116,0,-116
23469,1,1,147,1353,1206
23470,1,1,723,1339,616
23471,1,1,187,1600,1413
23472,0,0,131,0,-131
23473,1,0,247,0,-247
23474,1,0,34,0,-34
23475,1,1,11,1433,1422
23476,1,1,470,1255,785
23477,0,0,39,0,-39
23478,0,0,39,0,-39
23479,0,0,16,0,-16
23480,1,1,1080,1400,320
23481,1,1,76,1329,1253
23482,0,0,46,0,-46
23483,1,1,401,1641,1240
23484,0,0,2,0,-2
23485,0,0,66,0,-66
23486,0,0,40,0,-40
23487,0,0,50,0,-50
23488,0,0,0,0,0
23489,1,1,609,1226,617
23490,1,0,123,0,-123
23491,0,0,57,0,-57
23492,1,1,194,1367,1173
23493,1,0,28,0,-28
23494,1,1,80,1309,1229
23495,0,0,46,0,-46
23496,1,1,616,1374,758
23497,1,0,33,0,-33
23498,1,1,335,1396,1061
23499,0,0,208,0,-208
23500,0,0,21,0,-21
23501,1,1,1505,1249,-256
23502,1,1,97,1505,1408
23503,0,0,16,0,-16
23504,1,1,646,1435,789
23505,1,0,35,0,-35
23506,1,1,145,1319,1174
23507,1,1,331,1463,1132
23508,1,1,71,1359,1288
23509,1,0,106,0,-106
23510,0,0,128,0,-128
23511,0,0,30,0,-30
23512,1,1,305,1234,929
23513,1,0,3,0,-3
23514,1,0,35,0,-35
23515,1,1,1442,1239,-203
23516,1,1,1215,1655,440
23517,1,1,715,1295,580
23518,0,0,60,0,-60
23519,0,0,10,0,-10
23520,1,1,1179,1224,45
23521,1,1,585,1455,870
23522,1,1,1223,1214,-9
23523,1,0,105,0,-105
23524,0,0,33,0,-33
23525,0,0,33,0,-33
23526,1,1,348,2544,2196
23527,1,1,489,1366,877
23528,1,1,700,1955,1255
23529,1,1,157,1241,1084
23530,1,0,63,0,-63
23531,0,0,50,0,-50
23532,0,0,76,0,-76
23533,0,0,20,0,-20
23534,0,0,41,0,-41
23535,1,1,869,1691,822
23536,0,0,0,0,0
23537,0,0,31,0,-31
23538,1,0,58,0,-58
23539,0,0,57,0,-57
23540,0,0,41,0,-41
23541,1,1,313,1592,1279
23542,1,1,524,2608,2084
23543,1,0,23,0,-23
23544,1,1,443,1320,877
23545,0,0,55,0,-55
23546,1,0,190,0,-190
23547,1,1,124,1294,1170
23548,1,0,6,0,-6
23549,0,0,18,0,-18
23550,0,0,142,0,-142
23551,0,0,16,0,-16
23552,0,0,14,0,-14
23553,1,1,195,1330,1135
23554,1,0,61,0,-61
23555,1,0,0,0,0
23556,1,1,158,1449,1291
23557,1,0,37,0,-37
23558,1,1,1510,1217,-293
23559,1,1,624,1477,853
23560,1,0,78,0,-78
23561,0,0,62,0,-62
23562,0,0,32,0,-32
23563,1,1,148,1372,1224
23564,0,0,80,0,-80
23565,1,1,545,1632,1087
23566,0,0,25,0,-25
23567,0,0,2,0,-2
23568,1,1,1482,1701,219
23569,0,0,10,0,-10
23570,0,0,197,0,-197
23571,1,0,36,0,-36
23572,1,1,286,1442,1156
23573,0,0,16,0,-16
23574,1,1,45,1324,1279
23575,1,0,75,0,-75
23576,0,0,226,0,-226
23577,0,0,2,0,-2
23578,0,0,19,0,-19
23579,1,0,13,0,-13
23580,1,1,1099,1945,846
23581,0,0,38,0,-38
23582,1,1,1133,1463,330
23583,1,0,59,0,-59
23584,0,0,60,0,-60
23585,0,0,1,0,-1
23586,1,1,457,1709,1252
23587,1,0,71,0,-71
23588,0,0,80,0,-80
23589,0,0,54,0,-54
23590,1,1,382,1739,1357
23591,0,0,48,0,-48
23592,0,0,22,0,-22
23593,0,0,53,0,-53
23594,0,0,42,0,-42
23595,0,0,17,0,-17
23596,1,0,3,0,-3
23597,1,1,532,2394,1862
23598,0,0,29,0,-29
23599,0,0,12,0,-12
23600,1,0,7,0,-7
23601,1,1,1170,1273,103
23602,0,0,79,0,-79
23603,1,1,330,1825,1495
23604,1,1,94,1413,1319
23605,0,0,27,0,-27
23606,1,0,32,0,-32
23607,1,1,906,1628,722
23608,0,0,20,0,-20
23609,1,0,2,0,-2
23610,1,0,18,0,-18
23611,1,0,7,0,-7
23612,0,0,16,0,-16
23613,0,0,30,0,-30
23614,0,0,46,0,-46
23615,1,0,10,0,-10
23616,1,1,340,1229,889
23617,1,0,0,0,0
23618,1,1,48,1469,1421
23619,1,0,53,0,-53
23620,0,0,93,0,-93
23621,1,1,230,1229,999
23622,1,0,127,0,-127
23623,0,0,94,0,-94
23624,1,1,953,1417,464
23625,0,0,18,0,-18
23626,1,0,119,0,-119
23627,0,0,34,0,-34
23628,0,0,67,0,-67
23629,0,0,33,0,-33
23630,1,1,435,1390,955
23631,1,1,335,1523,1188
23632,0,0,18,0,-18
23633,0,0,151,0,-151
23634,0,0,72,0,-72
23635,1,1,31,1984,1953
23636,1,1,1297,1452,155
23637,1,1,116,1938,1822
23638,1,1,1249,1241,-8
23639,0,0,14,0,-14
23640,1,1,386,1964,1578
23641,0,0,10,0,-10
23642,0,0,8,0,-8
23643,1,0,165,0,-165
23644,1,0,55,0,-55
23645,1,1,897,1479,582
23646,1,1,387,1209,822
23647,1,1,90,1328,1238
23648,0,0,31,0,-31
23649,0,0,59,0,-59
23650,1,0,0,0,0
23651,0,0,63,0,-63
23652,0,0,46,0,-46
23653,1,0,24,0,-24
23654,1,1,1198,1253,55
23655,1,0,27,0,-27
23656,0,0,36,0,-36
23657,0,0,33,0,-33
23658,0,0,108,0,-108
23659,1,0,94,0,-94
23660,1,0,0,0,0
23661,1,0,57,0,-57
23662,1,1,408,1494,1086
23663,1,0,73,0,-73
23664,1,1,585,1787,1202
23665,0,0,80,0,-80
23666,0,0,58,0,-58
23667,0,0,67,0,-67
23668,1,0,2,0,-2
23669,0,0,19,0,-19
23670,0,0,58,0,-58
23671,1,0,82,0,-82
23672,1,1,498,1312,814
23673,0,0,45,0,-45
23674,1,0,12,0,-12
23675,1,0,0,0,0
23676,1,0,8,0,-8
23677,0,0,10,0,-10
23678,1,0,30,0,-30
23679,0,0,45,0,-45
23680,0,0,5,0,-5
23681,1,0,117,0,-117
23682,0,0,17,0,-17
23683,1,1,80,1650,1570
23684,1,0,23,0,-23
23685,1,0,24,0,-24
23686,0,0,10,0,-10
23687,1,0,0,0,0
23688,0,0,8,0,-8
23689,0,0,19,0,-19
23690,1,0,91,0,-91
23691,0,0,58,0,-58
23692,0,0,43,0,-43
23693,1,1,726,2068,1342
23694,0,0,2,0,-2
23695,1,1,259,2142,1883
23696,1,0,10,0,-10
23697,1,1,1016,1417,401
23698,1,1,384,1277,893
23699,1,0,35,0,-35
23700,1,0,543,0,-543
23701,1,0,34,0,-34
23702,0,0,60,0,-60
23703,0,0,9,0,-9
23704,0,0,84,0,-84
23705,1,1,1054,1242,188
23706,0,0,35,0,-35
23707,1,0,8,0,-8
23708,1,1,782,1310,528
23709,0,0,4,0,-4
23710,1,1,83,1232,1149
23711,1,1,983,1823,840
23712,1,1,771,1755,984
23713,1,1,326,1673,1347
23714,0,0,98,0,-98
23715,0,0,50,0,-50
23716,1,1,575,1204,629
23717,1,1,260,1246,986
23718,0,0,26,0,-26
23719,0,0,26,0,-26
23720,0,0,5,0,-5
23721,1,1,182,1385,1203
23722,1,0,133,0,-133
23723,1,0,30,0,-30
23724,1,1,1022,1653,631
23725,0,0,28,0,-28
23726,0,0,4,0,-4
23727,1,0,54,0,-54
23728,1,0,201,0,-201
23729,0,0,20,0,-20
23730,1,0,2,0,-2
23731,1,1,318,1369,1051
23732,1,1,117,1337,1220
23733,0,0,74,0,-74
23734,1,1,319,1456,1137
23735,0,0,25,0,-25
23736,1,0,42,0,-42
23737,1,0,51,0,-51
23738,0,0,20,0,-20
23739,1,1,313,1388,1075
23740,1,0,5,0,-5
23741,1,0,56,0,-56
23742,1,0,30,0,-30
23743,1,1,202,1402,1200
23744,0,0,38,0,-38
23745,1,0,9,0,-9
23746,0,0,112,0,-112
23747,0,0,11,0,-11
23748,0,0,81,0,-81
23749,1,1,716,1364,648
23750,1,0,208,0,-208
23751,1,0,41,0,-41
23752,1,0,9,0,-9
23753,0,0,68,0,-68
23754,0,0,17,0,-17
23755,0,0,4,0,-4
23756,1,0,92,0,-92
23757,0,0,99,0,-99
23758,1,0,4,0,-4
23759,1,0,25,0,-25
23760,1,0,4,0,-4
23761,1,0,99,0,-99
23762,1,1,256,2152,1896
23763,1,1,563,1264,701
23764,1,1,115,1222,1107
23765,1,1,1498,1244,-254
23766,1,0,57,0,-57
23767,1,0,33,0,-33
23768,1,0,61,0,-61
23769,1,1,1408,1763,355
23770,0,0,277,0,-277
23771,1,0,36,0,-36
23772,1,1,294,1566,1272
23773,1,1,302,1365,1063
23774,0,0,28,0,-28
23775,1,0,24,0,-24
23776,0,0,8,0,-8
23777,1,0,114,0,-114
23778,1,0,9,0,-9
23779,0,0,140,0,-140
23780,1,0,8,0,-8
23781,0,0,17,0,-17
23782,1,1,98,1314,1216
23783,1,0,58,0,-58
23784,1,1,2686,1704,-982
23785,1,1,179,1211,1032
23786,1,0,79,0,-79
23787,0,0,38,0,-38
23788,1,1,1408,1745,337
23789,1,1,919,1359,440
23790,1,0,22,0,-22
23791,1,1,149,1354,1205
23792,0,0,9,0,-9
23793,1,0,36,0,-36
23794,1,0,42,0,-42
23795,1,0,105,0,-105
23796,1,0,72,0,-72
23797,0,0,59,0,-59
23798,0,0,13,0,-13
23799,1,0,5,0,-5
23800,1,0,21,0,-21
23801,1,1,1140,2030,890
23802,1,0,71,0,-71
23803,0,0,36,0,-36
23804,1,0,30,0,-30
23805,0,0,23,0,-23
23806,1,0,12,0,-12
23807,1,1,36,1515,1479
23808,0,0,18,0,-18
23809,0,0,5,0,-5
23810,1,0,99,0,-99
23811,0,0,146,0,-146
23812,1,0,8,0,-8
23813,1,1,2006,1432,-574
23814,1,1,286,1244,958
23815,1,0,90,0,-90
23816,1,1,691,1267,576
23817,1,1,308,1778,1470
23818,1,1,278,1646,1368
23819,1,0,10,0,-10
23820,1,0,73,0,-73
23821,1,1,747,1327,580
23822,1,0,36,0,-36
23823,0,0,11,0,-11
23824,1,0,4,0,-4
23825,1,1,841,1889,1048
23826,1,1,373,2067,1694
23827,0,0,0,0,0
23828,1,1,432,1761,1329
23829,0,0,42,0,-42
23830,1,0,10,0,-10
23831,1,0,42,0,-42
23832,1,0,15,0,-15
23833,1,0,6,0,-6
23834,1,0,86,0,-86
23835,1,0,81,0,-81
23836,1,1,167,1344,1177
23837,1,0,57,0,-57
23838,1,0,13,0,-13
23839,1,0,9,0,-9
23840,1,0,87,0,-87
23841,0,0,10,0,-10
23842,1,0,14,0,-14
23843,1,0,30,0,-30
23844,0,0,71,0,-71
23845,0,0,31,0,-31
23846,0,0,57,0,-57
23847,1,1,464,1251,787
23848,1,0,97,0,-97
23849,1,1,179,1471,1292
23850,0,0,56,0,-56
23851,0,0,21,0,-21
23852,1,1,102,1654,1552
23853,1,1,127,1611,1484
23854,0,0,2,0,-2
23855,1,1,2363,1250,-1113
23856,1,0,2,0,-2
23857,0,0,21,0,-21
23858,1,0,26,0,-26
23859,1,0,40,0,-40
23860,1,0,11,0,-11
23861,0,0,12,0,-12
23862,0,0,10,0,-10
23863,1,1,533,1960,1427
23864,0,0,17,0,-17
23865,1,1,555,1211,656
23866,1,0,37,0,-37
23867,1,0,144,0,-144
23868,1,1,199,3112,2913
23869,1,0,142,0,-142
23870,1,1,1819,1214,-605
23871,0,0,7,0,-7
23872,0,0,38,0,-38
23873,0,0,23,0,-23
23874,1,0,19,0,-19
23875,0,0,62,0,-62
23876,0,0,16,0,-16
23877,1,0,35,0,-35
23878,0,0,24,0,-24
23879,0,0,9,0,-9
23880,1,0,28,0,-28
23881,0,0,28,0,-28
23882,0,0,88,0,-88
23883,0,0,41,0,-41
23884,0,0,11,0,-11
23885,1,0,214,0,-214
23886,1,1,289,1287,998
23887,0,0,63,0,-63
23888,1,0,0,0,0
23889,1,0,132,0,-132
23890,1,1,183,1359,1176
23891,0,0,23,0,-23
23892,1,0,20,0,-20
23893,1,1,193,1443,1250
23894,0,0,37,0,-37
23895,1,1,520,4441,3921
23896,0,0,202,0,-202
23897,1,0,2,0,-2
23898,0,0,163,0,-163
23899,1,1,606,1453,847
23900,1,0,62,0,-62
23901,1,1,407,1743,1336
23902,1,0,95,0,-95
23903,0,0,8,0,-8
23904,1,1,1127,1604,477
23905,0,0,71,0,-71
23906,1,0,147,0,-147
23907,0,0,17,0,-17
23908,1,1,312,1273,961
23909,1,1,279,1430,1151
23910,0,0,28,0,-28
23911,1,1,248,2749,2501
23912,1,1,1782,1543,-239
23913,1,0,30,0,-30
23914,0,0,11,0,-11
23915,1,1,162,1937,1775
23916,0,0,28,0,-28
23917,1,1,170,1281,1111
23918,1,0,3,0,-3
23919,1,1,363,1534,1171
23920,1,1,61,1313,1252
23921,0,0,54,0,-54
23922,0,0,22,0,-22
23923,1,1,99,1459,1360
23924,1,1,2307,1206,-1101
23925,1,0,29,0,-29
23926,0,0,21,0,-21
23927,1,0,8,0,-8
23928,0,0,21,0,-21
23929,1,0,156,0,-156
23930,0,0,87,0,-87
23931,0,0,146,0,-146
23932,1,0,58,0,-58
23933,0,0,22,0,-22
23934,1,0,13,0,-13
23935,1,0,78,0,-78
23936,1,0,109,0,-109
23937,1,1,162,1619,1457
23938,1,0,57,0,-57
23939,0,0,108,0,-108
23940,0,0,3,0,-3
23941,1,1,455,1716,1261
23942,0,0,41,0,-41
23943,1,1,758,1463,705
23944,1,0,77,0,-77
23945,1,1,452,2637,2185
23946,0,0,6,0,-6
23947,1,0,38,0,-38
23948,0,0,167,0,-167
23949,1,0,46,0,-46
23950,1,1,292,1280,988
23951,0,0,34,0,-34
23952,1,0,25,0,-25
23953,1,1,104,1360,1256
23954,1,1,557,2119,1562
23955,0,0,6,0,-6
23956,1,1,1057,1253,196
23957,1,1,212,1585,1373
23958,0,0,48,0,-48
23959,1,0,30,0,-30
23960,1,0,24,0,-24
23961,1,0,49,0,-49
23962,1,1,325,1652,1327
23963,1,1,771,1317,546
23964,1,1,580,1224,644
23965,0,0,151,0,-151
23966,1,1,408,1583,1175
23967,0,0,47,0,-47
23968,1,0,20,0,-20
23969,1,1,678,1452,774
23970,1,1,297,1226,929
23971,1,1,413,1311,898
23972,0,0,18,0,-18
23973,0,0,61,0,-61
23974,0,0,93,0,-93
23975,0,0,8,0,-8
23976,1,1,658,1541,883
23977,1,0,4,0,-4
23978,1,1,1048,1386,338
23979,0,0,10,0,-10
23980,1,1,242,1406,1164
23981,1,1,376,1225,849
23982,0,0,20,0,-20
23983,1,1,137,1370,1233
23984,1,1,1124,1441,317
23985,1,0,16,0,-16
23986,1,1,244,1330,1086
23987,0,0,1,0,-1
23988,1,1,599,1204,605
23989,0,0,156,0,-156
23990,0,0,5,0,-5
23991,0,0,51,0,-51
23992,0,0,20,0,-20
23993,0,0,119,0,-119
23994,1,1,244,1437,1193
23995,0,0,69,0,-69
23996,0,0,4,0,-4
23997,0,0,27,0,-27
23998,0,0,39,0,-39
23999,1,1,1222,1443,221
24000,0,0,65,0,-65
24001,1,1,86,1410,1324
24002,1,0,4,0,-4
24003,0,0,27,0,-27
24004,0,0,34,0,-34
24005,0,0,4,0,-4
24006,1,0,177,0,-177
24007,1,0,14,0,-14
24008,1,1,463,1290,827
24009,1,1,145,1320,1175
24010,0,0,151,0,-151
24011,0,0,63,0,-63
24012,1,0,45,0,-45
24013,0,0,3,0,-3
24014,0,0,6,0,-6
24015,1,1,413,1981,1568
24016,1,1,169,1925,1756
24017,0,0,10,0,-10
24018,1,1,965,1202,237
24019,1,0,151,0,-151
24020,1,1,784,1787,1003
24021,1,0,8,0,-8
24022,0,0,158,0,-158
24023,1,0,3,0,-3
24024,0,0,58,0,-58
24025,1,1,1925,1266,-659
24026,1,0,99,0,-99
24027,1,1,292,1381,1089
24028,1,1,319,1277,958
24029,1,0,17,0,-17
24030,1,0,70,0,-70
24031,1,1,363,1870,1507
24032,1,1,522,1289,767
24033,0,0,10,0,-10
24034,1,1,321,1287,966
24035,1,0,14,0,-14
24036,0,0,110,0,-110
24037,1,0,65,0,-65
24038,1,1,378,1363,985
24039,1,1,662,1532,870
24040,0,0,120,0,-120
24041,0,0,51,0,-51
24042,0,0,53,0,-53
24043,1,1,335,1345,1010
24044,1,0,64,0,-64
24045,1,1,818,1300,482
24046,1,0,19,0,-19
24047,1,1,265,1552,1287
24048,1,1,90,1697,1607
24049,0,0,27,0,-27
24050,1,1,762,1404,642
24051,1,0,17,0,-17
24052,0,0,16,0,-16
24053,0,0,18,0,-18
24054,0,0,0,0,0
24055,0,0,66,0,-66
24056,1,0,29,0,-29
24057,0,0,28,0,-28
24058,1,1,83,1533,1450
24059,1,0,42,0,-42
24060,0,0,85,0,-85
24061,1,1,123,1228,1105
24062,1,1,294,1392,1098
24063,1,1,157,1654,1497
24064,0,0,5,0,-5
24065,0,0,7,0,-7
24066,0,0,73,0,-73
24067,1,1,384,1202,818
24068,1,1,565,1350,785
24069,0,0,33,0,-33
24070,1,0,149,0,-149
24071,1,1,107,1281,1174
24072,1,1,73,1216,1143
24073,1,1,580,1422,842
24074,1,1,566,5445,4879
24075,1,1,684,3661,2977
24076,1,1,2251,2598,347
24077,1,0,13,0,-13
24078,0,0,21,0,-21
24079,0,0,3,0,-3
24080,1,0,6,0,-6
24081,0,0,30,0,-30
24082,0,0,21,0,-21
24083,1,0,24,0,-24
24084,0,0,95,0,-95
24085,1,1,415,1285,870
24086,0,0,25,0,-25
24087,1,0,23,0,-23
24088,0,0,87,0,-87
24089,1,1,85,1254,1169
24090,0,0,110,0,-110
24091,1,1,81,1299,1218
24092,0,0,57,0,-57
24093,1,1,236,2226,1990
24094,0,0,58,0,-58
24095,0,0,1,0,-1
24096,1,1,87,1473,1386
24097,1,0,46,0,-46
24098,1,0,80,0,-80
24099,1,1,328,1591,1263
24100,1,0,42,0,-42
24101,1,0,50,0,-50
24102,1,0,7,0,-7
24103,0,0,18,0,-18
24104,0,0,23,0,-23
24105,0,0,31,0,-31
24106,1,0,22,0,-22
24107,1,0,39,0,-39
24108,0,0,36,0,-36
24109,1,1,644,1995,1351
24110,1,1,274,1367,1093
24111,1,0,12,0,-12
24112,0,0,3,0,-3
24113,0,0,253,0,-253
24114,0,0,3,0,-3
24115,0,0,8,0,-8
24116,1,1,51,1253,1202
24117,1,0,1,0,-1
24118,1,1,106,1215,1109
24119,0,0,57,0,-57
24120,1,0,31,0,-31
24121,0,0,27,0,-27
24122,0,0,44,0,-44
24123,1,0,23,0,-23
24124,1,1,60,1540,1480
24125,1,0,51,0,-51
24126,1,1,33,1448,1415
24127,0,0,37,0,-37
24128,1,1,3382,1213,-2169
24129,0,0,113,0,-113
24130,0,0,192,0,-192
24131,0,0,0,0,0
24132,1,0,31,0,-31
24133,0,0,25,0,-25
24134,1,0,35,0,-35
24135,1,1,556,1307,751
24136,1,1,489,1547,1058
24137,0,0,8,0,-8
24138,1,1,1423,1670,247
24139,0,0,13,0,-13
24140,0,0,1,0,-1
24141,0,0,186,0,-186
24142,1,1,436,1822,1386
24143,1,0,15,0,-15
24144,1,1,204,2049,1845
24145,1,0,11,0,-11
24146,1,0,10,0,-10
24147,1,0,5,0,-5
24148,1,1,121,1202,1081
24149,0,0,27,0,-27
24150,1,1,163,2292,2129
24151,1,1,228,1337,1109
24152,1,0,123,0,-123
24153,1,1,405,1976,1571
24154,0,0,1,0,-1
24155,1,1,983,1353,370
24156,0,0,18,0,-18
24157,0,0,24,0,-24
24158,0,0,15,0,-15
24159,1,1,463,3489,3026
24160,0,0,87,0,-87
24161,1,1,746,2171,1425
24162,1,0,23,0,-23
24163,0,0,22,0,-22
24164,0,0,4,0,-4
24165,1,1,369,1327,958
24166,0,0,67,0,-67
24167,0,0,0,0,0
24168,1,1,77,1300,1223
24169,0,0,19,0,-19
24170,1,1,88,1589,1501
24171,0,0,7,0,-7
24172,0,0,20,0,-20
24173,1,0,13,0,-13
24174,1,1,369,1435,1066
24175,1,0,90,0,-90
24176,1,0,64,0,-64
24177,0,0,115,0,-115
24178,1,1,313,1912,1599
24179,0,0,27,0,-27
24180,1,0,14,0,-14
24181,0,0,103,0,-103
24182,1,0,7,0,-7
24183,0,0,41,0,-41
24184,0,0,14,0,-14
24185,0,0,17,0,-17
24186,1,0,55,0,-55
24187,1,0,65,0,-65
24188,0,0,75,0,-75
24189,0,0,70,0,-70
24190,0,0,57,0,-57
24191,0,0,35,0,-35
24192,1,1,187,2064,1877
24193,1,0,1,0,-1
24194,1,0,71,0,-71
24195,1,0,28,0,-28
24196,1,0,39,0,-39
24197,1,0,6,0,-6
24198,1,1,341,1353,1012
24199,0,0,7,0,-7
24200,1,1,139,1209,1070
24201,1,1,118,1315,1197
24202,1,1,194,1511,1317
24203,1,1,352,1360,1008
24204,1,0,75,0,-75
24205,1,0,23,0,-23
24206,1,1,158,1499,1341
24207,1,1,294,1944,1650
24208,1,0,1,0,-1
24209,1,0,46,0,-46
24210,0,0,44,0,-44
24211,1,0,78,0,-78
24212,1,0,25,0,-25
24213,1,1,217,1884,1667
24214,0,0,1,0,-1
24215,1,1,375,1467,1092
24216,1,0,8,0,-8
24217,1,0,20,0,-20
24218,0,0,61,0,-61
24219,1,0,74,0,-74
24220,1,0,13,0,-13
24221,1,0,128,0,-128
24222,1,0,8,0,-8
24223,1,0,60,0,-60
24224,0,0,19,0,-19
24225,1,1,159,1305,1146
24226,1,1,927,1411,484
24227,0,0,10,0,-10
24228,0,0,18,0,-18
24229,1,1,519,1387,868
24230,0,0,13,0,-13
24231,0,0,23,0,-23
24232,1,1,854,1334,480
24233,1,1,221,1501,1280
24234,1,1,204,1610,1406
24235,1,1,189,1511,1322
24236,1,1,26,1239,1213
24237,1,1,436,1295,859
24238,1,0,38,0,-38
24239,0,0,5,0,-5
24240,0,0,50,0,-50
24241,1,1,217,1239,1022
24242,0,0,3,0,-3
24243,0,0,30,0,-30
24244,0,0,31,0,-31
24245,1,0,0,0,0
24246,1,1,874,1454,580
24247,1,0,52,0,-52
24248,0,0,13,0,-13
24249,0,0,7,0,-7
24250,1,0,1,0,-1
24251,1,1,686,1275,589
24252,1,1,1558,1815,257
24253,1,0,127,0,-127
24254,0,0,29,0,-29
24255,1,1,269,1336,1067
24256,0,0,137,0,-137
24257,1,0,15,0,-15
24258,0,0,17,0,-17
24259,1,1,451,2776,2325
24260,0,0,19,0,-19
24261,0,0,51,0,-51
24262,0,0,20,0,-20
24263,1,1,183,1374,1191
24264,1,0,131,0,-131
24265,1,1,1547,2462,915
24266,0,0,25,0,-25
24267,0,0,60,0,-60
24268,0,0,64,0,-64
24269,1,0,6,0,-6
24270,1,1,417,1215,798
24271,1,1,326,1335,1009
24272,1,0,67,0,-67
24273,1,0,108,0,-108
24274,1,0,30,0,-30
24275,0,0,19,0,-19
24276,1,1,931,1497,566
24277,1,1,1143,1213,70
24278,1,1,257,1373,1116
24279,0,0,6,0,-6
24280,0,0,22,0,-22
24281,0,0,3,0,-3
24282,0,0,2,0,-2
24283,1,1,812,2023,1211
24284,1,1,253,1285,1032
24285,1,1,2738,1362,-1376
24286,1,0,56,0,-56
24287,0,0,12,0,-12
24288,1,0,14,0,-14
24289,0,0,5,0,-5
24290,1,1,754,1397,643
24291,1,1,640,1340,700
24292,0,0,48,0,-48
24293,1,0,4,0,-4
24294,1,0,7,0,-7
24295,0,0,128,0,-128
24296,1,1,1008,1294,286
24297,1,0,132,0,-132
24298,1,1,402,1208,806
24299,1,1,525,2495,1970
24300,0,0,30,0,-30
24301,1,0,0,0,0
24302,0,0,46,0,-46
24303,0,0,0,0,0
24304,0,0,115,0,-115
24305,1,1,10,1499,1489
24306,1,0,0,0,0
24307,1,0,75,0,-75
24308,1,1,181,1829,1648
24309,0,0,22,0,-22
24310,0,0,53,0,-53
24311,1,1,359,1353,994
24312,1,0,47,0,-47
24313,1,1,42,1777,1735
24314,1,1,1043,1863,820
24315,1,1,1175,1482,307
24316,0,0,36,0,-36
24317,0,0,90,0,-90
24318,0,0,26,0,-26
24319,0,0,70,0,-70
24320,1,0,34,0,-34
24321,1,1,53,2532,2479
24322,1,0,77,0,-77
24323,1,0,52,0,-52
24324,1,0,146,0,-146
24325,0,0,89,0,-89
24326,0,0,77,0,-77
24327,0,0,39,0,-39
24328,0,0,1,0,-1
24329,1,0,6,0,-6
24330,0,0,67,0,-67
24331,1,1,108,1327,1219
24332,0,0,35,0,-35
24333,1,0,22,0,-22
24334,1,1,213,1461,1248
24335,0,0,237,0,-237
24336,1,0,17,0,-17
24337,1,0,25,0,-25
24338,0,0,15,0,-15
24339,1,0,30,0,-30
24340,0,0,36,0,-36
24341,1,0,9,0,-9
24342,0,0,34,0,-34
24343,1,1,299,1483,1184
24344,1,0,49,0,-49
24345,1,1,494,1382,888
24346,1,0,73,0,-73
24347,1,0,23,0,-23
24348,1,1,245,1292,1047
24349,1,0,45,0,-45
24350,1,1,365,1891,1526
24351,0,0,23,0,-23
24352,0,0,23,0,-23
24353,1,0,19,0,-19
24354,0,0,46,0,-46
24355,0,0,68,0,-68
24356,1,0,71,0,-71
24357,0,0,112,0,-112
24358,0,0,13,0,-13
24359,1,0,127,0,-127
24360,0,0,14,0,-14
24361,0,0,41,0,-41
24362,1,1,511,1229,718
24363,0,0,15,0,-15
24364,1,0,94,0,-94
24365,1,0,12,0,-12
24366,0,0,6,0,-6
24367,0,0,11,0,-11
24368,1,0,129,0,-129
24369,0,0,40,0,-40
24370,1,0,17,0,-17
24371,1,1,546,1285,739
24372,0,0,36,0,-36
24373,0,0,66,0,-66
24374,0,0,20,0,-20
24375,0,0,131,0,-131
24376,1,1,151,1341,1190
24377,1,1,1477,1800,323
24378,1,0,2,0,-2
24379,0,0,159,0,-159
24380,1,0,18,0,-18
24381,1,0,39,0,-39
24382,1,1,30,1483,1453
24383,1,0,22,0,-22
24384,1,1,369,1427,1058
24385,1,1,2334,1212,-1122
24386,0,0,54,0,-54
24387,1,1,154,1288,1134
24388,0,0,33,0,-33
24389,0,0,15,0,-15
24390,1,0,102,0,-102
24391,0,0,10,0,-10
24392,1,1,245,1205,960
24393,1,0,0,0,0
24394,1,1,1088,2479,1391
24395,1,1,151,1587,1436
24396,1,1,372,1314,942
24397,1,0,83,0,-83
24398,1,1,238,1492,1254
24399,1,0,6,0,-6
24400,0,0,11,0,-11
24401,1,1,1192,1248,56
24402,0,0,90,0,-90
24403,1,0,26,0,-26
24404,0,0,57,0,-57
24405,0,0,5,0,-5
24406,0,0,63,0,-63
24407,1,1,1196,1744,548
24408,1,1,275,1241,966
24409,0,0,1,0,-1
24410,1,1,369,1254,885
24411,1,0,37,0,-37
24412,1,0,99,0,-99
24413,1,1,207,1241,1034
24414,0,0,49,0,-49
24415,0,0,2,0,-2
24416,0,0,31,0,-31
24417,1,1,498,1833,1335
24418,1,0,16,0,-16
24419,1,0,13,0,-13
24420,1,1,243,1579,1336
24421,1,0,57,0,-57
24422,1,0,96,0,-96
24423,0,0,39,0,-39
24424,1,0,3,0,-3
24425,0,0,18,0,-18
24426,0,0,175,0,-175
24427,1,1,167,1326,1159
24428,0,0,12,0,-12
24429,0,0,19,0,-19
24430,1,1,688,1375,687
24431,1,1,581,1407,826
24432,0,0,61,0,-61
24433,1,1,607,1423,816
24434,1,1,439,1464,1025
24435,0,0,69,0,-69
24436,0,0,208,0,-208
24437,0,0,101,0,-101
24438,0,0,16,0,-16
24439,1,0,182,0,-182
24440,1,0,54,0,-54
24441,1,0,36,0,-36
24442,0,0,29,0,-29
24443,1,0,141,0,-141
24444,0,0,69,0,-69
24445,1,0,18,0,-18
24446,0,0,156,0,-156
24447,1,1,878,2185,1307
24448,1,1,240,3852,3612
24449,1,1,961,1460,499
24450,1,1,819,1626,807
24451,0,0,24,0,-24
24452,0,0,6,0,-6
24453,1,0,30,0,-30
24454,0,0,17,0,-17
24455,1,0,102,0,-102
24456,0,0,89,0,-89
24457,1,0,10,0,-10
24458,1,1,413,1257,844
24459,0,0,11,0,-11
24460,1,0,109,0,-109
24461,1,1,67,1211,1144
24462,1,0,7,0,-7
24463,0,0,61,0,-61
24464,1,1,1591,2138,547
24465,1,1,93,1480,1387
24466,0,0,168,0,-168
24467,0,0,37,0,-37
24468,1,1,1278,1340,62
24469,0,0,0,0,0
24470,0,0,15,0,-15
24471,0,0,25,0,-25
24472,0,0,138,0,-138
24473,1,1,167,1363,1196
24474,1,1,203,1794,1591
24475,1,0,121,0,-121
24476,0,0,8,0,-8
24477,1,1,625,1681,1056
24478,1,0,49,0,-49
24479,1,1,365,1247,882
24480,1,0,20,0,-20
24481,0,0,9,0,-9
24482,0,0,58,0,-58
24483,1,1,447,1606,1159
24484,1,0,1,0,-1
24485,0,0,89,0,-89
24486,1,0,41,0,-41
24487,1,0,28,0,-28
24488,1,1,96,1349,1253
24489,1,1,1467,1221,-246
24490,1,1,26,1205,1179
24491,1,0,2,0,-2
24492,1,1,313,2048,1735
24493,0,0,52,0,-52
24494,1,0,15,0,-15
24495,0,0,19,0,-19
24496,1,0,5,0,-5
24497,0,0,24,0,-24
24498,1,0,7,0,-7
24499,1,0,25,0,-25
24500,0,0,33,0,-33
24501,0,0,81,0,-81
24502,1,0,0,0,0
24503,0,0,15,0,-15
24504,1,0,7,0,-7
24505,0,0,3,0,-3
24506,1,1,195,1649,1454
24507,0,0,31,0,-31
24508,0,0,46,0,-46
24509,0,0,14,0,-14
24510,1,1,479,1305,826
24511,1,0,38,0,-38
24512,0,0,33,0,-33
24513,1,0,38,0,-38
24514,1,1,968,1345,377
24515,1,0,8,0,-8
24516,1,1,110,1659,1549
24517,1,0,3,0,-3
24518,1,0,24,0,-24
24519,1,0,110,0,-110
24520,1,0,50,0,-50
24521,1,1,123,1203,1080
24522,1,0,81,0,-81
24523,0,0,89,0,-89
24524,1,0,13,0,-13
24525,1,1,437,5820,5383
24526,1,0,58,0,-58
24527,1,0,52,0,-52
24528,1,1,553,1211,658
24529,1,0,57,0,-57
24530,1,1,822,1337,515
24531,0,0,131,0,-131
24532,0,0,4,0,-4
24533,1,0,30,0,-30
24534,1,1,1618,2580,962
24535,1,0,19,0,-19
24536,0,0,16,0,-16
24537,1,0,57,0,-57
24538,1,1,486,2125,1639
24539,1,1,1953,1271,-682
24540,1,1,310,1751,1441
24541,0,0,92,0,-92
24542,1,0,28,0,-28
24543,0,0,6,0,-6
24544,0,0,14,0,-14
24545,1,0,33,0,-33
24546,1,0,34,0,-34
24547,0,0,87,0,-87
24548,1,0,14,0,-14
24549,0,0,126,0,-126
24550,1,0,356,0,-356
24551,1,1,405,1426,1021
24552,1,0,96,0,-96
24553,1,0,35,0,-35
24554,1,0,30,0,-30
24555,0,0,56,0,-56
24556,0,0,5,0,-5
24557,0,0,30,0,-30
24558,0,0,33,0,-33
24559,0,0,62,0,-62
24560,1,1,109,1424,1315
24561,0,0,101,0,-101
24562,1,1,1382,1343,-39
24563,1,0,103,0,-103
24564,1,1,151,1259,1108
24565,1,0,150,0,-150
24566,0,0,156,0,-156
24567,1,1,199,1285,1086
24568,1,0,4,0,-4
24569,1,0,50,0,-50
24570,1,0,7,0,-7
24571,0,0,1,0,-1
24572,1,1,358,1471,1113
24573,1,1,452,1214,762
24574,0,0,41,0,-41
24575,1,0,26,0,-26
24576,0,0,3,0,-3
24577,1,0,36,0,-36
24578,1,0,20,0,-20
24579,0,0,0,0,0
24580,1,0,61,0,-61
24581,0,0,65,0,-65
24582,1,1,672,1288,616
24583,1,0,29,0,-29
24584,1,1,653,1515,862
24585,1,0,16,0,-16
24586,0,0,10,0,-10
24587,0,0,17,0,-17
24588,1,1,1401,1430,29
24589,1,1,2598,1433,-1165
24590,1,0,102,0,-102
24591,1,1,109,1644,1535
24592,1,0,99,0,-99
24593,0,0,80,0,-80
24594,1,1,427,1411,984
24595,1,0,27,0,-27
24596,0,0,86,0,-86
24597,1,0,6,0,-6
24598,0,0,25,0,-25
24599,0,0,26,0,-26
24600,1,0,0,0,0
24601,1,1,1163,1269,106
24602,1,1,1198,1468,270
24603,0,0,15,0,-15
24604,0,0,77,0,-77
24605,0,0,62,0,-62
24606,1,1,112,1443,1331
24607,1,1,1895,1418,-477
24608,0,0,97,0,-97
24609,1,0,1,0,-1
24610,1,1,333,1204,871
24611,1,1,866,3080,2214
24612,1,1,119,1201,1082
24613,0,0,31,0,-31
24614,1,0,5,0,-5
24615,0,0,74,0,-74
24616,0,0,7,0,-7
24617,0,0,98,0,-98
24618,0,0,33,0,-33
24619,1,0,48,0,-48
24620,0,0,0,0,0
24621,1,1,131,1263,1132
24622,0,0,15,0,-15
24623,1,1,415,2283,1868
24624,1,1,315,1290,975
24625,1,1,101,1474,1373
24626,0,0,34,0,-34
24627,1,0,15,0,-15
24628,1,0,275,0,-275
24629,0,0,87,0,-87
24630,1,0,4,0,-4
24631,1,0,5,0,-5
24632,1,1,259,1652,1393
24633,0,0,9,0,-9
24634,1,1,504,1277,773
24635,0,0,17,0,-17
24636,1,0,14,0,-14
24637,0,0,96,0,-96
24638,0,0,96,0,-96
24639,0,0,114,0,-114
24640,0,0,72,0,-72
24641,0,0,107,0,-107
24642,0,0,0,0,0
24643,0,0,112,0,-112
24644,1,0,7,0,-7
24645,1,1,729,1394,665
24646,1,0,74,0,-74
24647,1,1,256,1480,1224
24648,1,0,75,0,-75
24649,0,0,5,0,-5
24650,0,0,43,0,-43
24651,1,0,5,0,-5
24652,0,0,47,0,-47
24653,0,0,12,0,-12
24654,1,1,26,1231,1205
24655,1,0,20,0,-20
24656,0,0,67,0,-67
24657,1,1,743,1598,855
24658,1,0,164,0,-164
24659,1,1,185,1482,1297
24660,1,0,36,0,-36
24661,1,0,36,0,-36
24662,1,1,330,1615,1285
24663,1,0,54,0,-54
24664,1,1,220,1264,1044
24665,0,0,9,0,-9
24666,1,1,645,1225,580
24667,0,0,116,0,-116
24668,0,0,11,0,-11
24669,1,1,384,2080,1696
24670,0,0,6,0,-6
24671,1,1,48,2437,2389
24672,0,0,23,0,-23
24673,0,0,15,0,-15
24674,0,0,7,0,-7
24675,0,0,197,0,-197
24676,1,0,70,0,-70
24677,1,1,122,1221,1099
24678,0,0,22,0,-22
24679,0,0,37,0,-37
24680,0,0,63,0,-63
24681,1,0,19,0,-19
24682,1,0,54,0,-54
24683,0,0,31,0,-31
24684,0,0,90,0,-90
24685,1,0,32,0,-32
24686,1,0,41,0,-41
24687,0,0,25,0,-25
24688,0,0,6,0,-6
24689,0,0,109,0,-109
24690,0,0,17,0,-17
24691,1,1,1070,1234,164
24692,0,0,10,0,-10
24693,0,0,63,0,-63
24694,0,0,14,0,-14
24695,1,0,20,0,-20
24696,1,0,97,0,-97
24697,0,0,62,0,-62
24698,0,0,31,0,-31
24699,0,0,79,0,-79
24700,1,1,321,1279,958
24701,0,0,0,0,0
24702,0,0,17,0,-17
24703,0,0,14,0,-14
24704,1,0,37,0,-37
24705,1,0,53,0,-53
24706,0,0,120,0,-120
24707,0,0,61,0,-61
24708,1,1,1051,3004,1953
24709,1,0,142,0,-142
24710,1,0,45,0,-45
24711,1,1,2429,1575,-854
24712,0,0,123,0,-123
24713,1,1,1025,1376,351
24714,1,1,418,1460,1042
24715,0,0,87,0,-87
24716,1,0,12,0,-12
24717,1,1,1501,1915,414
24718,1,1,522,1353,831
24719,1,0,246,0,-246
24720,1,1,1279,1239,-40
24721,1,1,382,1212,830
24722,1,0,4,0,-4
24723,1,1,551,1614,1063
24724,0,0,7,0,-7
24725,1,0,45,0,-45
24726,1,0,4,0,-4
24727,1,0,14,0,-14
24728,0,0,2,0,-2
24729,1,0,142,0,-142
24730,0,0,24,0,-24
24731,0,0,106,0,-106
24732,0,0,39,0,-39
24733,0,0,212,0,-212
24734,1,0,36,0,-36
24735,1,1,57,1510,1453
24736,0,0,82,0,-82
24737,1,1,607,2998,2391
24738,1,1,593,1896,1303
24739,0,0,63,0,-63
24740,1,0,57,0,-57
24741,1,1,388,2185,1797
24742,1,0,9,0,-9
24743,1,1,398,2378,1980
24744,0,0,64,0,-64
24745,1,1,510,1228,718
24746,0,0,3,0,-3
24747,1,1,415,2331,1916
24748,1,1,395,2166,1771
24749,1,0,42,0,-42
24750,1,1,1503,1370,-133
24751,1,1,214,1428,1214
24752,1,1,933,1213,280
24753,0,0,17,0,-17
24754,0,0,7,0,-7
24755,0,0,69,0,-69
24756,1,0,52,0,-52
24757,1,1,770,1206,436
24758,1,0,43,0,-43
24759,1,1,609,1404,795
24760,1,0,56,0,-56
24761,1,1,132,1398,1266
24762,1,1,653,1264,611
24763,1,1,337,1609,1272
24764,1,1,543,1284,741
24765,1,1,160,2268,2108
24766,1,0,47,0,-47
24767,1,1,724,1338,614
24768,0,0,12,0,-12
24769,1,0,22,0,-22
24770,1,1,270,1529,1259
24771,0,0,12,0,-12
24772,0,0,19,0,-19
24773,1,0,3,0,-3
24774,1,1,241,1262,1021
24775,1,0,75,0,-75
24776,0,0,49,0,-49
24777,1,0,10,0,-10
24778,0,0,30,0,-30
24779,1,1,506,1468,962
24780,1,1,677,1517,840
24781,0,0,8,0,-8
24782,0,0,141,0,-141
24783,0,0,2,0,-2
24784,0,0,82,0,-82
24785,1,1,1138,1282,144
24786,0,0,5,0,-5
24787,1,1,396,1866,1470
24788,0,0,114,0,-114
24789,0,0,16,0,-16
24790,1,1,386,1262,876
24791,0,0,1,0,-1
24792,1,1,221,1200,979
24793,1,0,93,0,-93
24794,1,1,187,1864,1677
24795,0,0,24,0,-24
24796,1,0,6,0,-6
24797,1,0,48,0,-48
24798,1,1,87,1342,1255
24799,0,0,12,0,-12
24800,1,1,97,1241,1144
24801,1,1,384,1262,878
24802,0,0,4,0,-4
24803,1,1,450,1296,846
24804,1,1,513,2009,1496
24805,0,0,13,0,-13
24806,1,0,0,0,0
24807,1,0,37,0,-37
24808,1,1,69,1631,1562
24809,1,0,82,0,-82
24810,1,0,50,0,-50
24811,1,0,17,0,-17
24812,0,0,15,0,-15
24813,0,0,59,0,-59
24814,0,0,25,0,-25
24815,0,0,50,0,-50
24816,0,0,9,0,-9
24817,0,0,27,0,-27
24818,1,1,70,1819,1749
24819,0,0,29,0,-29
24820,1,1,29,1483,1454
24821,1,0,82,0,-82
24822,1,0,125,0,-125
24823,0,0,42,0,-42
24824,0,0,40,0,-40
24825,1,1,533,2143,1610
24826,1,0,33,0,-33
24827,1,1,973,1469,496
24828,1,1,146,1780,1634
24829,1,1,1835,1988,153
24830,0,0,39,0,-39
24831,0,0,4,0,-4
24832,1,0,24,0,-24
24833,1,1,366,1207,841
24834,1,1,70,1543,1473
24835,1,0,6,0,-6
24836,0,0,3,0,-3
24837,1,0,35,0,-35
24838,1,0,8,0,-8
24839,1,1,165,1772,1607
24840,1,0,1,0,-1
24841,1,0,19,0,-19
24842,0,0,14,0,-14
24843,1,0,6,0,-6
24844,1,0,10,0,-10
24845,1,1,43,2126,2083
24846,1,1,129,1583,1454
24847,0,0,144,0,-144
24848,1,0,50,0,-50
24849,1,1,211,1213,1002
24850,1,1,763,1410,647
24851,1,0,132,0,-132
24852,1,1,689,1282,593
24853,1,0,3,0,-3
24854,1,0,20,0,-20
24855,1,1,2515,1579,-936
24856,0,0,15,0,-15
24857,1,0,111,0,-111
24858,1,0,30,0,-30
24859,1,0,19,0,-19
24860,0,0,1,0,-1
24861,0,0,13,0,-13
24862,1,1,85,1336,1251
24863,1,0,7,0,-7
24864,1,1,63,1258,1195
24865,1,1,336,2034,1698
24866,1,0,23,0,-23
24867,0,0,5,0,-5
24868,0,0,48,0,-48
24869,1,0,13,0,-13
24870,0,0,151,0,-151
24871,0,0,41,0,-41
24872,0,0,57,0,-57
24873,1,1,943,1330,387
24874,1,0,42,0,-42
24875,1,1,709,1236,527
24876,0,0,2,0,-2
24877,1,0,14,0,-14
24878,0,0,37,0,-37
24879,1,1,1942,1341,-601
24880,1,1,374,1260,886
24881,1,1,575,1278,703
24882,0,0,15,0,-15
24883,0,0,149,0,-149
24884,0,0,80,0,-80
24885,1,1,668,1378,710
24886,0,0,2,0,-2
24887,1,1,1405,1205,-200
24888,0,0,30,0,-30
24889,1,1,212,1349,1137
24890,1,1,97,1512,1415
24891,0,0,45,0,-45
24892,1,0,8,0,-8
24893,1,0,188,0,-188
24894,1,0,41,0,-41
24895,0,0,7,0,-7
24896,0,0,131,0,-131
24897,0,0,28,0,-28
24898,0,0,39,0,-39
24899,1,0,11,0,-11
24900,1,1,306,1486,1180
24901,0,0,68,0,-68
24902,0,0,96,0,-96
24903,0,0,34,0,-34
24904,0,0,38,0,-38
24905,0,0,34,0,-34
24906,0,0,52,0,-52
24907,0,0,121,0,-121
24908,1,0,0,0,0
24909,1,0,6,0,-6
24910,0,0,50,0,-50
24911,0,0,43,0,-43
24912,1,1,268,1256,988
24913,1,0,14,0,-14
24914,1,1,202,1545,1343
24915,1,1,55,1266,1211
24916,0,0,24,0,-24
24917,1,1,978,1366,388
24918,1,0,11,0,-11
24919,0,0,8,0,-8
24920,1,1,480,1418,938
24921,1,1,31,1457,1426
24922,0,0,50,0,-50
24923,1,1,341,1689,1348
24924,1,0,44,0,-44
24925,0,0,85,0,-85
24926,0,0,141,0,-141
24927,0,0,82,0,-82
24928,1,0,5,0,-5
24929,1,0,47,0,-47
24930,1,1,207,1220,1013
24931,1,0,115,0,-115
24932,1,0,6,0,-6
24933,1,0,68,0,-68
24934,0,0,74,0,-74
24935,1,1,596,1362,766
24936,1,1,69,1259,1190
24937,1,0,129,0,-129
24938,1,1,381,1869,1488
24939,1,1,242,1236,994
24940,1,1,730,1241,511
24941,1,0,19,0,-19
24942,1,0,85,0,-85
24943,1,1,1899,2399,500
24944,1,0,34,0,-34
24945,1,0,68,0,-68
24946,1,0,59,0,-59
24947,0,0,74,0,-74
24948,0,0,21,0,-21
24949,0,0,15,0,-15
24950,1,0,20,0,-20
24951,0,0,16,0,-16
24952,1,1,51,1453,1402
24953,1,1,555,1468,913
24954,1,1,1066,1345,279
24955,0,0,66,0,-66
24956,1,1,327,1263,936
24957,1,0,21,0,-21
24958,0,0,2,0,-2
24959,1,0,5,0,-5
24960,0,0,2,0,-2
24961,0,0,120,0,-120
24962,1,1,30,1201,1171
24963,1,1,473,1995,1522
24964,1,1,1091,1318,227
24965,1,1,287,1275,988
24966,0,0,23,0,-23
24967,0,0,44,0,-44
24968,1,1,495,1246,751
24969,1,0,10,0,-10
24970,1,0,65,0,-65
24971,0,0,1,0,-1
24972,1,1,550,1249,699
24973,1,1,86,1214,1128
24974,1,0,24,0,-24
24975,1,1,731,1284,553
24976,0,0,38,0,-38
24977,0,0,114,0,-114
24978,1,1,69,1232,1163
24979,0,0,2,0,-2
24980,1,1,1016,1750,734
24981,1,1,138,2366,2228
24982,0,0,0,0,0
24983,1,0,51,0,-51
24984,1,1,466,1758,1292
24985,0,0,14,0,-14
24986,1,0,32,0,-32
24987,1,0,124,0,-124
24988,1,0,1,0,-1
24989,0,0,49,0,-49
24990,1,1,126,1379,1253
24991,1,1,298,1312,1014
24992,1,0,35,0,-35
24993,0,0,14,0,-14
24994,0,0,59,0,-59
24995,1,0,1,0,-1
24996,0,0,62,0,-62
24997,1,0,12,0,-12
24998,1,1,247,1219,972
24999,1,1,261,1294,1033
25000,1,1,681,1884,1203
25001,1,1,829,1413,584
25002,0,0,31,0,-31
25003,1,1,472,1574,1102
25004,0,0,43,0,-43
25005,1,1,158,1705,1547
25006,1,1,366,1211,845
25007,1,0,3,0,-3
25008,0,0,142,0,-142
25009,1,0,67,0,-67
25010,1,1,2227,1268,-959
25011,1,0,51,0,-51
25012,0,0,12,0,-12
25013,1,0,42,0,-42
25014,0,0,2,0,-2
25015,0,0,45,0,-45
25016,1,0,80,0,-80
25017,1,1,37,1405,1368
25018,1,0,28,0,-28
25019,0,0,81,0,-81
25020,1,1,1075,2507,1432
25021,1,1,259,1223,964
25022,1,0,99,0,-99
25023,1,1,398,1683,1285
25024,1,0,14,0,-14
25025,0,0,28,0,-28
25026,1,1,197,1320,1123
25027,0,0,52,0,-52
25028,0,0,14,0,-14
25029,0,0,91,0,-91
25030,0,0,59,0,-59
25031,0,0,44,0,-44
25032,1,1,486,1213,727
25033,1,0,31,0,-31
25034,0,0,75,0,-75
25035,0,0,57,0,-57
25036,0,0,40,0,-40
25037,0,0,96,0,-96
25038,0,0,161,0,-161
25039,1,0,4,0,-4
25040,0,0,8,0,-8
25041,0,0,51,0,-51
25042,1,0,64,0,-64
25043,0,0,96,0,-96
25044,1,1,1998,1531,-467
25045,1,0,18,0,-18
25046,1,1,206,1246,1040
25047,1,1,243,1226,983
25048,0,0,49,0,-49
25049,0,0,176,0,-176
25050,1,1,1223,1278,55
25051,1,1,685,1487,802
25052,1,1,11,1699,1688
25053,1,1,828,1546,718
25054,1,1,529,1219,690
25055,0,0,38,0,-38
25056,0,0,27,0,-27
25057,1,1,296,1313,1017
25058,1,1,622,1444,822
25059,0,0,5,0,-5
25060,0,0,28,0,-28
25061,0,0,12,0,-12
25062,1,1,280,1360,1080
25063,0,0,54,0,-54
25064,1,0,157,0,-157
25065,0,0,93,0,-93
25066,1,0,21,0,-21
25067,0,0,11,0,-11
25068,1,1,578,1654,1076
25069,0,0,157,0,-157
25070,1,1,240,1280,1040
25071,0,0,226,0,-226
25072,1,0,53,0,-53
25073,1,1,1324,1360,36
25074,0,0,8,0,-8
25075,1,0,102,0,-102
25076,0,0,15,0,-15
25077,1,0,36,0,-36
25078,0,0,132,0,-132
25079,0,0,25,0,-25
25080,1,0,54,0,-54
25081,1,1,733,1210,477
25082,1,0,61,0,-61
25083,0,0,57,0,-57
25084,1,0,150,0,-150
25085,1,1,956,1304,348
25086,1,1,1552,1258,-294
25087,0,0,78,0,-78
25088,1,0,18,0,-18
25089,0,0,4,0,-4
25090,0,0,55,0,-55
25091,0,0,18,0,-18
25092,0,0,81,0,-81
25093,0,0,3,0,-3
25094,1,1,253,1627,1374
25095,0,0,2,0,-2
25096,1,0,6,0,-6
25097,1,1,951,1476,525
25098,1,1,38,1475,1437
25099,0,0,32,0,-32
25100,0,0,27,0,-27
25101,0,0,24,0,-24
25102,0,0,30,0,-30
25103,1,0,21,0,-21
25104,0,0,6,0,-6
25105,0,0,127,0,-127
25106,1,0,59,0,-59
25107,1,1,709,1959,1250
25108,1,1,499,1514,1015
25109,1,1,30,1409,1379
25110,1,0,48,0,-48
25111,1,0,140,0,-140
25112,1,1,345,1470,1125
25113,1,0,45,0,-45
25114,1,0,26,0,-26
25115,0,0,11,0,-11
25116,1,1,282,1528,1246
25117,1,0,67,0,-67
25118,0,0,36,0,-36
25119,0,0,96,0,-96
25120,0,0,53,0,-53
25121,1,0,137,0,-137
25122,1,0,30,0,-30
25123,1,0,51,0,-51
25124,0,0,53,0,-53
25125,0,0,7,0,-7
25126,1,1,1325,1561,236
25127,1,1,418,1506,1088
25128,0,0,95,0,-95
25129,1,0,8,0,-8
25130,0,0,13,0,-13
25131,0,0,178,0,-178
25132,0,0,38,0,-38
25133,1,1,961,1360,399
25134,0,0,7,0,-7
25135,1,0,3,0,-3
25136,0,0,21,0,-21
25137,0,0,57,0,-57
25138,0,0,12,0,-12
25139,1,0,16,0,-16
25140,0,0,30,0,-30
25141,1,0,117,0,-117
25142,1,1,116,1975,1859
25143,1,1,526,1427,901
25144,1,1,271,1278,1007
25145,1,1,351,1256,905
25146,1,0,26,0,-26
25147,0,0,43,0,-43
25148,1,1,903,1654,751
25149,1,1,714,1274,560
25150,1,1,482,1662,1180
25151,0,0,44,0,-44
25152,0,0,7,0,-7
25153,0,0,55,0,-55
25154,0,0,85,0,-85
25155,0,0,27,0,-27
25156,1,0,35,0,-35
25157,1,1,843,1621,778
25158,0,0,82,0,-82
25159,1,1,1638,1729,91
25160,0,0,11,0,-11
25161,1,1,151,1409,1258
25162,1,1,308,1236,928
25163,1,0,90,0,-90
25164,1,0,52,0,-52
25165,1,1,2222,1228,-994
25166,1,1,296,1774,1478
25167,1,1,264,1258,994
25168,1,1,216,1427,1211
25169,0,0,118,0,-118
25170,1,1,391,1209,818
25171,1,1,233,1250,1017
25172,0,0,69,0,-69
25173,1,1,1017,1731,714
25174,0,0,42,0,-42
25175,1,0,11,0,-11
25176,0,0,91,0,-91
25177,0,0,46,0,-46
25178,0,0,33,0,-33
25179,1,1,664,1412,748
25180,1,1,32,1729,1697
25181,1,0,59,0,-59
25182,1,1,169,1471,1302
25183,1,0,9,0,-9
25184,0,0,23,0,-23
25185,1,0,79,0,-79
25186,0,0,40,0,-40
25187,1,0,47,0,-47
25188,1,1,1537,1211,-326
25189,0,0,1,0,-1
25190,0,0,19,0,-19
25191,0,0,94,0,-94
25192,0,0,53,0,-53
25193,0,0,327,0,-327
25194,0,0,34,0,-34
25195,1,0,58,0,-58
25196,0,0,78,0,-78
25197,1,1,39,1228,1189
25198,0,0,125,0,-125
25199,0,0,64,0,-64
25200,1,1,678,1442,764
25201,0,0,42,0,-42
25202,0,0,32,0,-32
25203,1,0,56,0,-56
25204,1,0,85,0,-85
25205,1,0,3,0,-3
25206,1,1,423,1664,1241
25207,1,1,524,1396,872
25208,1,1,314,1227,913
25209,1,1,1020,1395,375
25210,1,1,27,1658,1631
25211,1,0,15,0,-15
25212,1,0,20,0,-20
25213,1,1,499,1935,1436
25214,0,0,268,0,-268
25215,0,0,3,0,-3
25216,0,0,71,0,-71
25217,1,0,19,0,-19
25218,0,0,2,0,-2
25219,1,1,312,2198,1886
25220,0,0,7,0,-7
25221,1,0,31,0,-31
25222,0,0,16,0,-16
25223,1,0,12,0,-12
25224,1,1,112,1385,1273
25225,0,0,64,0,-64
25226,1,0,115,0,-115
25227,1,1,356,1258,902
25228,1,0,42,0,-42
25229,0,0,23,0,-23
25230,0,0,60,0,-60
25231,0,0,31,0,-31
25232,0,0,76,0,-76
25233,0,0,23,0,-23
25234,1,1,1913,1504,-409
25235,0,0,33,0,-33
25236,0,0,99,0,-99
25237,1,0,99,0,-99
25238,1,1,722,1350,628
25239,1,0,13,0,-13
25240,1,0,21,0,-21
25241,1,1,478,1629,1151
25242,1,1,126,1339,1213
25243,1,1,398,1570,1172
25244,1,1,953,1501,548
25245,1,0,24,0,-24
25246,0,0,61,0,-61
25247,1,1,109,3157,3048
25248,0,0,65,0,-65
25249,0,0,15,0,-15
25250,1,1,334,1969,1635
25251,1,1,657,1246,589
25252,0,0,47,0,-47
25253,0,0,48,0,-48
25254,1,1,749,1275,526
25255,0,0,23,0,-23
25256,1,1,455,1314,859
25257,1,0,228,0,-228
25258,0,0,5,0,-5
25259,1,0,93,0,-93
25260,1,1,469,1418,949
25261,1,1,125,1252,1127
25262,1,0,4,0,-4
25263,0,0,48,0,-48
25264,1,1,1309,1630,321
25265,1,1,169,1498,1329
25266,0,0,13,0,-13
25267,0,0,81,0,-81
25268,1,1,102,1369,1267
25269,1,1,424,2977,2553
25270,0,0,23,0,-23
25271,1,1,481,1680,1199
25272,0,0,58,0,-58
25273,1,1,393,2609,2216
25274,1,1,514,1613,1099
25275,1,1,1127,1297,170
25276,1,0,89,0,-89
25277,0,0,67,0,-67
25278,0,0,163,0,-163
25279,1,0,59,0,-59
25280,1,1,308,1466,1158
25281,1,1,305,1553,1248
25282,1,0,37,0,-37
25283,1,0,130,0,-130
25284,1,0,6,0,-6
25285,0,0,38,0,-38
25286,0,0,2,0,-2
25287,1,1,1482,1299,-183
25288,1,0,43,0,-43
25289,1,0,47,0,-47
25290,1,1,148,1382,1234
25291,1,1,88,1397,1309
25292,0,0,181,0,-181
25293,0,0,33,0,-33
25294,1,1,1226,1520,294
25295,0,0,1,0,-1
25296,0,0,69,0,-69
25297,1,0,10,0,-10
25298,0,0,28,0,-28
25299,1,1,228,1584,1356
25300,0,0,8,0,-8
25301,1,0,9,0,-9
25302,1,0,23,0,-23
25303,1,1,1844,1645,-199
25304,1,0,1,0,-1
25305,1,1,695,1348,653
25306,1,0,7,0,-7
25307,1,1,1576,1362,-214
25308,0,0,47,0,-47
25309,0,0,75,0,-75
25310,0,0,11,0,-11
25311,0,0,52,0,-52
25312,0,0,18,0,-18
25313,1,0,7,0,-7
25314,1,0,56,0,-56
25315,0,0,23,0,-23
25316,1,0,9,0,-9
25317,1,1,507,1226,719
25318,1,1,167,1426,1259
25319,1,1,393,1779,1386
25320,0,0,6,0,-6
25321,1,0,25,0,-25
25322,1,1,247,1254,1007
25323,0,0,2,0,-2
25324,0,0,193,0,-193
25325,1,0,82,0,-82
25326,1,1,144,1780,1636
25327,0,0,29,0,-29
25328,1,0,86,0,-86
25329,1,1,667,1458,791
25330,1,0,20,0,-20
25331,1,0,105,0,-105
25332,1,1,232,1385,1153
25333,1,1,1927,1399,-528
25334,1,0,78,0,-78
25335,1,1,481,1802,1321
25336,1,1,530,1518,988
25337,1,1,482,1315,833
25338,0,0,57,0,-57
25339,1,1,148,2177,2029
25340,1,1,136,1407,1271
25341,0,0,33,0,-33
25342,1,0,116,0,-116
25343,1,0,27,0,-27
25344,1,0,90,0,-90
25345,1,0,13,0,-13
25346,1,1,94,1374,1280
25347,0,0,76,0,-76
25348,1,1,538,1394,856
25349,1,1,1416,1423,7
25350,1,1,509,1746,1237
25351,0,0,23,0,-23
25352,0,0,6,0,-6
25353,1,0,15,0,-15
25354,1,1,444,1304,860
25355,1,0,246,0,-246
25356,0,0,26,0,-26
25357,0,0,7,0,-7
25358,0,0,104,0,-104
25359,1,1,496,1252,756
25360,0,0,61,0,-61
25361,0,0,5,0,-5
25362,0,0,12,0,-12
25363,0,0,150,0,-150
25364,1,1,319,1343,1024
25365,1,0,60,0,-60
25366,0,0,19,0,-19
25367,1,0,65,0,-65
25368,1,0,12,0,-12
25369,1,1,2103,1478,-625
25370,1,0,109,0,-109
25371,0,0,83,0,-83
25372,0,0,67,0,-67
25373,1,0,18,0,-18
25374,1,0,8,0,-8
25375,1,0,25,0,-25
25376,1,1,806,1240,434
25377,1,0,85,0,-85
25378,0,0,13,0,-13
25379,0,0,28,0,-28
25380,0,0,27,0,-27
25381,1,1,314,1298,984
25382,0,0,16,0,-16
25383,1,1,1296,1845,549
25384,0,0,34,0,-34
25385,1,0,31,0,-31
25386,0,0,161,0,-161
25387,0,0,24,0,-24
25388,1,0,63,0,-63
25389,0,0,19,0,-19
25390,1,0,4,0,-4
25391,0,0,3,0,-3
25392,1,0,5,0,-5
25393,1,0,12,0,-12
25394,1,1,254,1229,975
25395,1,0,112,0,-112
25396,0,0,17,0,-17
25397,1,0,42,0,-42
25398,1,1,473,1265,792
25399,1,0,21,0,-21
25400,1,1,1817,1410,-407
25401,0,0,22,0,-22
25402,1,0,74,0,-74
25403,0,0,114,0,-114
25404,1,1,109,1651,1542
25405,1,1,836,3220,2384
25406,1,0,59,0,-59
25407,1,0,23,0,-23
25408,0,0,29,0,-29
25409,1,0,7,0,-7
25410,1,0,39,0,-39
25411,1,1,1271,1825,554
25412,0,0,5,0,-5
25413,1,1,595,2352,1757
25414,1,1,121,1279,1158
25415,1,0,9,0,-9
25416,0,0,24,0,-24
25417,1,1,416,1725,1309
25418,0,0,34,0,-34
25419,1,1,312,1287,975
25420,1,0,34,0,-34
25421,1,0,69,0,-69
25422,0,0,4,0,-4
25423,1,1,366,1349,983
25424,1,1,743,1457,714
25425,0,0,3,0,-3
25426,1,1,178,1292,1114
25427,1,1,16,1504,1488
25428,1,1,1136,1217,81
25429,1,0,4,0,-4
25430,1,1,777,1273,496
25431,0,0,70,0,-70
25432,1,0,13,0,-13
25433,0,0,17,0,-17
25434,0,0,53,0,-53
25435,0,0,1,0,-1
25436,1,1,119,1456,1337
25437,1,1,422,1284,862
25438,1,0,144,0,-144
25439,0,0,5,0,-5
25440,1,0,70,0,-70
25441,0,0,107,0,-107
25442,1,1,359,2191,1832
25443,1,1,368,1698,1330
25444,1,1,1056,1498,442
25445,1,0,14,0,-14
25446,0,0,26,0,-26
25447,0,0,24,0,-24
25448,0,0,11,0,-11
25449,0,0,34,0,-34
25450,0,0,7,0,-7
25451,1,0,52,0,-52
25452,1,1,71,1292,1221
25453,1,1,812,1678,866
25454,1,1,228,1465,1237
25455,1,0,40,0,-40
25456,1,1,437,1237,800
25457,1,1,647,1289,642
25458,0,0,21,0,-21
25459,0,0,106,0,-106
25460,0,0,101,0,-101
25461,1,1,908,1342,434
25462,1,1,100,1523,1423
25463,1,1,14,2212,2198
25464,0,0,22,0,-22
25465,1,1,45,2296,2251
25466,1,1,653,1436,783
25467,1,0,30,0,-30
25468,0,0,62,0,-62
25469,1,0,63,0,-63
25470,0,0,16,0,-16
25471,1,0,7,0,-7
25472,1,1,535,1320,785
25473,1,1,571,2480,1909
25474,1,1,123,1343,1220
25475,0,0,18,0,-18
25476,0,0,20,0,-20
25477,0,0,21,0,-21
25478,1,0,72,0,-72
25479,1,1,354,1271,917
25480,1,1,102,1512,1410
25481,1,1,69,1298,1229
25482,1,1,168,1447,1279
25483,1,0,12,0,-12
25484,0,0,59,0,-59
25485,1,1,1382,1414,32
25486,1,0,27,0,-27
25487,0,0,41,0,-41
25488,1,1,667,2534,1867
25489,1,0,55,0,-55
25490,0,0,112,0,-112
25491,1,1,188,1339,1151
25492,1,0,24,0,-24
25493,1,0,103,0,-103
25494,0,0,10,0,-10
25495,1,1,1788,1640,-148
25496,1,0,21,0,-21
25497,1,1,931,1552,621
25498,1,1,295,1341,1046
25499,1,0,42,0,-42
25500,0,0,2,0,-2
25501,1,1,104,2226,2122
25502,1,1,409,2333,1924
25503,0,0,102,0,-102
25504,1,0,34,0,-34
25505,0,0,10,0,-10
25506,1,1,477,1387,910
25507,1,1,4,1732,1728
25508,0,0,55,0,-55
25509,0,0,6,0,-6
25510,1,0,194,0,-194
25511,0,0,36,0,-36
25512,1,0,11,0,-11
25513,0,0,16,0,-16
25514,1,0,68,0,-68
25515,0,0,42,0,-42
25516,1,0,2,0,-2
25517,1,1,85,4892,4807
25518,0,0,156,0,-156
25519,0,0,13,0,-13
25520,0,0,174,0,-174
25521,1,1,756,1476,720
25522,0,0,28,0,-28
25523,1,0,28,0,-28
25524,1,0,2,0,-2
25525,1,0,11,0,-11
25526,0,0,17,0,-17
25527,1,0,11,0,-11
25528,1,1,659,1204,545
25529,1,0,8,0,-8
25530,1,0,249,0,-249
25531,0,0,58,0,-58
25532,1,0,56,0,-56
25533,1,1,188,1444,1256
25534,0,0,166,0,-166
25535,1,0,3,0,-3
25536,1,0,13,0,-13
25537,1,0,128,0,-128
25538,0,0,20,0,-20
25539,0,0,18,0,-18
25540,0,0,60,0,-60
25541,1,0,12,0,-12
25542,1,0,44,0,-44
25543,1,0,88,0,-88
25544,1,0,11,0,-11
25545,0,0,29,0,-29
25546,1,0,15,0,-15
25547,0,0,4,0,-4
25548,1,1,428,1561,1133
25549,0,0,0,0,0
25550,1,0,13,0,-13
25551,0,0,48,0,-48
25552,1,1,657,1580,923
25553,0,0,132,0,-132
25554,0,0,58,0,-58
25555,0,0,32,0,-32
25556,1,0,17,0,-17
25557,0,0,78,0,-78
25558,1,1,153,1230,1077
25559,1,1,390,1214,824
25560,1,0,80,0,-80
25561,1,0,113,0,-113
25562,0,0,88,0,-88
25563,0,0,46,0,-46
25564,1,1,646,1228,582
25565,0,0,16,0,-16
25566,1,1,299,1381,1082
25567,0,0,4,0,-4
25568,0,0,147,0,-147
25569,0,0,89,0,-89
25570,1,0,11,0,-11
25571,1,0,6,0,-6
25572,1,0,61,0,-61
25573,1,1,466,1521,1055
25574,0,0,40,0,-40
25575,1,0,36,0,-36
25576,0,0,45,0,-45
25577,1,0,49,0,-49
25578,0,0,1,0,-1
25579,0,0,145,0,-145
25580,1,1,79,1203,1124
25581,1,1,253,2387,2134
25582,1,1,421,1318,897
25583,1,1,758,1451,693
25584,1,1,518,1206,688
25585,1,0,35,0,-35
25586,0,0,48,0,-48
25587,1,0,49,0,-49
25588,1,0,20,0,-20
25589,0,0,52,0,-52
25590,1,1,300,1217,917
25591,0,0,3,0,-3
25592,0,0,34,0,-34
25593,0,0,42,0,-42
25594,1,0,65,0,-65
25595,1,1,1237,1227,-10
25596,1,1,2610,1215,-1395
25597,1,1,577,1280,703
25598,0,0,6,0,-6
25599,1,1,226,1387,1161
25600,0,0,75,0,-75
25601,1,1,218,1456,1238
25602,0,0,56,0,-56
25603,1,0,37,0,-37
25604,1,0,56,0,-56
25605,1,0,29,0,-29
25606,0,0,86,0,-86
25607,1,0,72,0,-72
25608,1,1,499,1455,956
25609,0,0,19,0,-19
25610,1,0,16,0,-16
25611,0,0,16,0,-16
25612,1,0,181,0,-181
25613,1,1,362,1294,932
25614,1,1,320,1261,941
25615,0,0,25,0,-25
25616,1,1,853,1248,395
25617,0,0,51,0,-51
25618,1,0,47,0,-47
25619,1,1,891,1692,801
25620,0,0,16,0,-16
25621,0,0,15,0,-15
25622,1,1,288,1370,1082
25623,1,1,312,1517,1205
25624,0,0,13,0,-13
25625,0,0,47,0,-47
25626,1,0,12,0,-12
25627,0,0,116,0,-116
25628,1,1,203,1332,1129
25629,1,1,303,1568,1265
25630,0,0,13,0,-13
25631,0,0,132,0,-132
25632,0,0,78,0,-78
25633,0,0,0,0,0
25634,1,0,58,0,-58
25635,0,0,64,0,-64
25636,1,1,1042,1202,160
25637,1,0,30,0,-30
25638,0,0,11,0,-11
25639,0,0,15,0,-15
25640,0,0,3,0,-3
25641,1,1,306,1529,1223
25642,0,0,8,0,-8
25643,1,1,571,1361,790
25644,0,0,41,0,-41
25645,0,0,1,0,-1
25646,1,0,4,0,-4
25647,0,0,43,0,-43
25648,1,1,856,1863,1007
25649,1,0,86,0,-86
25650,0,0,24,0,-24
25651,0,0,5,0,-5
25652,1,1,450,2574,2124
25653,1,0,60,0,-60
25654,1,0,27,0,-27
25655,0,0,29,0,-29
25656,1,0,23,0,-23
25657,1,1,162,1349,1187
25658,1,0,4,0,-4
25659,0,0,32,0,-32
25660,1,0,9,0,-9
25661,0,0,12,0,-12
25662,1,1,333,1581,1248
25663,0,0,25,0,-25
25664,1,0,3,0,-3
25665,0,0,16,0,-16
25666,1,0,19,0,-19
25667,0,0,45,0,-45
25668,1,1,1024,1298,274
25669,1,0,22,0,-22
25670,1,1,205,1291,1086
25671,1,0,67,0,-67
25672,0,0,3,0,-3
25673,1,1,942,1909,967
25674,0,0,40,0,-40
25675,1,1,598,1247,649
25676,0,0,68,0,-68
25677,1,1,353,1393,1040
25678,0,0,40,0,-40
25679,1,1,111,1741,1630
25680,1,1,1197,1270,73
25681,0,0,0,0,0
25682,1,1,383,1396,1013
25683,1,0,47,0,-47
25684,1,1,67,1350,1283
25685,1,0,96,0,-96
25686,0,0,28,0,-28
25687,0,0,14,0,-14
25688,0,0,31,0,-31
25689,1,0,18,0,-18
25690,1,1,260,1589,1329
25691,0,0,68,0,-68
25692,1,1,568,1928,1360
25693,1,1,104,1385,1281
25694,0,0,31,0,-31
25695,1,0,6,0,-6
25696,1,0,3,0,-3
25697,0,0,31,0,-31
25698,1,0,46,0,-46
25699,0,0,116,0,-116
25700,1,0,90,0,-90
25701,0,0,37,0,-37
25702,0,0,54,0,-54
25703,0,0,40,0,-40
25704,1,0,10,0,-10
25705,1,1,252,1318,1066
25706,1,1,623,1676,1053
25707,0,0,23,0,-23
25708,0,0,59,0,-59
25709,0,0,33,0,-33
25710,1,0,74,0,-74
25711,1,0,141,0,-141
25712,1,1,82,1296,1214
25713,1,1,216,1488,1272
25714,0,0,21,0,-21
25715,0,0,0,0,0
25716,0,0,11,0,-11
25717,0,0,203,0,-203
25718,1,1,211,1215,1004
25719,1,0,188,0,-188
25720,1,0,9,0,-9
25721,1,1,84,1714,1630
25722,1,0,65,0,-65
25723,0,0,23,0,-23
25724,1,0,91,0,-91
25725,1,1,511,1275,764
25726,0,0,8,0,-8
25727,1,1,1055,1425,370
25728,0,0,196,0,-196
25729,0,0,25,0,-25
25730,0,0,49,0,-49
25731,0,0,0,0,0
25732,1,1,481,1365,884
25733,0,0,151,0,-151
25734,0,0,2,0,-2
25735,1,0,150,0,-150
25736,1,0,11,0,-11
25737,1,1,559,1255,696
25738,0,0,18,0,-18
25739,1,0,206,0,-206
25740,0,0,4,0,-4
25741,1,1,1376,1310,-66
25742,1,0,48,0,-48
25743,1,1,320,1447,1127
25744,1,0,48,0,-48
25745,1,1,527,2025,1498
25746,1,1,102,1488,1386
25747,1,0,10,0,-10
25748,1,0,16,0,-16
25749,1,1,989,1810,821
25750,0,0,1,0,-1
25751,1,1,280,1248,968
25752,0,0,36,0,-36
25753,1,0,1,0,-1
25754,0,0,71,0,-71
25755,0,0,37,0,-37
25756,1,0,56,0,-56
25757,1,0,241,0,-241
25758,1,0,58,0,-58
25759,1,0,13,0,-13
25760,1,0,21,0,-21
25761,0,0,23,0,-23
25762,1,1,217,2372,2155
25763,1,0,5,0,-5
25764,1,1,937,1580,643
25765,1,0,107,0,-107
25766,0,0,116,0,-116
25767,0,0,26,0,-26
25768,0,0,11,0,-11
25769,1,1,1453,1339,-114
25770,1,0,1,0,-1
25771,0,0,109,0,-109
25772,0,0,12,0,-12
25773,1,0,54,0,-54
25774,1,0,35,0,-35
25775,0,0,1,0,-1
25776,1,0,39,0,-39
25777,0,0,1,0,-1
25778,0,0,20,0,-20
25779,1,0,43,0,-43
25780,1,1,129,1968,1839
25781,0,0,15,0,-15
25782,1,0,73,0,-73
25783,0,0,94,0,-94
25784,1,0,0,0,0
25785,0,0,2,0,-2
25786,1,1,257,1480,1223
25787,1,1,65,1789,1724
25788,0,0,0,0,0
25789,1,1,125,1578,1453
25790,0,0,21,0,-21
25791,0,0,8,0,-8
25792,0,0,68,0,-68
25793,0,0,19,0,-19
25794,0,0,45,0,-45
25795,1,0,2,0,-2
25796,0,0,20,0,-20
25797,0,0,5,0,-5
25798,1,0,15,0,-15
25799,1,1,361,1428,1067
25800,1,1,115,2375,2260
25801,1,1,638,1995,1357
25802,1,0,17,0,-17
25803,1,1,473,1625,1152
25804,1,1,638,1254,616
25805,0,0,89,0,-89
25806,0,0,76,0,-76
25807,1,1,1832,1527,-305
25808,1,0,43,0,-43
25809,0,0,11,0,-11
25810,0,0,75,0,-75
25811,1,1,251,1279,1028
25812,1,1,985,1338,353
25813,0,0,34,0,-34
25814,1,0,1,0,-1
25815,0,0,67,0,-67
25816,1,1,256,1242,986
25817,1,1,923,1542,619
25818,1,0,52,0,-52
25819,0,0,50,0,-50
25820,0,0,20,0,-20
25821,1,1,131,1426,1295
25822,0,0,90,0,-90
25823,1,0,58,0,-58
25824,1,0,107,0,-107
25825,1,0,82,0,-82
25826,0,0,71,0,-71
25827,1,1,112,1572,1460
25828,1,0,1,0,-1
25829,0,0,43,0,-43
25830,1,0,11,0,-11
25831,1,1,766,1480,714
25832,1,1,1728,1230,-498
25833,1,0,117,0,-117
25834,1,0,83,0,-83
25835,1,1,413,1565,1152
25836,0,0,20,0,-20
25837,1,1,145,1401,1256
25838,0,0,71,0,-71
25839,1,0,5,0,-5
25840,0,0,124,0,-124
25841,1,0,109,0,-109
25842,0,0,39,0,-39
25843,1,0,44,0,-44
25844,1,0,453,0,-453
25845,0,0,44,0,-44
25846,0,0,10,0,-10
25847,1,0,43,0,-43
25848,1,1,495,1209,714
25849,1,0,92,0,-92
25850,1,0,44,0,-44
25851,0,0,5,0,-5
25852,1,0,6,0,-6
25853,1,0,21,0,-21
25854,0,0,23,0,-23
25855,1,1,604,1987,1383
25856,1,1,677,1477,800
25857,1,1,433,1236,803
25858,1,0,0,0,0
25859,1,0,119,0,-119
25860,0,0,26,0,-26
25861,0,0,11,0,-11
25862,0,0,47,0,-47
25863,1,1,507,1209,702
25864,0,0,79,0,-79
25865,1,1,406,1440,1034
25866,1,0,5,0,-5
25867,1,0,9,0,-9
25868,1,0,19,0,-19
25869,0,0,105,0,-105
25870,0,0,62,0,-62
25871,1,0,3,0,-3
25872,1,1,260,1261,1001
25873,1,1,2344,1589,-755
25874,1,1,537,1663,1126
25875,1,0,3,0,-3
25876,0,0,103,0,-103
25877,1,0,65,0,-65
25878,0,0,11,0,-11
25879,0,0,25,0,-25
25880,1,1,402,2162,1760
25881,0,0,34,0,-34
25882,0,0,9,0,-9
25883,1,1,393,1502,1109
25884,1,0,3,0,-3
25885,1,1,114,2173,2059
25886,1,0,3,0,-3
25887,0,0,46,0,-46
25888,1,1,1171,1889,718
25889,0,0,148,0,-148
25890,1,0,15,0,-15
25891,1,0,44,0,-44
25892,1,0,14,0,-14
25893,0,0,7,0,-7
25894,1,0,199,0,-199
25895,0,0,171,0,-171
25896,1,0,9,0,-9
25897,0,0,42,0,-42
25898,0,0,3,0,-3
25899,1,0,95,0,-95
25900,1,1,752,1480,728
25901,1,0,0,0,0
25902,0,0,175,0,-175
25903,0,0,53,0,-53
25904,1,1,335,2547,2212
25905,1,1,305,1274,969
25906,1,1,563,1413,850
25907,0,0,22,0,-22
25908,1,1,436,1422,986
25909,1,1,317,1238,921
25910,0,0,17,0,-17
25911,1,1,337,1609,1272
25912,1,1,660,1605,945
25913,1,0,10,0,-10
25914,0,0,356,0,-356
25915,0,0,40,0,-40
25916,0,0,6,0,-6
25917,1,1,704,1585,881
25918,1,1,1526,1285,-241
25919,0,0,6,0,-6
25920,1,0,78,0,-78
25921,1,1,2046,1207,-839
25922,0,0,13,0,-13
25923,1,0,3,0,-3
25924,0,0,35,0,-35
25925,1,1,311,1205,894
25926,0,0,26,0,-26
25927,0,0,13,0,-13
25928,0,0,87,0,-87
25929,1,0,10,0,-10
25930,1,1,170,1286,1116
25931,1,0,24,0,-24
25932,1,1,428,2160,1732
25933,0,0,118,0,-118
25934,1,1,569,1256,687
25935,0,0,80,0,-80
25936,1,1,909,1412,503
25937,1,1,291,1385,1094
25938,0,0,18,0,-18
25939,1,0,100,0,-100
25940,0,0,47,0,-47
25941,0,0,36,0,-36
25942,0,0,113,0,-113
25943,1,1,115,1210,1095
25944,0,0,41,0,-41
25945,0,0,23,0,-23
25946,1,0,34,0,-34
25947,1,1,1079,1330,251
25948,1,0,158,0,-158
25949,1,0,6,0,-6
25950,0,0,43,0,-43
25951,1,0,55,0,-55
25952,1,1,40,1680,1640
25953,1,0,15,0,-15
25954,1,1,655,1878,1223
25955,0,0,14,0,-14
25956,1,0,12,0,-12
25957,1,0,12,0,-12
25958,1,0,22,0,-22
25959,1,0,5,0,-5
25960,0,0,143,0,-143
25961,1,0,51,0,-51
25962,0,0,21,0,-21
25963,1,1,58,1542,1484
25964,1,1,2686,1313,-1373
25965,0,0,5,0,-5
25966,1,0,53,0,-53
25967,1,0,24,0,-24
25968,1,1,266,1315,1049
25969,1,0,89,0,-89
25970,1,1,54,2074,2020
25971,0,0,7,0,-7
25972,1,1,724,1361,637
25973,0,0,28,0,-28
25974,1,0,11,0,-11
25975,1,1,227,1257,1030
25976,1,0,1,0,-1
25977,1,0,166,0,-166
25978,1,0,26,0,-26
25979,0,0,82,0,-82
25980,0,0,46,0,-46
25981,1,0,119,0,-119
25982,0,0,3,0,-3
25983,0,0,87,0,-87
25984,0,0,59,0,-59
25985,0,0,9,0,-9
25986,1,1,184,2959,2775
25987,0,0,10,0,-10
25988,1,0,27,0,-27
25989,1,1,891,1387,496
25990,1,1,517,1236,719
25991,1,0,113,0,-113
25992,1,0,20,0,-20
25993,0,0,83,0,-83
25994,1,1,391,1353,962
25995,1,0,10,0,-10
25996,1,0,73,0,-73
25997,0,0,3,0,-3
25998,0,0,158,0,-158
25999,1,1,615,1840,1225
26000,1,1,452,1256,804
26001,0,0,113,0,-113
26002,1,0,8,0,-8
26003,1,1,466,1444,978
26004,1,1,356,1251,895
26005,1,1,167,1382,1215
26006,0,0,81,0,-81
26007,0,0,98,0,-98
26008,0,0,1,0,-1
26009,1,0,10,0,-10
26010,1,1,171,1642,1471
26011,1,1,878,1989,1111
26012,1,1,60,1353,1293
26013,0,0,45,0,-45
26014,1,0,4,0,-4
26015,0,0,62,0,-62
26016,1,1,1479,1237,-242
26017,1,1,423,1266,843
26018,0,0,50,0,-50
26019,0,0,3,0,-3
26020,1,0,25,0,-25
26021,0,0,66,0,-66
26022,1,0,79,0,-79
26023,0,0,170,0,-170
26024,1,1,597,1402,805
26025,0,0,24,0,-24
26026,1,0,20,0,-20
26027,1,0,25,0,-25
26028,1,1,982,1231,249
26029,1,1,1698,1610,-88
26030,1,0,10,0,-10
26031,1,0,14,0,-14
26032,0,0,61,0,-61
26033,0,0,40,0,-40
26034,0,0,103,0,-103
26035,1,1,259,1790,1531
26036,1,1,72,1279,1207
26037,0,0,2,0,-2
26038,0,0,65,0,-65
26039,1,1,185,1455,1270
26040,0,0,0,0,0
26041,0,0,41,0,-41
26042,1,0,12,0,-12
26043,1,1,488,1285,797
26044,1,0,56,0,-56
26045,1,0,177,0,-177
26046,0,0,86,0,-86
26047,1,1,825,1200,375
26048,1,0,23,0,-23
26049,0,0,63,0,-63
26050,1,1,276,1551,1275
26051,0,0,24,0,-24
26052,1,1,326,1756,1430
26053,0,0,101,0,-101
26054,0,0,22,0,-22
26055,1,1,476,1573,1097
26056,1,1,306,2480,2174
26057,0,0,171,0,-171
26058,0,0,138,0,-138
26059,0,0,99,0,-99
26060,1,1,770,1372,602
26061,0,0,10,0,-10
26062,1,0,10,0,-10
26063,0,0,126,0,-126
26064,1,0,134,0,-134
26065,1,0,12,0,-12
26066,0,0,25,0,-25
26067,0,0,26,0,-26
26068,1,1,370,1303,933
26069,1,1,214,1307,1093
26070,1,0,0,0,0
26071,0,0,48,0,-48
26072,1,0,18,0,-18
26073,1,0,0,0,0
26074,0,0,65,0,-65
26075,1,0,36,0,-36
26076,1,0,176,0,-176
26077,0,0,91,0,-91
26078,0,0,17,0,-17
26079,1,1,1351,2053,702
26080,1,1,533,1251,718
26081,0,0,11,0,-11
26082,0,0,4,0,-4
26083,1,0,127,0,-127
26084,0,0,103,0,-103
26085,1,1,126,1479,1353
26086,1,0,85,0,-85
26087,0,0,88,0,-88
26088,1,1,38,1791,1753
26089,1,0,18,0,-18
26090,1,1,1243,1803,560
26091,1,0,79,0,-79
26092,0,0,12,0,-12
26093,0,0,54,0,-54
26094,0,0,3,0,-3
26095,1,0,95,0,-95
26096,1,1,693,1369,676
26097,1,1,771,1356,585
26098,0,0,61,0,-61
26099,0,0,40,0,-40
26100,0,0,173,0,-173
26101,1,0,15,0,-15
26102,1,1,114,1377,1263
26103,1,0,17,0,-17
26104,1,1,133,1525,1392
26105,1,1,2630,2944,314
26106,1,0,43,0,-43
26107,1,0,7,0,-7
26108,0,0,88,0,-88
26109,0,0,51,0,-51
26110,1,0,10,0,-10
26111,1,0,25,0,-25
26112,0,0,10,0,-10
26113,1,1,357,1784,1427
26114,1,0,20,0,-20
26115,0,0,14,0,-14
26116,0,0,40,0,-40
26117,0,0,20,0,-20
26118,0,0,15,0,-15
26119,1,1,223,1683,1460
26120,1,0,5,0,-5
26121,0,0,5,0,-5
26122,0,0,23,0,-23
26123,0,0,42,0,-42
26124,1,0,0,0,0
26125,1,0,46,0,-46
26126,0,0,113,0,-113
26127,0,0,49,0,-49
26128,1,1,662,1227,565
26129,1,0,176,0,-176
26130,0,0,56,0,-56
26131,1,1,781,1206,425
26132,1,1,126,1349,1223
26133,0,0,36,0,-36
26134,1,1,322,1384,1062
26135,1,1,2217,2344,127
26136,1,0,84,0,-84
26137,1,0,83,0,-83
26138,1,1,387,1630,1243
26139,1,1,615,2189,1574
26140,1,1,1240,1340,100
26141,0,0,27,0,-27
26142,0,0,36,0,-36
26143,0,0,69,0,-69
26144,1,1,373,1248,875
26145,1,1,425,1624,1199
26146,1,1,154,1357,1203
26147,1,0,57,0,-57
26148,1,0,210,0,-210
26149,0,0,15,0,-15
26150,1,1,295,1347,1052
26151,1,0,100,0,-100
26152,0,0,8,0,-8
26153,0,0,35,0,-35
26154,1,1,162,1344,1182
26155,1,0,9,0,-9
26156,0,0,96,0,-96
26157,1,0,0,0,0
26158,1,1,1023,1238,215
26159,0,0,50,0,-50
26160,1,1,1515,1285,-230
26161,1,1,168,1659,1491
26162,0,0,46,0,-46
26163,0,0,134,0,-134
26164,1,0,49,0,-49
26165,1,0,2,0,-2
26166,1,0,12,0,-12
26167,1,1,673,1522,849
26168,1,1,656,1486,830
26169,1,0,4,0,-4
26170,1,0,46,0,-46
26171,0,0,29,0,-29
26172,0,0,102,0,-102
26173,0,0,14,0,-14
26174,0,0,25,0,-25
26175,1,0,104,0,-104
26176,1,0,30,0,-30
26177,1,0,18,0,-18
26178,0,0,167,0,-167
26179,0,0,20,0,-20
26180,0,0,19,0,-19
26181,0,0,117,0,-117
26182,1,1,464,1780,1316
26183,0,0,0,0,0
26184,1,0,34,0,-34
26185,1,1,595,1538,943
26186,1,1,967,1359,392
26187,1,1,281,1436,1155
26188,0,0,74,0,-74
26189,1,0,11,0,-11
26190,1,0,64,0,-64
26191,0,0,16,0,-16
26192,0,0,227,0,-227
26193,1,1,886,1591,705
26194,0,0,70,0,-70
26195,0,0,1,0,-1
26196,0,0,30,0,-30
26197,1,0,10,0,-10
26198,0,0,29,0,-29
26199,1,0,6,0,-6
26200,1,0,10,0,-10
26201,0,0,41,0,-41
26202,1,0,1,0,-1
26203,1,1,980,3565,2585
26204,1,0,19,0,-19
26205,1,1,122,1355,1233
26206,1,0,55,0,-55
26207,1,1,211,1574,1363
26208,1,1,3037,1243,-1794
26209,1,0,28,0,-28
26210,0,0,55,0,-55
26211,1,0,41,0,-41
26212,0,0,26,0,-26
26213,1,1,137,1298,1161
26214,1,0,45,0,-45
26215,1,0,154,0,-154
26216,1,0,49,0,-49
26217,1,1,1023,2484,1461
26218,1,0,216,0,-216
26219,0,0,110,0,-110
26220,1,0,6,0,-6
26221,1,1,702,1760,1058
26222,1,0,4,0,-4
26223,1,0,50,0,-50
26224,0,0,18,0,-18
26225,1,0,60,0,-60
26226,1,1,180,1465,1285
26227,0,0,90,0,-90
26228,1,0,103,0,-103
26229,1,0,64,0,-64
26230,0,0,46,0,-46
26231,1,1,319,1778,1459
26232,1,0,61,0,-61
26233,1,0,32,0,-32
26234,0,0,24,0,-24
26235,1,1,315,1314,999
26236,0,0,244,0,-244
26237,1,1,138,1358,1220
26238,0,0,30,0,-30
26239,0,0,45,0,-45
26240,0,0,37,0,-37
26241,1,0,96,0,-96
26242,1,0,189,0,-189
26243,0,0,27,0,-27
26244,1,0,66,0,-66
26245,0,0,51,0,-51
26246,1,0,33,0,-33
26247,0,0,20,0,-20
26248,0,0,10,0,-10
26249,0,0,66,0,-66
26250,0,0,17,0,-17
26251,0,0,13,0,-13
26252,1,0,6,0,-6
26253,0,0,32,0,-32
26254,0,0,1,0,-1
26255,1,0,15,0,-15
26256,0,0,25,0,-25
26257,1,0,20,0,-20
26258,1,0,12,0,-12
26259,0,0,80,0,-80
26260,1,0,11,0,-11
26261,1,0,37,0,-37
26262,0,0,62,0,-62
26263,0,0,5,0,-5
26264,1,1,278,1232,954
26265,1,1,302,1499,1197
26266,1,1,109,1281,1172
26267,1,0,88,0,-88
26268,0,0,43,0,-43
26269,0,0,31,0,-31
26270,1,1,510,1207,697
26271,1,1,219,1359,1140
26272,0,0,113,0,-113
26273,1,1,257,1693,1436
26274,1,1,576,1428,852
26275,1,0,68,0,-68
26276,1,0,259,0,-259
26277,0,0,17,0,-17
26278,0,0,2,0,-2
26279,1,1,586,1429,843
26280,1,0,19,0,-19
26281,1,1,381,1238,857
26282,1,0,40,0,-40
26283,1,0,5,0,-5
26284,0,0,11,0,-11
26285,0,0,126,0,-126
26286,1,1,181,1889,1708
26287,1,0,142,0,-142
26288,0,0,0,0,0
26289,1,0,23,0,-23
26290,1,0,118,0,-118
26291,1,0,5,0,-5
26292,1,1,391,1583,1192
26293,1,0,69,0,-69
26294,0,0,19,0,-19
26295,1,0,125,0,-125
26296,0,0,29,0,-29
26297,0,0,26,0,-26
26298,1,1,83,2236,2153
26299,1,0,47,0,-47
26300,1,1,273,2204,1931
26301,1,1,256,1223,967
26302,1,1,77,1340,1263
26303,1,0,40,0,-40
26304,0,0,45,0,-45
26305,1,0,37,0,-37
26306,1,1,681,1398,717
26307,0,0,40,0,-40
26308,1,0,47,0,-47
26309,0,0,13,0,-13
26310,1,1,67,1445,1378
26311,0,0,41,0,-41
26312,0,0,34,0,-34
26313,1,0,49,0,-49
26314,0,0,23,0,-23
26315,0,0,57,0,-57
26316,1,0,49,0,-49
26317,1,0,63,0,-63
26318,1,0,76,0,-76
26319,1,1,94,1769,1675
26320,1,1,115,1517,1402
26321,1,1,591,1361,770
26322,0,0,0,0,0
26323,0,0,98,0,-98
26324,0,0,35,0,-35
26325,0,0,49,0,-49
26326,1,0,99,0,-99
26327,1,0,12,0,-12
26328,0,0,14,0,-14
26329,1,1,580,2449,1869
26330,1,1,1471,1408,-63
26331,0,0,21,0,-21
26332,1,0,59,0,-59
26333,0,0,65,0,-65
26334,1,1,415,1722,1307
26335,1,1,491,1614,1123
26336,1,1,786,1770,984
26337,1,1,683,1626,943
26338,1,0,4,0,-4
26339,1,1,1547,1378,-169
26340,1,1,145,1462,1317
26341,1,1,493,1671,1178
26342,1,0,23,0,-23
26343,0,0,42,0,-42
26344,1,1,602,1802,1200
26345,1,1,818,1526,708
26346,0,0,11,0,-11
26347,0,0,71,0,-71
26348,1,1,92,1567,1475
26349,0,0,50,0,-50
26350,1,1,3,1418,1415
26351,1,1,583,1293,710
26352,1,1,181,1239,1058
26353,0,0,0,0,0
26354,1,1,1366,1567,201
26355,1,0,7,0,-7
26356,1,1,138,1225,1087
26357,1,0,12,0,-12
26358,0,0,13,0,-13
26359,0,0,6,0,-6
26360,1,0,60,0,-60
26361,0,0,38,0,-38
26362,0,0,6,0,-6
26363,0,0,4,0,-4
26364,0,0,42,0,-42
26365,1,0,30,0,-30
26366,0,0,130,0,-130
26367,1,1,360,1679,1319
26368,0,0,38,0,-38
26369,0,0,44,0,-44
26370,1,1,263,1792,1529
26371,1,1,294,1409,1115
26372,1,0,28,0,-28
26373,1,0,17,0,-17
26374,1,1,1068,1726,658
26375,1,0,12,0,-12
26376,1,1,469,1645,1176
26377,1,0,50,0,-50
26378,0,0,37,0,-37
26379,0,0,51,0,-51
26380,1,0,83,0,-83
26381,0,0,23,0,-23
26382,0,0,25,0,-25
26383,0,0,59,0,-59
26384,0,0,27,0,-27
26385,0,0,16,0,-16
26386,0,0,158,0,-158
26387,0,0,11,0,-11
26388,1,1,58,1260,1202
26389,1,0,35,0,-35
26390,0,0,11,0,-11
26391,1,0,42,0,-42
26392,0,0,9,0,-9
26393,0,0,17,0,-17
26394,1,0,1,0,-1
26395,1,0,72,0,-72
26396,1,1,625,4601,3976
26397,1,0,19,0,-19
26398,1,1,191,1215,1024
26399,0,0,98,0,-98
26400,0,0,63,0,-63
26401,0,0,27,0,-27
26402,1,0,68,0,-68
26403,1,0,44,0,-44
26404,1,1,672,1212,540
26405,0,0,16,0,-16
26406,1,1,1612,1473,-139
26407,1,1,115,1546,1431
26408,1,0,7,0,-7
26409,1,1,395,1491,1096
26410,0,0,49,0,-49
26411,0,0,73,0,-73
26412,1,1,75,1252,1177
26413,1,0,12,0,-12
26414,1,0,85,0,-85
26415,1,1,776,1301,525
26416,0,0,6,0,-6
26417,1,1,203,4701,4498
26418,1,0,22,0,-22
26419,0,0,47,0,-47
26420,1,1,1576,1562,-14
26421,1,0,40,0,-40
26422,1,0,168,0,-168
26423,1,0,67,0,-67
26424,0,0,33,0,-33
26425,1,1,86,1403,1317
26426,1,0,27,0,-27
26427,0,0,7,0,-7
26428,1,0,15,0,-15
26429,0,0,36,0,-36
26430,1,0,11,0,-11
26431,1,0,20,0,-20
26432,1,1,1171,1436,265
26433,0,0,15,0,-15
26434,0,0,13,0,-13
26435,0,0,175,0,-175
26436,0,0,3,0,-3
26437,1,0,49,0,-49
26438,1,1,164,2271,2107
26439,1,1,28,1797,1769
26440,1,0,158,0,-158
26441,1,1,360,1336,976
26442,1,0,44,0,-44
26443,0,0,23,0,-23
26444,1,1,524,1208,684
26445,0,0,79,0,-79
26446,0,0,12,0,-12
26447,1,0,26,0,-26
26448,0,0,140,0,-140
26449,1,1,89,1593,1504
26450,1,1,70,1384,1314
26451,0,0,26,0,-26
26452,1,0,4,0,-4
26453,1,1,1558,1799,241
26454,1,1,106,1227,1121
26455,0,0,14,0,-14
26456,0,0,29,0,-29
26457,1,0,79,0,-79
26458,1,1,157,1336,1179
26459,1,1,395,1218,823
26460,1,1,230,1344,1114
26461,0,0,43,0,-43
26462,0,0,25,0,-25
26463,1,1,299,1245,946
26464,1,1,791,1913,1122
26465,1,0,19,0,-19
26466,1,1,368,2557,2189
26467,0,0,53,0,-53
26468,1,1,1145,1595,450
26469,1,1,965,1749,784
26470,1,1,1082,1202,120
26471,0,0,33,0,-33
26472,1,0,61,0,-61
26473,0,0,1,0,-1
26474,1,1,611,1906,1295
26475,1,1,1255,1230,-25
26476,1,1,27,1278,1251
26477,0,0,17,0,-17
26478,0,0,74,0,-74
26479,0,0,30,0,-30
26480,0,0,166,0,-166
26481,0,0,99,0,-99
26482,1,0,45,0,-45
26483,1,0,0,0,0
26484,0,0,26,0,-26
26485,0,0,73,0,-73
26486,0,0,86,0,-86
26487,0,0,72,0,-72
26488,1,1,404,1295,891
26489,1,0,78,0,-78
26490,1,1,280,1403,1123
26491,1,0,36,0,-36
26492,1,1,102,2638,2536
26493,0,0,17,0,-17
26494,1,1,233,1514,1281
26495,0,0,23,0,-23
26496,0,0,163,0,-163
26497,1,1,619,1684,1065
26498,0,0,42,0,-42
26499,1,1,256,1963,1707
26500,1,0,32,0,-32
26501,0,0,10,0,-10
26502,1,0,23,0,-23
26503,0,0,139,0,-139
26504,1,0,44,0,-44
26505,1,1,116,1323,1207
26506,0,0,30,0,-30
26507,0,0,212,0,-212
26508,1,1,300,1384,1084
26509,1,0,89,0,-89
26510,0,0,18,0,-18
26511,0,0,22,0,-22
26512,1,1,435,1983,1548
26513,0,0,1,0,-1
26514,0,0,0,0,0
26515,0,0,16,0,-16
26516,0,0,30,0,-30
26517,0,0,1,0,-1
26518,1,0,55,0,-55
26519,1,0,85,0,-85
26520,0,0,77,0,-77
26521,1,1,1497,1368,-129
26522,0,0,56,0,-56
26523,1,1,1050,1327,277
26524,1,1,636,1226,590
26525,1,1,1356,2359,1003
26526,1,1,19,1388,1369
26527,0,0,80,0,-80
26528,0,0,13,0,-13
26529,1,0,14,0,-14
26530,1,1,351,2450,2099
26531,0,0,19,0,-19
26532,1,1,60,2082,2022
26533,1,0,13,0,-13
26534,1,1,1469,1284,-185
26535,1,1,252,2483,2231
26536,0,0,9,0,-9
26537,0,0,78,0,-78
26538,0,0,54,0,-54
26539,1,0,38,0,-38
26540,1,1,333,2063,1730
26541,0,0,55,0,-55
26542,1,1,468,1450,982
26543,0,0,54,0,-54
26544,0,0,10,0,-10
26545,1,1,1187,1741,554
26546,0,0,113,0,-113
26547,1,0,102,0,-102
26548,0,0,47,0,-47
26549,1,1,75,1239,1164
26550,1,0,80,0,-80
26551,0,0,37,0,-37
26552,0,0,105,0,-105
26553,1,1,413,2931,2518
26554,1,0,28,0,-28
26555,0,0,10,0,-10
26556,0,0,78,0,-78
26557,0,0,5,0,-5
26558,1,1,2361,1444,-917
26559,0,0,2,0,-2
26560,1,1,303,1531,1228
26561,1,0,74,0,-74
26562,0,0,3,0,-3
26563,1,0,56,0,-56
26564,0,0,11,0,-11
26565,1,1,77,1231,1154
26566,1,1,631,1552,921
26567,0,0,87,0,-87
26568,0,0,61,0,-61
26569,1,0,6,0,-6
26570,0,0,99,0,-99
26571,0,0,6,0,-6
26572,1,0,145,0,-145
26573,0,0,13,0,-13
26574,1,0,57,0,-57
26575,0,0,16,0,-16
26576,1,1,95,1566,1471
26577,0,0,105,0,-105
26578,1,0,55,0,-55
26579,1,0,86,0,-86
26580,1,1,1741,1472,-269
26581,0,0,18,0,-18
26582,0,0,93,0,-93
26583,0,0,62,0,-62
26584,1,0,110,0,-110
26585,0,0,27,0,-27
26586,1,0,24,0,-24
26587,0,0,71,0,-71
26588,0,0,24,0,-24
26589,0,0,13,0,-13
26590,1,0,13,0,-13
26591,1,0,42,0,-42
26592,1,0,17,0,-17
26593,0,0,79,0,-79
26594,1,0,110,0,-110
26595,1,0,86,0,-86
26596,1,0,237,0,-237
26597,0,0,33,0,-33
26598,1,1,498,1285,787
26599,0,0,28,0,-28
26600,1,0,67,0,-67
26601,0,0,15,0,-15
26602,1,1,399,1458,1059
26603,1,0,3,0,-3
26604,1,0,49,0,-49
26605,1,1,86,1568,1482
26606,0,0,17,0,-17
26607,1,0,48,0,-48
26608,1,0,244,0,-244
26609,0,0,19,0,-19
26610,0,0,154,0,-154
26611,1,0,46,0,-46
26612,1,1,467,2134,1667
26613,1,0,51,0,-51
26614,0,0,117,0,-117
26615,1,0,4,0,-4
26616,0,0,7,0,-7
26617,1,1,35,1549,1514
26618,0,0,22,0,-22
26619,1,0,108,0,-108
26620,0,0,27,0,-27
26621,1,1,88,1370,1282
26622,1,0,16,0,-16
26623,0,0,8,0,-8
26624,1,1,666,1742,1076
26625,0,0,11,0,-11
26626,0,0,15,0,-15
26627,1,0,33,0,-33
26628,1,1,542,2479,1937
26629,1,1,240,1247,1007
26630,1,1,152,1224,1072
26631,1,0,26,0,-26
26632,1,0,21,0,-21
26633,1,1,53,1666,1613
26634,1,1,179,1662,1483
26635,1,1,222,1258,1036
26636,1,1,637,1657,1020
26637,1,1,420,1247,827
26638,1,0,25,0,-25
26639,0,0,21,0,-21
26640,1,1,250,1656,1406
26641,1,0,13,0,-13
26642,0,0,17,0,-17
26643,1,1,89,2067,1978
26644,0,0,29,0,-29
26645,0,0,96,0,-96
26646,1,0,77,0,-77
26647,1,0,108,0,-108
26648,0,0,23,0,-23
26649,1,0,52,0,-52
26650,1,1,231,2140,1909
26651,0,0,11,0,-11
26652,1,1,1314,1289,-25
26653,1,1,440,2299,1859
26654,0,0,8,0,-8
26655,1,0,83,0,-83
26656,1,0,41,0,-41
26657,0,0,57,0,-57
26658,1,1,614,1436,822
26659,0,0,9,0,-9
26660,1,0,64,0,-64
26661,1,0,134,0,-134
26662,0,0,56,0,-56
26663,0,0,56,0,-56
26664,0,0,71,0,-71
26665,1,1,337,1369,1032
26666,1,1,930,1530,600
26667,1,1,126,1562,1436
26668,1,1,275,1374,1099
26669,1,1,588,2127,1539
26670,0,0,3,0,-3
26671,1,1,124,1724,1600
26672,0,0,13,0,-13
26673,1,0,5,0,-5
26674,0,0,152,0,-152
26675,0,0,52,0,-52
26676,1,1,537,2063,1526
26677,1,0,100,0,-100
26678,1,0,50,0,-50
26679,1,1,763,1215,452
26680,0,0,151,0,-151
26681,1,1,155,2081,1926
26682,1,1,443,2979,2536
26683,1,1,299,1473,1174
26684,1,1,251,1723,1472
26685,1,1,163,1803,1640
26686,0,0,187,0,-187
26687,1,1,348,2089,1741
26688,1,1,749,1306,557
26689,1,0,14,0,-14
26690,1,1,104,1280,1176
26691,0,0,39,0,-39
26692,0,0,0,0,0
26693,1,0,63,0,-63
26694,0,0,29,0,-29
26695,0,0,48,0,-48
26696,0,0,94,0,-94
26697,1,0,0,0,0
26698,1,0,6,0,-6
26699,1,1,186,1931,1745
26700,1,1,112,1431,1319
26701,0,0,14,0,-14
26702,1,0,18,0,-18
26703,1,1,91,1591,1500
26704,1,1,374,1270,896
26705,1,0,37,0,-37
26706,1,0,8,0,-8
26707,0,0,59,0,-59
26708,0,0,99,0,-99
26709,1,1,97,2059,1962
26710,0,0,24,0,-24
26711,1,0,79,0,-79
26712,1,1,302,1937,1635
26713,0,0,43,0,-43
26714,1,0,114,0,-114
26715,0,0,13,0,-13
26716,0,0,43,0,-43
26717,0,0,10,0,-10
26718,1,1,340,2092,1752
26719,0,0,36,0,-36
26720,1,0,109,0,-109
26721,1,1,26,1302,1276
26722,1,1,438,1463,1025
26723,0,0,84,0,-84
26724,0,0,12,0,-12
26725,1,0,17,0,-17
26726,0,0,10,0,-10
26727,1,1,712,1274,562
26728,0,0,41,0,-41
26729,0,0,104,0,-104
26730,1,0,42,0,-42
26731,0,0,39,0,-39
26732,0,0,1,0,-1
26733,1,1,341,1559,1218
26734,1,1,35,1528,1493
26735,0,0,20,0,-20
26736,1,0,60,0,-60
26737,0,0,16,0,-16
26738,0,0,41,0,-41
26739,1,0,38,0,-38
26740,0,0,35,0,-35
26741,1,1,1462,1683,221
26742,1,1,375,1455,1080
26743,0,0,25,0,-25
26744,1,0,27,0,-27
26745,1,1,306,1439,1133
26746,1,0,9,0,-9
26747,1,1,126,1438,1312
26748,0,0,168,0,-168
26749,0,0,81,0,-81
26750,1,1,1148,1208,60
26751,1,1,842,1292,450
26752,0,0,182,0,-182
26753,0,0,102,0,-102
26754,0,0,156,0,-156
26755,0,0,11,0,-11
26756,1,1,535,1225,690
26757,1,0,20,0,-20
26758,0,0,23,0,-23
26759,1,0,9,0,-9
26760,0,0,3,0,-3
26761,1,0,30,0,-30
26762,1,1,415,1476,1061
26763,1,1,517,1894,1377
26764,0,0,79,0,-79
26765,1,0,58,0,-58
26766,0,0,79,0,-79
26767,0,0,107,0,-107
26768,1,0,263,0,-263
26769,1,0,18,0,-18
26770,1,0,51,0,-51
26771,0,0,31,0,-31
26772,0,0,39,0,-39
26773,1,0,100,0,-100
26774,1,0,103,0,-103
26775,1,1,155,1946,1791
26776,1,1,362,1584,1222
26777,1,1,528,2128,1600
26778,1,0,30,0,-30
26779,1,0,44,0,-44
26780,0,0,7,0,-7
26781,1,1,635,1447,812
26782,0,0,13,0,-13
26783,1,1,56,1345,1289
26784,0,0,104,0,-104
26785,0,0,38,0,-38
26786,1,1,338,1359,1021
26787,1,0,4,0,-4
26788,0,0,104,0,-104
26789,0,0,3,0,-3
26790,0,0,36,0,-36
26791,1,0,4,0,-4
26792,0,0,7,0,-7
26793,0,0,62,0,-62
26794,0,0,68,0,-68
26795,1,0,42,0,-42
26796,0,0,13,0,-13
26797,1,1,325,1398,1073
26798,1,1,27,2306,2279
26799,1,1,921,1674,753
26800,1,1,267,1229,962
26801,0,0,104,0,-104
26802,1,0,71,0,-71
26803,1,1,1123,1216,93
26804,0,0,1,0,-1
26805,0,0,29,0,-29
26806,0,0,29,0,-29
26807,0,0,104,0,-104
26808,0,0,23,0,-23
26809,1,0,20,0,-20
26810,1,0,476,0,-476
26811,0,0,21,0,-21
26812,0,0,14,0,-14
26813,1,0,59,0,-59
26814,1,0,225,0,-225
26815,1,0,124,0,-124
26816,0,0,98,0,-98
26817,1,1,224,2126,1902
26818,1,0,4,0,-4
26819,1,1,296,1368,1072
26820,1,0,131,0,-131
26821,0,0,151,0,-151
26822,0,0,26,0,-26
26823,0,0,16,0,-16
26824,1,1,178,2407,2229
26825,1,1,52,1350,1298
26826,0,0,1,0,-1
26827,0,0,34,0,-34
26828,1,0,40,0,-40
26829,1,1,1473,1593,120
26830,1,1,1068,1206,138
26831,0,0,159,0,-159
26832,0,0,39,0,-39
26833,0,0,8,0,-8
26834,1,0,193,0,-193
26835,0,0,106,0,-106
26836,0,0,202,0,-202
26837,1,0,73,0,-73
26838,0,0,40,0,-40
26839,0,0,28,0,-28
26840,1,1,1175,1243,68
26841,1,1,116,1465,1349
26842,1,1,618,2412,1794
26843,1,0,14,0,-14
26844,1,0,122,0,-122
26845,1,0,3,0,-3
26846,0,0,19,0,-19
26847,0,0,9,0,-9
26848,0,0,16,0,-16
26849,0,0,55,0,-55
26850,0,0,13,0,-13
26851,0,0,8,0,-8
26852,1,1,600,1354,754
26853,0,0,62,0,-62
26854,1,0,20,0,-20
26855,0,0,42,0,-42
26856,1,1,552,1449,897
26857,1,1,160,1457,1297
26858,1,0,152,0,-152
26859,1,0,18,0,-18
26860,1,1,207,1212,1005
26861,0,0,24,0,-24
26862,1,1,588,1469,881
26863,0,0,108,0,-108
26864,1,1,99,1617,1518
26865,0,0,5,0,-5
26866,0,0,161,0,-161
26867,0,0,107,0,-107
26868,1,1,293,1233,940
26869,1,1,109,1250,1141
26870,0,0,83,0,-83
26871,0,0,9,0,-9
26872,0,0,14,0,-14
26873,0,0,6,0,-6
26874,1,1,444,1359,915
26875,0,0,107,0,-107
26876,1,0,31,0,-31
26877,0,0,19,0,-19
26878,0,0,11,0,-11
26879,1,0,142,0,-142
26880,1,0,16,0,-16
26881,0,0,14,0,-14
26882,1,0,44,0,-44
26883,0,0,24,0,-24
26884,0,0,61,0,-61
26885,1,0,27,0,-27
26886,1,0,16,0,-16
26887,0,0,13,0,-13
26888,0,0,50,0,-50
26889,1,1,315,1724,1409
26890,0,0,5,0,-5
26891,1,0,6,0,-6
26892,0,0,81,0,-81
26893,0,0,15,0,-15
26894,1,1,304,1221,917
26895,1,1,123,1231,1108
26896,1,1,948,1509,561
26897,1,0,40,0,-40
26898,1,1,69,1293,1224
26899,1,0,8,0,-8
26900,1,0,25,0,-25
26901,0,0,61,0,-61
26902,0,0,9,0,-9
26903,0,0,1,0,-1
26904,0,0,38,0,-38
26905,1,0,79,0,-79
26906,0,0,266,0,-266
26907,0,0,3,0,-3
26908,1,0,16,0,-16
26909,1,0,17,0,-17
26910,1,1,925,1963,1038
26911,1,1,325,1401,1076
26912,1,0,15,0,-15
26913,0,0,118,0,-118
26914,1,0,150,0,-150
26915,1,1,246,1466,1220
26916,1,1,768,2275,1507
26917,1,1,254,1471,1217
26918,0,0,10,0,-10
26919,1,1,1934,1728,-206
26920,1,1,364,1442,1078
26921,0,0,19,0,-19
26922,1,1,276,1509,1233
26923,1,0,39,0,-39
26924,0,0,63,0,-63
26925,1,0,21,0,-21
26926,0,0,54,0,-54
26927,0,0,48,0,-48
26928,1,1,327,2237,1910
26929,1,0,58,0,-58
26930,1,1,927,2356,1429
26931,1,1,153,1252,1099
26932,0,0,26,0,-26
26933,1,1,156,1263,1107
26934,1,0,64,0,-64
26935,0,0,9,0,-9
26936,0,0,9,0,-9
26937,0,0,17,0,-17
26938,1,0,183,0,-183
26939,0,0,36,0,-36
26940,0,0,47,0,-47
26941,0,0,75,0,-75
26942,0,0,27,0,-27
26943,1,0,34,0,-34
26944,1,1,730,1533,803
26945,1,1,63,1228,1165
26946,1,1,407,1538,1131
26947,1,1,1905,1457,-448
26948,1,0,12,0,-12
26949,0,0,12,0,-12
26950,0,0,177,0,-177
26951,0,0,43,0,-43
26952,0,0,43,0,-43
26953,1,1,294,1603,1309
26954,1,1,1031,1219,188
26955,1,1,212,1321,1109
26956,0,0,134,0,-134
26957,1,0,37,0,-37
26958,1,0,192,0,-192
26959,1,1,772,1390,618
26960,0,0,150,0,-150
26961,0,0,10,0,-10
26962,1,1,197,1258,1061
26963,0,0,72,0,-72
26964,1,0,67,0,-67
26965,0,0,150,0,-150
26966,0,0,92,0,-92
26967,0,0,31,0,-31
26968,1,1,45,1723,1678
26969,0,0,12,0,-12
26970,0,0,19,0,-19
26971,1,1,289,1804,1515
26972,0,0,33,0,-33
26973,0,0,110,0,-110
26974,0,0,56,0,-56
26975,0,0,121,0,-121
26976,1,1,1161,1268,107
26977,0,0,4,0,-4
26978,1,1,42,1315,1273
26979,1,0,191,0,-191
26980,0,0,52,0,-52
26981,0,0,246,0,-246
26982,0,0,145,0,-145
26983,0,0,11,0,-11
26984,1,0,102,0,-102
26985,0,0,18,0,-18
26986,1,0,4,0,-4
26987,1,0,56,0,-56
26988,1,1,259,1512,1253
26989,1,1,546,2228,1682
26990,1,1,319,2158,1839
26991,1,1,949,1367,418
26992,0,0,34,0,-34
26993,1,1,525,1249,724
26994,0,0,16,0,-16
26995,1,1,207,3653,3446
26996,1,0,44,0,-44
26997,1,1,599,1269,670
26998,0,0,26,0,-26
26999,0,0,27,0,-27
27000,1,1,118,1410,1292
27001,1,0,7,0,-7
27002,1,1,692,1777,1085
27003,0,0,33,0,-33
27004,1,0,28,0,-28
27005,0,0,81,0,-81
27006,1,0,99,0,-99
27007,1,1,714,3265,2551
27008,1,0,16,0,-16
27009,1,1,48,1202,1154
27010,1,1,154,1390,1236
27011,1,0,45,0,-45
27012,0,0,26,0,-26
27013,1,1,1514,1256,-258
27014,1,1,1504,2136,632
27015,1,1,179,1648,1469
27016,1,0,4,0,-4
27017,1,1,450,2722,2272
27018,1,0,63,0,-63
27019,1,0,1,0,-1
27020,1,0,6,0,-6
27021,1,0,6,0,-6
27022,0,0,32,0,-32
27023,0,0,13,0,-13
27024,0,0,36,0,-36
27025,1,0,18,0,-18
27026,1,0,171,0,-171
27027,1,0,45,0,-45
27028,1,1,380,1547,1167
27029,1,0,73,0,-73
27030,0,0,60,0,-60
27031,0,0,38,0,-38
27032,1,1,135,2950,2815
27033,0,0,3,0,-3
27034,1,0,70,0,-70
27035,0,0,52,0,-52
27036,1,0,52,0,-52
27037,0,0,54,0,-54
27038,1,1,508,1587,1079
27039,0,0,54,0,-54
27040,0,0,21,0,-21
27041,0,0,68,0,-68
27042,1,1,404,1908,1504
27043,1,0,52,0,-52
27044,0,0,90,0,-90
27045,1,0,77,0,-77
27046,1,1,686,1212,526
27047,0,0,15,0,-15
27048,0,0,11,0,-11
27049,1,1,1468,1581,113
27050,0,0,4,0,-4
27051,0,0,66,0,-66
27052,0,0,46,0,-46
27053,0,0,188,0,-188
27054,0,0,8,0,-8
27055,1,0,9,0,-9
27056,0,0,20,0,-20
27057,0,0,8,0,-8
27058,1,1,313,1475,1162
27059,1,0,9,0,-9
27060,0,0,163,0,-163
27061,0,0,56,0,-56
27062,1,1,157,1210,1053
27063,0,0,235,0,-235
27064,1,0,13,0,-13
27065,0,0,18,0,-18
27066,0,0,63,0,-63
27067,1,0,58,0,-58
27068,0,0,30,0,-30
27069,1,0,21,0,-21
27070,1,1,115,1286,1171
27071,1,0,6,0,-6
27072,0,0,129,0,-129
27073,1,0,48,0,-48
27074,1,0,1,0,-1
27075,0,0,35,0,-35
27076,1,1,668,1202,534
27077,0,0,8,0,-8
27078,0,0,55,0,-55
27079,0,0,8,0,-8
27080,1,0,2,0,-2
27081,1,0,10,0,-10
27082,0,0,71,0,-71
27083,1,1,500,2659,2159
27084,0,0,39,0,-39
27085,1,1,537,1606,1069
27086,0,0,7,0,-7
27087,1,1,272,1207,935
27088,0,0,89,0,-89
27089,1,0,1,0,-1
27090,0,0,101,0,-101
27091,1,0,70,0,-70
27092,1,1,381,1250,869
27093,1,0,33,0,-33
27094,1,1,1332,1305,-27
27095,1,0,6,0,-6
27096,1,0,40,0,-40
27097,1,0,44,0,-44
27098,1,0,128,0,-128
27099,1,1,347,1634,1287
27100,1,0,62,0,-62
27101,0,0,5,0,-5
27102,0,0,7,0,-7
27103,1,1,549,1601,1052
27104,1,1,298,1290,992
27105,1,1,315,1238,923
27106,1,0,0,0,0
27107,1,0,162,0,-162
27108,1,1,138,1323,1185
27109,0,0,51,0,-51
27110,1,0,46,0,-46
27111,0,0,22,0,-22
27112,1,1,281,1921,1640
27113,1,0,29,0,-29
27114,1,0,32,0,-32
27115,0,0,139,0,-139
27116,1,1,450,1402,952
27117,1,0,5,0,-5
27118,0,0,81,0,-81
27119,1,0,31,0,-31
27120,0,0,0,0,0
27121,1,0,217,0,-217
27122,1,0,57,0,-57
27123,1,0,15,0,-15
27124,1,1,307,1548,1241
27125,1,0,47,0,-47
27126,1,1,690,1353,663
27127,1,1,1289,1493,204
27128,0,0,1,0,-1
27129,0,0,69,0,-69
27130,0,0,12,0,-12
27131,1,0,235,0,-235
27132,0,0,58,0,-58
27133,1,0,1,0,-1
27134,1,1,1884,1343,-541
27135,0,0,9,0,-9
27136,1,0,92,0,-92
27137,0,0,0,0,0
27138,0,0,74,0,-74
27139,0,0,53,0,-53
27140,0,0,1,0,-1
27141,0,0,75,0,-75
27142,1,1,218,1331,1113
27143,0,0,80,0,-80
27144,1,1,1378,1559,181
27145,1,1,362,1340,978
27146,0,0,68,0,-68
27147,0,0,30,0,-30
27148,1,1,244,1265,1021
27149,0,0,0,0,0
27150,1,1,159,1480,1321
27151,0,0,102,0,-102
27152,1,0,24,0,-24
27153,1,1,1194,1586,392
27154,1,1,74,1875,1801
27155,0,0,31,0,-31
27156,0,0,1,0,-1
27157,0,0,20,0,-20
27158,1,0,30,0,-30
27159,1,1,471,1360,889
27160,1,1,116,1282,1166
27161,1,0,22,0,-22
27162,1,1,591,1818,1227
27163,0,0,78,0,-78
27164,1,1,150,1889,1739
27165,0,0,16,0,-16
27166,1,1,269,1296,1027
27167,0,0,16,0,-16
27168,1,1,291,1209,918
27169,1,0,80,0,-80
27170,0,0,64,0,-64
27171,0,0,53,0,-53
27172,1,0,9,0,-9
27173,1,1,678,1607,929
27174,1,0,4,0,-4
27175,1,0,1,0,-1
27176,0,0,40,0,-40
27177,0,0,26,0,-26
27178,1,1,892,1804,912
27179,1,1,1258,1255,-3
27180,1,0,8,0,-8
27181,0,0,45,0,-45
27182,0,0,37,0,-37
27183,1,0,12,0,-12
27184,1,1,357,1348,991
27185,1,0,61,0,-61
27186,1,0,37,0,-37
27187,0,0,157,0,-157
27188,1,0,77,0,-77
27189,1,0,33,0,-33
27190,1,1,1100,1387,287
27191,0,0,12,0,-12
27192,0,0,5,0,-5
27193,1,1,57,1982,1925
27194,1,1,573,1306,733
27195,0,0,50,0,-50
27196,1,1,410,1324,914
27197,1,0,8,0,-8
27198,0,0,44,0,-44
27199,0,0,80,0,-80
27200,1,0,14,0,-14
27201,0,0,14,0,-14
27202,0,0,35,0,-35
27203,1,0,0,0,0
27204,1,0,84,0,-84
27205,0,0,17,0,-17
27206,1,0,76,0,-76
27207,0,0,6,0,-6
27208,0,0,56,0,-56
27209,1,1,297,1700,1403
27210,0,0,23,0,-23
27211,1,1,892,1699,807
27212,1,1,398,1406,1008
27213,0,0,40,0,-40
27214,1,0,9,0,-9
27215,1,1,8,1636,1628
27216,0,0,41,0,-41
27217,1,1,1237,1254,17
27218,0,0,21,0,-21
27219,1,1,72,1392,1320
27220,1,0,48,0,-48
27221,1,1,864,1427,563
27222,1,1,448,1312,864
27223,1,0,98,0,-98
27224,0,0,96,0,-96
27225,1,1,782,1313,531
27226,1,0,76,0,-76
27227,1,1,486,1895,1409
27228,1,1,817,1490,673
27229,0,0,9,0,-9
27230,1,0,7,0,-7
27231,1,1,1557,1265,-292
27232,0,0,14,0,-14
27233,0,0,2,0,-2
27234,0,0,28,0,-28
27235,1,0,12,0,-12
27236,0,0,33,0,-33
27237,0,0,56,0,-56
27238,0,0,38,0,-38
27239,0,0,69,0,-69
27240,0,0,28,0,-28
27241,1,1,123,1215,1092
27242,1,0,133,0,-133
27243,1,1,671,1468,797
27244,0,0,151,0,-151
27245,1,1,58,1367,1309
27246,1,0,105,0,-105
27247,0,0,140,0,-140
27248,0,0,9,0,-9
27249,0,0,1,0,-1
27250,1,1,110,1326,1216
27251,0,0,4,0,-4
27252,1,1,759,1321,562
27253,0,0,89,0,-89
27254,1,1,1003,1444,441
27255,0,0,218,0,-218
27256,0,0,38,0,-38
27257,1,0,68,0,-68
27258,1,1,1309,1454,145
27259,1,1,197,1630,1433
27260,1,0,9,0,-9
27261,1,1,226,1520,1294
27262,0,0,9,0,-9
27263,1,1,41,1752,1711
27264,0,0,78,0,-78
27265,1,1,459,2624,2165
27266,1,0,20,0,-20
27267,1,0,33,0,-33
27268,1,1,387,1216,829
27269,1,1,1253,1475,222
27270,1,1,378,1525,1147
27271,0,0,8,0,-8
27272,1,0,53,0,-53
27273,0,0,10,0,-10
27274,1,1,1084,1412,328
27275,0,0,71,0,-71
27276,1,1,900,1275,375
27277,0,0,85,0,-85
27278,0,0,11,0,-11
27279,1,0,8,0,-8
27280,1,0,28,0,-28
27281,0,0,53,0,-53
27282,1,1,430,1204,774
27283,1,0,27,0,-27
27284,1,0,44,0,-44
27285,1,0,75,0,-75
27286,1,0,36,0,-36
27287,1,0,114,0,-114
27288,0,0,4,0,-4
27289,0,0,12,0,-12
27290,1,0,38,0,-38
27291,0,0,175,0,-175
27292,0,0,142,0,-142
27293,1,1,264,1948,1684
27294,1,1,689,1747,1058
27295,0,0,6,0,-6
27296,0,0,22,0,-22
27297,1,0,2,0,-2
27298,1,1,755,2756,2001
27299,0,0,2,0,-2
27300,0,0,15,0,-15
27301,1,0,1,0,-1
27302,1,0,13,0,-13
27303,0,0,55,0,-55
27304,1,0,4,0,-4
27305,1,1,2011,1205,-806
27306,1,1,743,1514,771
27307,0,0,92,0,-92
27308,1,1,1064,1482,418
27309,0,0,13,0,-13
27310,0,0,12,0,-12
27311,1,1,268,1692,1424
27312,1,0,21,0,-21
27313,1,0,59,0,-59
27314,0,0,2,0,-2
27315,0,0,18,0,-18
27316,1,0,43,0,-43
27317,1,0,11,0,-11
27318,1,0,34,0,-34
27319,1,0,98,0,-98
27320,0,0,19,0,-19
27321,1,0,44,0,-44
27322,0,0,3,0,-3
27323,0,0,19,0,-19
27324,0,0,22,0,-22
27325,0,0,20,0,-20
27326,0,0,20,0,-20
27327,1,1,267,1583,1316
27328,1,1,141,1718,1577
27329,0,0,34,0,-34
27330,1,1,607,2099,1492
27331,0,0,69,0,-69
27332,0,0,98,0,-98
27333,1,0,11,0,-11
27334,1,1,95,1290,1195
27335,1,1,153,1372,1219
27336,0,0,16,0,-16
27337,1,0,47,0,-47
27338,1,1,115,2378,2263
27339,1,1,1029,1225,196
27340,0,0,49,0,-49
27341,0,0,50,0,-50
27342,1,0,429,0,-429
27343,0,0,14,0,-14
27344,0,0,95,0,-95
27345,1,1,479,1315,836
27346,1,1,62,1557,1495
27347,0,0,28,0,-28
27348,0,0,41,0,-41
27349,1,0,7,0,-7
27350,0,0,85,0,-85
27351,0,0,40,0,-40
27352,1,1,178,1221,1043
27353,0,0,61,0,-61
27354,1,0,2,0,-2
27355,1,1,251,1626,1375
27356,1,1,428,1347,919
27357,0,0,4,0,-4
27358,1,1,236,1544,1308
27359,1,1,79,1235,1156
27360,1,1,315,1529,1214
27361,1,0,109,0,-109
27362,1,1,246,1796,1550
27363,1,1,661,2721,2060
27364,1,1,315,1508,1193
27365,1,1,165,1595,1430
27366,0,0,3,0,-3
27367,1,1,1477,1345,-132
27368,0,0,121,0,-121
27369,0,0,191,0,-191
27370,1,0,10,0,-10
27371,1,1,776,1293,517
27372,1,0,30,0,-30
27373,1,0,7,0,-7
27374,1,1,729,1204,475
27375,0,0,11,0,-11
27376,1,1,233,1257,1024
27377,0,0,66,0,-66
27378,1,1,71,1561,1490
27379,1,1,976,1242,266
27380,1,0,111,0,-111
27381,0,0,45,0,-45
27382,1,0,71,0,-71
27383,1,0,46,0,-46
27384,0,0,28,0,-28
27385,1,0,36,0,-36
27386,1,0,7,0,-7
27387,1,0,14,0,-14
27388,0,0,16,0,-16
27389,0,0,12,0,-12
27390,1,0,49,0,-49
27391,1,1,386,2267,1881
27392,0,0,0,0,0
27393,0,0,1,0,-1
27394,1,1,252,2119,1867
27395,1,1,445,1552,1107
27396,1,1,243,1535,1292
27397,1,0,82,0,-82
27398,0,0,20,0,-20
27399,1,0,27,0,-27
27400,0,0,210,0,-210
27401,0,0,27,0,-27
27402,1,0,38,0,-38
27403,0,0,32,0,-32
27404,1,1,1110,1938,828
27405,1,0,30,0,-30
27406,1,0,73,0,-73
27407,1,0,18,0,-18
27408,0,0,19,0,-19
27409,1,0,14,0,-14
27410,1,0,23,0,-23
27411,0,0,156,0,-156
27412,1,1,785,1357,572
27413,0,0,78,0,-78
27414,1,0,5,0,-5
27415,0,0,22,0,-22
27416,1,0,16,0,-16
27417,1,0,16,0,-16
27418,1,0,16,0,-16
27419,0,0,6,0,-6
27420,0,0,16,0,-16
27421,1,0,0,0,0
27422,0,0,23,0,-23
27423,0,0,44,0,-44
27424,0,0,18,0,-18
27425,0,0,85,0,-85
27426,0,0,14,0,-14
27427,1,0,37,0,-37
27428,0,0,168,0,-168
27429,0,0,23,0,-23
27430,0,0,0,0,0
27431,1,0,10,0,-10
27432,1,0,195,0,-195
27433,1,0,179,0,-179
27434,1,1,1118,1231,113
27435,1,0,154,0,-154
27436,1,0,38,0,-38
27437,1,1,52,1512,1460
27438,1,1,62,1443,1381
27439,1,0,67,0,-67
27440,0,0,71,0,-71
27441,1,1,46,2307,2261
27442,0,0,65,0,-65
27443,0,0,52,0,-52
27444,1,1,132,1493,1361
27445,0,0,82,0,-82
27446,0,0,5,0,-5
27447,0,0,25,0,-25
27448,1,0,33,0,-33
27449,1,0,110,0,-110
27450,1,0,71,0,-71
27451,1,1,1445,1359,-86
27452,1,0,5,0,-5
27453,0,0,6,0,-6
27454,1,1,557,1518,961
27455,1,0,27,0,-27
27456,0,0,9,0,-9
27457,1,1,334,1256,922
27458,1,0,52,0,-52
27459,1,1,22,1251,1229
27460,1,1,64,1247,1183
27461,0,0,60,0,-60
27462,0,0,24,0,-24
27463,0,0,109,0,-109
27464,0,0,42,0,-42
27465,1,1,708,1277,569
27466,0,0,2,0,-2
27467,0,0,74,0,-74
27468,0,0,147,0,-147
27469,1,0,44,0,-44
27470,0,0,39,0,-39
27471,0,0,34,0,-34
27472,1,1,1540,1479,-61
27473,0,0,16,0,-16
27474,1,1,1205,1219,14
27475,0,0,5,0,-5
27476,1,0,229,0,-229
27477,1,1,495,1222,727
27478,1,1,201,1234,1033
27479,1,0,22,0,-22
27480,1,0,3,0,-3
27481,1,1,582,1260,678
27482,1,0,47,0,-47
27483,1,1,149,1505,1356
27484,1,1,108,1231,1123
27485,1,1,392,1323,931
27486,1,0,4,0,-4
27487,0,0,33,0,-33
27488,0,0,18,0,-18
27489,1,0,103,0,-103
27490,1,0,139,0,-139
27491,1,0,38,0,-38
27492,1,0,11,0,-11
27493,1,1,740,1518,778
27494,1,1,213,1398,1185
27495,0,0,47,0,-47
27496,1,1,1371,1388,17
27497,1,1,681,1424,743
27498,0,0,2,0,-2
27499,1,0,47,0,-47
27500,1,0,30,0,-30
27501,0,0,77,0,-77
27502,1,0,18,0,-18
27503,1,0,71,0,-71
27504,0,0,36,0,-36
27505,0,0,22,0,-22
27506,0,0,196,0,-196
27507,0,0,98,0,-98
27508,1,1,1476,1369,-107
27509,1,1,311,1680,1369
27510,1,0,68,0,-68
27511,0,0,36,0,-36
27512,0,0,58,0,-58
27513,1,0,12,0,-12
27514,1,0,32,0,-32
27515,1,1,97,1339,1242
27516,1,1,49,1243,1194
27517,0,0,52,0,-52
27518,1,1,175,1341,1166
27519,0,0,42,0,-42
27520,1,0,10,0,-10
27521,1,1,1461,1386,-75
27522,1,0,8,0,-8
27523,1,1,263,1628,1365
27524,1,0,21,0,-21
27525,1,1,105,1210,1105
27526,1,1,152,2231,2079
27527,1,1,477,1230,753
27528,1,0,19,0,-19
27529,1,1,58,1221,1163
27530,1,0,165,0,-165
27531,0,0,16,0,-16
27532,1,1,171,3004,2833
27533,1,1,743,1347,604
27534,0,0,13,0,-13
27535,0,0,29,0,-29
27536,1,1,451,1840,1389
27537,0,0,10,0,-10
27538,1,0,2,0,-2
27539,1,1,1421,3949,2528
27540,1,1,66,2065,1999
27541,1,0,101,0,-101
27542,1,1,1273,1506,233
27543,1,1,164,1210,1046
27544,0,0,57,0,-57
27545,0,0,19,0,-19
27546,1,0,24,0,-24
27547,0,0,4,0,-4
27548,1,0,148,0,-148
27549,1,1,242,1368,1126
27550,0,0,9,0,-9
27551,1,1,184,1763,1579
27552,0,0,34,0,-34
27553,1,1,1380,2565,1185
27554,0,0,20,0,-20
27555,1,1,630,1226,596
27556,0,0,14,0,-14
27557,0,0,31,0,-31
27558,1,1,49,3784,3735
27559,1,0,34,0,-34
27560,1,1,513,1400,887
27561,0,0,75,0,-75
27562,1,1,396,1400,1004
27563,1,1,674,1482,808
27564,1,0,81,0,-81
27565,0,0,4,0,-4
27566,0,0,8,0,-8
27567,0,0,99,0,-99
27568,0,0,221,0,-221
27569,0,0,39,0,-39
27570,0,0,48,0,-48
27571,0,0,54,0,-54
27572,1,0,33,0,-33
27573,1,0,115,0,-115
27574,1,1,659,1270,611
27575,1,1,595,2091,1496
27576,1,0,57,0,-57
27577,0,0,20,0,-20
27578,0,0,134,0,-134
27579,0,0,50,0,-50
27580,1,1,138,1286,1148
27581,1,1,905,1380,475
27582,1,0,1,0,-1
27583,0,0,17,0,-17
27584,1,0,17,0,-17
27585,0,0,140,0,-140
27586,1,1,105,1901,1796
27587,0,0,54,0,-54
27588,1,0,163,0,-163
27589,0,0,51,0,-51
27590,0,0,26,0,-26
27591,0,0,9,0,-9
27592,1,0,78,0,-78
27593,1,0,10,0,-10
27594,1,1,388,1459,1071
27595,1,0,0,0,0
27596,0,0,113,0,-113
27597,1,1,391,4174,3783
27598,1,0,49,0,-49
27599,1,1,825,1327,502
27600,1,1,286,1866,1580
27601,1,1,581,2254,1673
27602,1,0,23,0,-23
27603,1,0,45,0,-45
27604,1,0,0,0,0
27605,1,1,143,1935,1792
27606,1,0,9,0,-9
27607,0,0,5,0,-5
27608,1,1,469,1239,770
27609,1,0,17,0,-17
27610,1,0,26,0,-26
27611,1,0,33,0,-33
27612,0,0,13,0,-13
27613,1,1,830,1505,675
27614,1,1,442,1354,912
27615,0,0,16,0,-16
27616,1,1,54,1698,1644
27617,1,0,3,0,-3
27618,0,0,94,0,-94
27619,0,0,48,0,-48
27620,1,1,424,1543,1119
27621,1,0,101,0,-101
27622,1,1,162,1452,1290
27623,1,1,195,1275,1080
27624,0,0,0,0,0
27625,0,0,30,0,-30
27626,0,0,23,0,-23
27627,0,0,8,0,-8
27628,1,1,1050,1405,355
27629,1,1,195,2183,1988
27630,0,0,29,0,-29
27631,1,1,214,1377,1163
27632,0,0,55,0,-55
27633,1,0,51,0,-51
27634,1,0,70,0,-70
27635,1,0,42,0,-42
27636,1,0,15,0,-15
27637,1,1,330,1742,1412
27638,1,0,20,0,-20
27639,1,1,210,1561,1351
27640,1,1,369,2095,1726
27641,0,0,27,0,-27
27642,1,0,80,0,-80
27643,0,0,148,0,-148
27644,1,1,574,1226,652
27645,0,0,71,0,-71
27646,1,0,1,0,-1
27647,1,0,34,0,-34
27648,0,0,12,0,-12
27649,1,0,77,0,-77
27650,1,0,37,0,-37
27651,1,0,107,0,-107
27652,0,0,154,0,-154
27653,1,0,57,0,-57
27654,1,0,18,0,-18
27655,1,1,349,1203,854
27656,1,0,43,0,-43
27657,1,1,1011,1664,653
27658,1,0,5,0,-5
27659,1,0,18,0,-18
27660,1,0,18,0,-18
27661,0,0,19,0,-19
27662,1,1,175,1207,1032
27663,0,0,47,0,-47
27664,0,0,1,0,-1
27665,1,0,63,0,-63
27666,1,0,3,0,-3
27667,1,0,57,0,-57
27668,1,0,41,0,-41
27669,0,0,8,0,-8
27670,0,0,8,0,-8
27671,0,0,66,0,-66
27672,0,0,12,0,-12
27673,1,0,37,0,-37
27674,1,0,1,0,-1
27675,1,1,405,1738,1333
27676,1,1,430,1222,792
27677,1,1,684,1694,1010
27678,0,0,27,0,-27
27679,0,0,22,0,-22
27680,0,0,13,0,-13
27681,1,1,110,1203,1093
27682,1,0,0,0,0
27683,0,0,52,0,-52
27684,0,0,21,0,-21
27685,0,0,4,0,-4
27686,1,1,616,1684,1068
27687,0,0,65,0,-65
27688,1,1,234,1533,1299
27689,0,0,33,0,-33
27690,1,0,8,0,-8
27691,0,0,34,0,-34
27692,0,0,46,0,-46
27693,1,1,441,1547,1106
27694,0,0,14,0,-14
27695,0,0,177,0,-177
27696,1,1,233,1332,1099
27697,1,0,16,0,-16
27698,1,0,108,0,-108
27699,1,1,770,1212,442
27700,0,0,76,0,-76
27701,0,0,1,0,-1
27702,1,1,242,1202,960
27703,1,1,1503,1251,-252
27704,1,0,94,0,-94
27705,0,0,12,0,-12
27706,1,1,193,1492,1299
27707,1,1,237,1846,1609
27708,0,0,26,0,-26
27709,1,0,37,0,-37
27710,0,0,163,0,-163
27711,1,0,11,0,-11
27712,0,0,18,0,-18
27713,0,0,240,0,-240
27714,1,1,717,1314,597
27715,1,0,98,0,-98
27716,0,0,25,0,-25
27717,1,1,119,1245,1126
27718,1,1,254,1387,1133
27719,0,0,3,0,-3
27720,0,0,74,0,-74
27721,1,1,347,2044,1697
27722,0,0,3,0,-3
27723,1,0,7,0,-7
27724,1,1,182,1870,1688
27725,1,1,352,1475,1123
27726,0,0,65,0,-65
27727,0,0,55,0,-55
27728,1,1,242,2123,1881
27729,1,1,296,1329,1033
27730,1,0,68,0,-68
27731,0,0,19,0,-19
27732,1,1,444,1355,911
27733,1,0,16,0,-16
27734,0,0,13,0,-13
27735,0,0,71,0,-71
27736,0,0,32,0,-32
27737,0,0,81,0,-81
27738,0,0,69,0,-69
27739,1,1,182,3425,3243
27740,1,0,9,0,-9
27741,0,0,2,0,-2
27742,0,0,37,0,-37
27743,1,0,7,0,-7
27744,1,1,126,1510,1384
27745,1,1,251,1712,1461
27746,0,0,31,0,-31
27747,0,0,4,0,-4
27748,1,0,172,0,-172
27749,0,0,15,0,-15
27750,1,1,183,1223,1040
27751,0,0,5,0,-5
27752,1,1,978,1488,510
27753,1,1,518,1787,1269
27754,1,0,100,0,-100
27755,1,1,831,1607,776
27756,0,0,30,0,-30
27757,0,0,2,0,-2
27758,0,0,15,0,-15
27759,0,0,80,0,-80
27760,0,0,65,0,-65
27761,0,0,11,0,-11
27762,1,0,14,0,-14
27763,0,0,16,0,-16
27764,1,0,42,0,-42
27765,0,0,51,0,-51
27766,1,1,793,1515,722
27767,1,0,13,0,-13
27768,0,0,40,0,-40
27769,0,0,10,0,-10
27770,0,0,103,0,-103
27771,1,1,605,2018,1413
27772,1,0,27,0,-27
27773,1,0,10,0,-10
27774,1,0,9,0,-9
27775,1,1,717,1483,766
27776,1,0,18,0,-18
27777,0,0,92,0,-92
27778,1,1,210,2338,2128
27779,1,1,78,1443,1365
27780,1,1,6,1388,1382
27781,1,0,103,0,-103
27782,0,0,8,0,-8
27783,0,0,20,0,-20
27784,0,0,97,0,-97
27785,0,0,18,0,-18
27786,1,1,397,1210,813
27787,1,0,56,0,-56
27788,1,0,0,0,0
27789,0,0,66,0,-66
27790,0,0,189,0,-189
27791,1,1,341,1260,919
27792,0,0,1,0,-1
27793,1,1,766,1272,506
27794,1,0,56,0,-56
27795,1,1,1610,1404,-206
27796,1,1,571,1299,728
27797,1,1,130,1258,1128
27798,1,0,63,0,-63
27799,0,0,22,0,-22
27800,0,0,61,0,-61
27801,1,0,31,0,-31
27802,0,0,176,0,-176
27803,0,0,19,0,-19
27804,0,0,23,0,-23
27805,0,0,74,0,-74
27806,1,1,17,1457,1440
27807,0,0,70,0,-70
27808,1,0,7,0,-7
27809,1,1,233,1421,1188
27810,0,0,33,0,-33
27811,1,1,241,1880,1639
27812,1,0,31,0,-31
27813,1,0,26,0,-26
27814,0,0,53,0,-53
27815,0,0,30,0,-30
27816,1,0,22,0,-22
27817,1,0,26,0,-26
27818,0,0,46,0,-46
27819,1,1,1077,1408,331
27820,1,0,57,0,-57
27821,0,0,84,0,-84
27822,1,1,369,1751,1382
27823,0,0,169,0,-169
27824,0,0,7,0,-7
27825,1,0,114,0,-114
27826,1,0,157,0,-157
27827,0,0,269,0,-269
27828,1,0,5,0,-5
27829,1,0,7,0,-7
27830,0,0,24,0,-24
27831,0,0,49,0,-49
27832,0,0,67,0,-67
27833,0,0,76,0,-76
27834,0,0,80,0,-80
27835,0,0,96,0,-96
27836,1,1,1017,1607,590
27837,0,0,53,0,-53
27838,1,1,356,1498,1142
27839,1,1,638,1216,578
27840,0,0,30,0,-30
27841,1,1,1465,1591,126
27842,0,0,24,0,-24
27843,1,0,151,0,-151
27844,1,0,94,0,-94
27845,0,0,17,0,-17
27846,0,0,87,0,-87
27847,1,1,229,2148,1919
27848,1,1,838,1699,861
27849,1,0,45,0,-45
27850,1,0,37,0,-37
27851,1,1,540,1267,727
27852,0,0,24,0,-24
27853,0,0,21,0,-21
27854,0,0,69,0,-69
27855,1,0,12,0,-12
27856,0,0,32,0,-32
27857,1,0,24,0,-24
27858,0,0,4,0,-4
27859,0,0,99,0,-99
27860,1,1,293,1295,1002
27861,0,0,7,0,-7
27862,1,1,456,1803,1347
27863,1,1,906,1413,507
27864,1,1,795,1271,476
27865,0,0,9,0,-9
27866,1,1,1233,1278,45
27867,0,0,4,0,-4
27868,1,1,772,1375,603
27869,1,0,9,0,-9
27870,1,1,181,1626,1445
27871,1,1,421,1342,921
27872,1,1,240,1548,1308
27873,0,0,3,0,-3
27874,1,1,311,3045,2734
27875,1,1,195,1227,1032
27876,1,0,3,0,-3
27877,1,0,2,0,-2
27878,1,1,522,2079,1557
27879,0,0,168,0,-168
27880,1,0,66,0,-66
27881,1,0,16,0,-16
27882,1,0,1,0,-1
27883,1,1,228,1509,1281
27884,1,1,209,1444,1235
27885,1,1,825,1658,833
27886,0,0,33,0,-33
27887,1,0,39,0,-39
27888,0,0,34,0,-34
27889,0,0,117,0,-117
27890,1,1,43,2987,2944
27891,1,0,7,0,-7
27892,0,0,21,0,-21
27893,1,1,735,1314,579
27894,1,0,13,0,-13
27895,0,0,31,0,-31
27896,0,0,44,0,-44
27897,1,1,370,2368,1998
27898,1,1,217,1494,1277
27899,1,1,439,1670,1231
27900,1,0,48,0,-48
27901,0,0,158,0,-158
27902,1,0,22,0,-22
27903,1,0,10,0,-10
27904,1,1,733,1424,691
27905,1,1,489,1531,1042
27906,1,0,19,0,-19
27907,1,0,6,0,-6
27908,1,0,1,0,-1
27909,1,0,1,0,-1
27910,1,1,846,1239,393
27911,0,0,5,0,-5
27912,1,0,28,0,-28
27913,0,0,14,0,-14
27914,1,0,14,0,-14
27915,0,0,11,0,-11
27916,1,0,21,0,-21
27917,0,0,8,0,-8
27918,1,1,14,1226,1212
27919,1,0,71,0,-71
27920,1,0,12,0,-12
27921,1,1,74,1683,1609
27922,0,0,73,0,-73
27923,1,0,4,0,-4
27924,0,0,98,0,-98
27925,0,0,1,0,-1
27926,0,0,99,0,-99
27927,0,0,72,0,-72
27928,0,0,26,0,-26
27929,0,0,29,0,-29
27930,1,1,862,1435,573
27931,0,0,44,0,-44
27932,0,0,9,0,-9
27933,1,1,833,1429,596
27934,1,0,43,0,-43
27935,1,0,21,0,-21
27936,0,0,58,0,-58
27937,0,0,74,0,-74
27938,0,0,139,0,-139
27939,0,0,42,0,-42
27940,1,1,452,2353,1901
27941,1,0,29,0,-29
27942,1,0,1,0,-1
27943,0,0,119,0,-119
27944,1,0,18,0,-18
27945,1,1,127,1210,1083
27946,1,0,25,0,-25
27947,0,0,55,0,-55
27948,0,0,22,0,-22
27949,1,0,11,0,-11
27950,1,0,40,0,-40
27951,1,1,186,2034,1848
27952,1,0,49,0,-49
27953,1,0,88,0,-88
27954,0,0,7,0,-7
27955,1,0,14,0,-14
27956,1,1,276,1560,1284
27957,1,0,12,0,-12
27958,1,1,278,1460,1182
27959,1,0,25,0,-25
27960,1,0,119,0,-119
27961,1,0,38,0,-38
27962,0,0,59,0,-59
27963,0,0,115,0,-115
27964,1,1,104,1544,1440
27965,1,0,24,0,-24
27966,1,1,407,1513,1106
27967,1,1,67,1421,1354
27968,0,0,24,0,-24
27969,0,0,35,0,-35
27970,1,0,10,0,-10
27971,0,0,168,0,-168
27972,0,0,2,0,-2
27973,1,0,33,0,-33
27974,1,1,293,1309,1016
27975,1,1,292,1212,920
27976,1,0,0,0,0
27977,1,1,553,1339,786
27978,1,0,107,0,-107
27979,1,1,277,1518,1241
27980,0,0,50,0,-50
27981,0,0,40,0,-40
27982,0,0,9,0,-9
27983,0,0,32,0,-32
27984,1,1,228,4059,3831
27985,1,0,29,0,-29
27986,1,0,69,0,-69
27987,0,0,119,0,-119
27988,1,0,143,0,-143
27989,0,0,21,0,-21
27990,0,0,46,0,-46
27991,1,0,42,0,-42
27992,0,0,24,0,-24
27993,0,0,23,0,-23
27994,0,0,93,0,-93
27995,1,0,100,0,-100
27996,1,1,86,2541,2455
27997,1,1,513,1404,891
27998,0,0,57,0,-57
27999,1,0,1,0,-1
28000,0,0,1,0,-1
28001,0,0,2,0,-2
28002,1,1,875,2353,1478
28003,1,1,113,1643,1530
28004,0,0,14,0,-14
28005,1,0,65,0,-65
28006,0,0,31,0,-31
28007,0,0,58,0,-58
28008,0,0,8,0,-8
28009,1,1,240,1262,1022
28010,0,0,8,0,-8
28011,0,0,16,0,-16
28012,1,0,15,0,-15
28013,0,0,77,0,-77
28014,1,1,279,1300,1021
28015,1,1,254,1237,983
28016,1,1,548,2364,1816
28017,1,1,395,2545,2150
28018,0,0,38,0,-38
28019,1,0,47,0,-47
28020,1,0,10,0,-10
28021,0,0,5,0,-5
28022,1,0,7,0,-7
28023,1,0,169,0,-169
28024,1,1,700,1228,528
28025,1,0,49,0,-49
28026,1,1,244,1927,1683
28027,1,0,58,0,-58
28028,1,1,266,1202,936
28029,1,0,16,0,-16
28030,1,0,76,0,-76
28031,1,0,213,0,-213
28032,0,0,39,0,-39
28033,0,0,23,0,-23
28034,0,0,84,0,-84
28035,1,1,256,1446,1190
28036,1,1,1210,1292,82
28037,0,0,37,0,-37
28038,0,0,12,0,-12
28039,0,0,44,0,-44
28040,1,0,34,0,-34
28041,0,0,37,0,-37
28042,1,0,40,0,-40
28043,1,1,947,1356,409
28044,1,1,1855,1312,-543
28045,1,1,1056,1291,235
28046,1,1,298,1592,1294
28047,1,1,226,2379,2153
28048,1,0,13,0,-13
28049,1,0,88,0,-88
28050,1,1,131,1383,1252
28051,0,0,55,0,-55
28052,1,1,1672,1230,-442
28053,1,1,104,1532,1428
28054,1,1,639,1889,1250
28055,0,0,16,0,-16
28056,1,0,102,0,-102
28057,0,0,8,0,-8
28058,1,1,474,1334,860
28059,1,1,247,1550,1303
28060,1,0,92,0,-92
28061,1,1,1988,1202,-786
28062,0,0,70,0,-70
28063,1,0,35,0,-35
28064,0,0,13,0,-13
28065,1,1,1028,1925,897
28066,1,0,143,0,-143
28067,1,0,26,0,-26
28068,1,0,61,0,-61
28069,1,1,265,1510,1245
28070,1,1,297,1251,954
28071,0,0,1,0,-1
28072,1,1,1296,1315,19
28073,0,0,91,0,-91
28074,1,1,531,1217,686
28075,1,1,462,1358,896
28076,1,0,45,0,-45
28077,0,0,79,0,-79
28078,1,0,40,0,-40
28079,0,0,7,0,-7
28080,1,0,193,0,-193
28081,1,1,315,1363,1048
28082,0,0,14,0,-14
28083,0,0,120,0,-120
28084,1,0,12,0,-12
28085,0,0,114,0,-114
28086,0,0,6,0,-6
28087,1,0,3,0,-3
28088,1,1,128,2115,1987
28089,1,0,12,0,-12
28090,1,1,103,2028,1925
28091,1,0,48,0,-48
28092,0,0,95,0,-95
28093,0,0,19,0,-19
28094,0,0,13,0,-13
28095,0,0,68,0,-68
28096,1,0,0,0,0
28097,0,0,21,0,-21
28098,1,1,302,1383,1081
28099,1,0,106,0,-106
28100,1,0,96,0,-96
28101,0,0,34,0,-34
28102,1,1,444,1328,884
28103,0,0,62,0,-62
28104,1,0,191,0,-191
28105,1,0,52,0,-52
28106,1,1,73,2038,1965
28107,1,0,109,0,-109
28108,1,1,9,1719,1710
28109,1,1,542,1501,959
28110,1,0,53,0,-53
28111,1,0,18,0,-18
28112,1,0,110,0,-110
28113,1,1,576,1461,885
28114,1,0,16,0,-16
28115,0,0,52,0,-52
28116,1,0,55,0,-55
28117,0,0,67,0,-67
28118,1,0,127,0,-127
28119,0,0,18,0,-18
28120,1,0,25,0,-25
28121,1,1,41,1613,1572
28122,1,1,102,1331,1229
28123,0,0,149,0,-149
28124,1,1,274,1379,1105
28125,1,0,0,0,0
28126,1,1,286,1294,1008
28127,1,1,237,1242,1005
28128,1,0,63,0,-63
28129,1,1,171,1269,1098
28130,1,1,835,1378,543
28131,1,0,126,0,-126
28132,1,0,22,0,-22
28133,0,0,89,0,-89
28134,0,0,106,0,-106
28135,1,1,63,1329,1266
28136,1,0,270,0,-270
28137,0,0,1,0,-1
28138,1,0,11,0,-11
28139,0,0,3,0,-3
28140,1,1,1045,1255,210
28141,0,0,185,0,-185
28142,1,1,349,1351,1002
28143,1,0,49,0,-49
28144,0,0,46,0,-46
28145,0,0,136,0,-136
28146,1,0,19,0,-19
28147,1,1,453,1233,780
28148,1,1,842,1460,618
28149,1,1,18,1453,1435
28150,1,1,862,1273,411
28151,1,0,60,0,-60
28152,0,0,14,0,-14
28153,1,1,274,1238,964
28154,0,0,29,0,-29
28155,1,0,28,0,-28
28156,1,0,0,0,0
28157,1,0,37,0,-37
28158,0,0,51,0,-51
28159,1,1,945,1243,298
28160,0,0,76,0,-76
28161,1,1,103,5308,5205
28162,1,1,329,1305,976
28163,0,0,14,0,-14
28164,1,1,1674,1395,-279
28165,1,0,153,0,-153
28166,1,1,677,3322,2645
28167,1,0,11,0,-11
28168,0,0,82,0,-82
28169,0,0,82,0,-82
28170,0,0,109,0,-109
28171,0,0,31,0,-31
28172,0,0,1,0,-1
28173,1,1,765,1283,518
28174,1,1,434,1842,1408
28175,1,1,291,2345,2054
28176,0,0,15,0,-15
28177,1,0,202,0,-202
28178,1,1,584,1324,740
28179,1,0,6,0,-6
28180,1,1,402,1321,919
28181,1,0,19,0,-19
28182,1,1,411,1225,814
28183,0,0,27,0,-27
28184,0,0,58,0,-58
28185,0,0,6,0,-6
28186,1,1,2066,2573,507
28187,1,0,5,0,-5
28188,1,1,469,1513,1044
28189,1,0,21,0,-21
28190,0,0,4,0,-4
28191,1,1,310,1204,894
28192,1,0,10,0,-10
28193,1,0,6,0,-6
28194,1,1,72,1765,1693
28195,0,0,58,0,-58
28196,1,0,81,0,-81
28197,1,1,100,1367,1267
28198,1,1,317,1379,1062
28199,1,1,485,1670,1185
28200,0,0,26,0,-26
28201,0,0,35,0,-35
28202,1,1,354,1412,1058
28203,0,0,5,0,-5
28204,0,0,30,0,-30
28205,0,0,36,0,-36
28206,1,0,4,0,-4
28207,1,1,202,2605,2403
28208,1,1,1031,1228,197
28209,1,0,24,0,-24
28210,0,0,14,0,-14
28211,0,0,159,0,-159
28212,1,1,381,1379,998
28213,0,0,280,0,-280
28214,1,1,290,1359,1069
28215,0,0,63,0,-63
28216,1,1,449,1247,798
28217,1,1,170,1268,1098
28218,1,0,21,0,-21
28219,1,0,47,0,-47
28220,0,0,26,0,-26
28221,1,1,223,1395,1172
28222,0,0,13,0,-13
28223,0,0,19,0,-19
28224,1,1,703,1226,523
28225,1,1,128,1253,1125
28226,0,0,6,0,-6
28227,0,0,14,0,-14
28228,0,0,28,0,-28
28229,1,1,255,1555,1300
28230,1,0,12,0,-12
28231,0,0,156,0,-156
28232,1,1,280,4496,4216
28233,0,0,20,0,-20
28234,1,1,1055,1814,759
28235,0,0,6,0,-6
28236,0,0,55,0,-55
28237,1,1,428,1638,1210
28238,1,0,33,0,-33
28239,1,0,28,0,-28
28240,0,0,5,0,-5
28241,0,0,32,0,-32
28242,1,1,394,1463,1069
28243,0,0,71,0,-71
28244,0,0,54,0,-54
28245,0,0,36,0,-36
28246,1,1,267,1239,972
28247,0,0,28,0,-28
28248,0,0,12,0,-12
28249,1,1,236,1535,1299
28250,1,0,16,0,-16
28251,0,0,27,0,-27
28252,1,1,120,1266,1146
28253,0,0,128,0,-128
28254,1,0,28,0,-28
28255,0,0,21,0,-21
28256,1,1,1625,1244,-381
28257,0,0,26,0,-26
28258,1,0,27,0,-27
28259,1,1,175,1755,1580
28260,1,0,36,0,-36
28261,1,0,4,0,-4
28262,1,1,181,2156,1975
28263,0,0,42,0,-42
28264,0,0,9,0,-9
28265,1,0,27,0,-27
28266,0,0,19,0,-19
28267,1,1,82,1248,1166
28268,1,0,55,0,-55
28269,1,1,144,1250,1106
28270,1,0,29,0,-29
28271,1,1,413,1988,1575
28272,1,1,376,1675,1299
28273,0,0,91,0,-91
28274,1,0,60,0,-60
28275,1,1,10,1298,1288
28276,0,0,92,0,-92
28277,1,0,11,0,-11
28278,1,0,62,0,-62
28279,1,1,345,2904,2559
28280,0,0,122,0,-122
28281,0,0,47,0,-47
28282,1,1,1113,1263,150
28283,1,0,14,0,-14
28284,0,0,7,0,-7
28285,0,0,20,0,-20
28286,1,1,393,1324,931
28287,1,1,224,1342,1118
28288,1,0,9,0,-9
28289,1,0,114,0,-114
28290,1,1,111,1207,1096
28291,1,1,115,1478,1363
28292,0,0,164,0,-164
28293,0,0,187,0,-187
28294,1,0,131,0,-131
28295,1,1,109,5947,5838
28296,0,0,130,0,-130
28297,1,1,659,1744,1085
28298,1,0,116,0,-116
28299,0,0,16,0,-16
28300,0,0,5,0,-5
28301,0,0,5,0,-5
28302,1,1,506,1864,1358
28303,1,0,0,0,0
28304,1,1,543,1453,910
28305,1,1,456,1347,891
28306,1,0,57,0,-57
28307,1,0,29,0,-29
28308,1,1,504,3130,2626
28309,1,0,20,0,-20
28310,1,1,320,1217,897
28311,1,0,67,0,-67
28312,1,1,1509,1284,-225
28313,0,0,10,0,-10
28314,1,0,23,0,-23
28315,0,0,53,0,-53
28316,0,0,79,0,-79
28317,1,1,248,1248,1000
28318,1,1,918,1708,790
28319,0,0,116,0,-116
28320,0,0,69,0,-69
28321,0,0,34,0,-34
28322,1,1,439,1221,782
28323,1,0,30,0,-30
28324,0,0,3,0,-3
28325,1,1,81,1488,1407
28326,1,0,22,0,-22
28327,1,0,92,0,-92
28328,1,0,58,0,-58
28329,0,0,68,0,-68
28330,1,0,103,0,-103
28331,0,0,18,0,-18
28332,0,0,47,0,-47
28333,0,0,60,0,-60
28334,1,1,928,1351,423
28335,1,0,0,0,0
28336,1,0,69,0,-69
28337,0,0,49,0,-49
28338,0,0,19,0,-19
28339,1,1,862,1302,440
28340,1,0,99,0,-99
28341,0,0,152,0,-152
28342,0,0,1,0,-1
28343,0,0,42,0,-42
28344,1,1,1066,1360,294
28345,0,0,75,0,-75
28346,1,0,106,0,-106
28347,0,0,21,0,-21
28348,1,1,596,1266,670
28349,0,0,10,0,-10
28350,1,0,7,0,-7
28351,0,0,58,0,-58
28352,1,1,101,1673,1572
28353,0,0,69,0,-69
28354,1,1,1122,1577,455
28355,1,0,63,0,-63
28356,0,0,8,0,-8
28357,1,1,258,1843,1585
28358,0,0,154,0,-154
28359,1,0,183,0,-183
28360,1,1,70,1907,1837
28361,1,1,646,3660,3014
28362,0,0,12,0,-12
28363,1,0,27,0,-27
28364,0,0,74,0,-74
28365,1,1,430,1707,1277
28366,0,0,54,0,-54
28367,0,0,47,0,-47
28368,1,1,668,1867,1199
28369,1,0,53,0,-53
28370,1,0,20,0,-20
28371,1,0,102,0,-102
28372,1,0,69,0,-69
28373,1,1,301,1408,1107
28374,0,0,78,0,-78
28375,1,0,14,0,-14
28376,1,1,1588,1597,9
28377,0,0,136,0,-136
28378,0,0,52,0,-52
28379,1,1,68,2564,2496
28380,1,0,60,0,-60
28381,0,0,7,0,-7
28382,0,0,30,0,-30
28383,1,1,572,1554,982
28384,0,0,57,0,-57
28385,0,0,37,0,-37
28386,1,0,6,0,-6
28387,1,0,3,0,-3
28388,1,0,14,0,-14
28389,1,0,44,0,-44
28390,0,0,86,0,-86
28391,0,0,96,0,-96
28392,0,0,27,0,-27
28393,1,1,387,2227,1840
28394,1,1,262,1313,1051
28395,0,0,10,0,-10
28396,1,1,917,1367,450
28397,1,0,39,0,-39
28398,1,1,433,1259,826
28399,1,0,57,0,-57
28400,0,0,15,0,-15
28401,0,0,8,0,-8
28402,1,1,676,1290,614
28403,1,1,279,1421,1142
28404,1,1,819,1370,551
28405,0,0,15,0,-15
28406,1,1,237,1342,1105
28407,1,1,435,1263,828
28408,0,0,15,0,-15
28409,1,0,22,0,-22
28410,1,0,91,0,-91
28411,1,1,390,1375,985
28412,0,0,37,0,-37
28413,1,1,650,1329,679
28414,1,1,638,1973,1335
28415,0,0,31,0,-31
28416,1,0,35,0,-35
28417,1,1,1603,1233,-370
28418,0,0,30,0,-30
28419,1,1,67,1536,1469
28420,1,0,12,0,-12
28421,1,1,75,1346,1271
28422,1,0,64,0,-64
28423,0,0,18,0,-18
28424,0,0,302,0,-302
28425,1,0,286,0,-286
28426,1,0,12,0,-12
28427,1,0,131,0,-131
28428,1,0,32,0,-32
28429,0,0,3,0,-3
28430,0,0,13,0,-13
28431,1,1,387,1351,964
28432,1,1,399,1519,1120
28433,1,0,72,0,-72
28434,0,0,64,0,-64
28435,0,0,57,0,-57
28436,1,1,1950,1371,-579
28437,1,1,648,1466,818
28438,1,1,270,1517,1247
28439,0,0,144,0,-144
28440,0,0,148,0,-148
28441,1,1,637,1863,1226
28442,1,1,1399,1296,-103
28443,1,1,400,3313,2913
28444,0,0,18,0,-18
28445,0,0,27,0,-27
28446,1,0,31,0,-31
28447,1,1,734,1419,685
28448,0,0,17,0,-17
28449,0,0,18,0,-18
28450,1,1,1219,1576,357
28451,0,0,207,0,-207
28452,1,0,1,0,-1
28453,1,1,1343,1523,180
28454,1,0,33,0,-33
28455,1,0,23,0,-23
28456,1,0,96,0,-96
28457,1,0,1,0,-1
28458,0,0,19,0,-19
28459,1,0,52,0,-52
28460,0,0,30,0,-30
28461,1,1,116,1478,1362
28462,1,1,775,3232,2457
28463,1,0,7,0,-7
28464,0,0,1,0,-1
28465,0,0,5,0,-5
28466,1,0,68,0,-68
28467,1,1,884,1297,413
28468,0,0,57,0,-57
28469,0,0,41,0,-41
28470,1,0,43,0,-43
28471,1,1,2328,1527,-801
28472,1,1,252,1723,1471
28473,1,0,45,0,-45
28474,0,0,5,0,-5
28475,0,0,87,0,-87
28476,1,1,584,1352,768
28477,1,1,475,1503,1028
28478,1,1,175,1374,1199
28479,1,1,202,1207,1005
28480,0,0,0,0,0
28481,0,0,24,0,-24
28482,1,1,1036,1854,818
28483,1,0,46,0,-46
28484,1,0,109,0,-109
28485,1,1,686,1647,961
28486,1,1,393,1413,1020
28487,1,1,307,1531,1224
28488,1,0,14,0,-14
28489,0,0,9,0,-9
28490,1,1,615,2124,1509
28491,1,0,35,0,-35
28492,1,0,14,0,-14
28493,1,1,861,1220,359
28494,1,1,401,1279,878
28495,1,0,33,0,-33
28496,1,1,911,2685,1774
28497,0,0,12,0,-12
28498,1,0,65,0,-65
28499,1,1,172,1228,1056
28500,1,1,1013,1685,672
28501,1,1,379,1287,908
28502,1,0,0,0,0
28503,0,0,81,0,-81
28504,1,1,469,1233,764
28505,1,1,84,1443,1359
28506,0,0,29,0,-29
28507,1,0,196,0,-196
28508,1,0,54,0,-54
28509,0,0,125,0,-125
28510,0,0,35,0,-35
28511,1,0,23,0,-23
28512,1,1,716,1223,507
28513,1,0,102,0,-102
28514,1,1,4559,1231,-3328
28515,0,0,24,0,-24
28516,1,0,50,0,-50
28517,1,0,39,0,-39
28518,0,0,5,0,-5
28519,1,0,7,0,-7
28520,0,0,19,0,-19
28521,1,1,537,1391,854
28522,1,1,97,1325,1228
28523,0,0,21,0,-21
28524,1,0,40,0,-40
28525,1,0,30,0,-30
28526,1,0,69,0,-69
28527,0,0,1,0,-1
28528,1,0,33,0,-33
28529,0,0,71,0,-71
28530,1,1,556,1247,691
28531,0,0,25,0,-25
28532,1,1,1293,1302,9
28533,0,0,27,0,-27
28534,0,0,59,0,-59
28535,0,0,38,0,-38
28536,1,1,973,1443,470
28537,0,0,122,0,-122
28538,1,1,2020,1335,-685
28539,0,0,145,0,-145
28540,0,0,7,0,-7
28541,1,1,440,1220,780
28542,0,0,20,0,-20
28543,1,1,100,1348,1248
28544,1,0,1,0,-1
28545,1,1,409,1215,806
28546,1,0,25,0,-25
28547,1,1,564,1464,900
28548,0,0,17,0,-17
28549,1,0,57,0,-57
28550,1,1,192,1214,1022
28551,0,0,35,0,-35
28552,1,0,1,0,-1
28553,0,0,97,0,-97
28554,1,1,483,1503,1020
28555,1,1,187,1463,1276
28556,0,0,338,0,-338
28557,0,0,17,0,-17
28558,0,0,24,0,-24
28559,1,1,991,1289,298
28560,0,0,15,0,-15
28561,1,0,26,0,-26
28562,1,0,33,0,-33
28563,1,1,574,5571,4997
28564,1,1,1490,1212,-278
28565,1,0,108,0,-108
28566,1,1,1387,1377,-10
28567,1,0,32,0,-32
28568,1,0,11,0,-11
28569,0,0,19,0,-19
28570,0,0,15,0,-15
28571,1,1,329,1217,888
28572,1,1,456,1319,863
28573,1,1,765,1436,671
28574,1,0,53,0,-53
28575,1,0,78,0,-78
28576,1,1,210,1681,1471
28577,0,0,153,0,-153
28578,1,0,19,0,-19
28579,1,0,6,0,-6
28580,1,0,186,0,-186
28581,0,0,24,0,-24
28582,0,0,57,0,-57
28583,0,0,13,0,-13
28584,0,0,32,0,-32
28585,0,0,58,0,-58
28586,0,0,26,0,-26
28587,1,1,1069,1221,152
28588,1,1,647,1316,669
28589,0,0,54,0,-54
28590,1,0,8,0,-8
28591,1,0,24,0,-24
28592,1,1,47,2130,2083
28593,0,0,36,0,-36
28594,0,0,133,0,-133
28595,1,0,23,0,-23
28596,0,0,14,0,-14
28597,1,1,1414,2119,705
28598,1,0,27,0,-27
28599,0,0,132,0,-132
28600,1,1,394,2926,2532
28601,1,1,431,1771,1340
28602,1,0,16,0,-16
28603,0,0,39,0,-39
28604,1,0,2,0,-2
28605,0,0,26,0,-26
28606,1,0,21,0,-21
28607,1,1,164,1589,1425
28608,0,0,18,0,-18
28609,1,1,228,1260,1032
28610,0,0,92,0,-92
28611,1,1,1053,1284,231
28612,0,0,22,0,-22
28613,1,1,204,1358,1154
28614,0,0,17,0,-17
28615,0,0,28,0,-28
28616,0,0,27,0,-27
28617,1,0,15,0,-15
28618,1,0,86,0,-86
28619,1,0,127,0,-127
28620,0,0,156,0,-156
28621,1,1,270,1249,979
28622,0,0,71,0,-71
28623,0,0,17,0,-17
28624,1,0,51,0,-51
28625,0,0,14,0,-14
28626,0,0,55,0,-55
28627,0,0,141,0,-141
28628,1,1,468,1268,800
28629,1,1,120,1321,1201
28630,1,1,634,1297,663
28631,1,1,585,1330,745
28632,1,1,936,1278,342
28633,1,0,1,0,-1
28634,0,0,9,0,-9
28635,0,0,35,0,-35
28636,1,0,41,0,-41
28637,1,1,54,2027,1973
28638,0,0,124,0,-124
28639,1,1,210,1282,1072
28640,0,0,15,0,-15
28641,0,0,90,0,-90
28642,0,0,45,0,-45
28643,1,1,582,1265,683
28644,1,1,721,1421,700
28645,0,0,6,0,-6
28646,1,1,84,1657,1573
28647,0,0,38,0,-38
28648,0,0,144,0,-144
28649,1,0,3,0,-3
28650,0,0,86,0,-86
28651,1,1,554,1658,1104
28652,1,1,85,1324,1239
28653,0,0,51,0,-51
28654,1,0,63,0,-63
28655,1,1,470,1306,836
28656,1,1,439,1357,918
28657,1,1,843,1956,1113
28658,1,1,990,1203,213
28659,1,0,22,0,-22
28660,0,0,43,0,-43
28661,0,0,65,0,-65
28662,0,0,64,0,-64
28663,1,0,22,0,-22
28664,1,1,105,1483,1378
28665,1,1,520,1241,721
28666,0,0,8,0,-8
28667,1,0,88,0,-88
28668,1,1,116,1758,1642
28669,0,0,1,0,-1
28670,1,1,932,1811,879
28671,1,0,18,0,-18
28672,0,0,134,0,-134
28673,0,0,57,0,-57
28674,1,1,395,1375,980
28675,1,0,10,0,-10
28676,1,1,433,1254,821
28677,1,0,44,0,-44
28678,1,0,20,0,-20
28679,0,0,22,0,-22
28680,0,0,186,0,-186
28681,1,1,950,1432,482
28682,0,0,12,0,-12
28683,0,0,63,0,-63
28684,1,0,25,0,-25
28685,0,0,24,0,-24
28686,1,1,378,1892,1514
28687,0,0,29,0,-29
28688,1,1,81,2116,2035
28689,1,1,408,1553,1145
28690,1,0,8,0,-8
28691,1,1,528,1508,980
28692,0,0,1,0,-1
28693,0,0,102,0,-102
28694,0,0,13,0,-13
28695,1,0,4,0,-4
28696,1,1,187,1222,1035
28697,1,1,508,1427,919
28698,1,1,340,1208,868
28699,1,1,459,1463,1004
28700,1,0,55,0,-55
28701,0,0,92,0,-92
28702,0,0,121,0,-121
28703,1,1,753,1225,472
28704,1,0,14,0,-14
28705,1,0,13,0,-13
28706,1,0,113,0,-113
28707,1,1,356,1442,1086
28708,1,0,18,0,-18
28709,0,0,28,0,-28
28710,0,0,54,0,-54
28711,0,0,115,0,-115
28712,1,1,788,1367,579
28713,1,1,230,1352,1122
28714,0,0,46,0,-46
28715,1,1,77,1434,1357
28716,0,0,19,0,-19
28717,1,0,10,0,-10
28718,1,0,1,0,-1
28719,1,1,72,1239,1167
28720,0,0,18,0,-18
28721,0,0,48,0,-48
28722,0,0,1,0,-1
28723,0,0,32,0,-32
28724,1,0,2,0,-2
28725,1,1,339,1773,1434
28726,1,0,114,0,-114
28727,1,0,14,0,-14
28728,0,0,33,0,-33
28729,0,0,8,0,-8
28730,1,0,7,0,-7
28731,0,0,168,0,-168
28732,1,0,5,0,-5
28733,1,1,570,1219,649
28734,1,0,6,0,-6
28735,1,1,633,1439,806
28736,0,0,93,0,-93
28737,1,0,7,0,-7
28738,0,0,3,0,-3
28739,0,0,143,0,-143
28740,0,0,11,0,-11
28741,1,0,0,0,0
28742,1,0,5,0,-5
28743,0,0,58,0,-58
28744,1,1,432,1290,858
28745,1,1,97,1231,1134
28746,0,0,102,0,-102
28747,1,1,870,1802,932
28748,0,0,67,0,-67
28749,1,1,310,2213,1903
28750,0,0,2,0,-2
28751,0,0,5,0,-5
28752,0,0,169,0,-169
28753,0,0,118,0,-118
28754,1,0,186,0,-186
28755,0,0,8,0,-8
28756,0,0,12,0,-12
28757,1,1,472,5848,5376
28758,1,0,48,0,-48
28759,1,1,569,1372,803
28760,1,1,151,1274,1123
28761,0,0,51,0,-51
28762,1,1,100,1260,1160
28763,1,1,105,4470,4365
28764,1,1,363,1305,942
28765,1,0,102,0,-102
28766,1,1,16,1394,1378
28767,1,0,17,0,-17
28768,0,0,7,0,-7
28769,1,1,878,1206,328
28770,0,0,30,0,-30
28771,0,0,30,0,-30
28772,1,1,1115,1358,243
28773,0,0,10,0,-10
28774,0,0,24,0,-24
28775,0,0,112,0,-112
28776,1,1,2769,1321,-1448
28777,0,0,17,0,-17
28778,1,0,131,0,-131
28779,1,0,64,0,-64
28780,1,1,556,1268,712
28781,1,1,223,1212,989
28782,1,1,454,1276,822
28783,1,1,572,1241,669
28784,1,0,71,0,-71
28785,1,1,391,1308,917
28786,0,0,50,0,-50
28787,0,0,31,0,-31
28788,0,0,22,0,-22
28789,0,0,10,0,-10
28790,1,0,7,0,-7
28791,1,1,2338,1282,-1056
28792,1,1,1959,1309,-650
28793,1,0,9,0,-9
28794,1,1,1177,1503,326
28795,1,1,1596,1230,-366
28796,0,0,51,0,-51
28797,1,1,536,1252,716
28798,1,0,4,0,-4
28799,1,1,173,1201,1028
28800,1,1,462,1288,826
28801,1,1,80,1572,1492
28802,1,0,19,0,-19
28803,0,0,285,0,-285
28804,1,0,152,0,-152
28805,1,1,1272,1430,158
28806,0,0,46,0,-46
28807,0,0,62,0,-62
28808,1,0,30,0,-30
28809,0,0,101,0,-101
28810,0,0,9,0,-9
28811,0,0,199,0,-199
28812,1,0,193,0,-193
28813,1,0,71,0,-71
28814,1,0,3,0,-3
28815,1,1,246,1295,1049
28816,1,0,9,0,-9
28817,1,0,16,0,-16
28818,1,1,968,2470,1502
28819,1,1,492,1312,820
28820,0,0,63,0,-63
28821,0,0,23,0,-23
28822,1,0,8,0,-8
28823,1,1,440,1507,1067
28824,0,0,71,0,-71
28825,0,0,25,0,-25
28826,1,0,18,0,-18
28827,1,1,232,1269,1037
28828,0,0,41,0,-41
28829,1,1,417,1402,985
28830,0,0,332,0,-332
28831,0,0,23,0,-23
28832,1,0,51,0,-51
28833,0,0,64,0,-64
28834,0,0,35,0,-35
28835,1,0,13,0,-13
28836,1,0,13,0,-13
28837,1,0,18,0,-18
28838,0,0,86,0,-86
28839,1,1,356,1298,942
28840,1,0,26,0,-26
28841,1,0,1,0,-1
28842,1,0,13,0,-13
28843,0,0,38,0,-38
28844,0,0,38,0,-38
28845,1,0,151,0,-151
28846,1,0,23,0,-23
28847,0,0,6,0,-6
28848,1,1,2369,1202,-1167
28849,1,1,516,1391,875
28850,0,0,8,0,-8
28851,1,1,1676,4609,2933
28852,0,0,60,0,-60
28853,1,1,1561,1275,-286
28854,1,0,49,0,-49
28855,1,0,8,0,-8
28856,0,0,59,0,-59
28857,1,1,343,1375,1032
28858,0,0,4,0,-4
28859,1,0,18,0,-18
28860,1,1,1585,1222,-363
28861,1,1,78,1320,1242
28862,1,1,194,2084,1890
28863,1,0,77,0,-77
28864,0,0,8,0,-8
28865,0,0,26,0,-26
28866,1,1,476,2219,1743
28867,1,1,194,1274,1080
28868,0,0,32,0,-32
28869,0,0,57,0,-57
28870,0,0,59,0,-59
28871,1,1,1045,1826,781
28872,0,0,65,0,-65
28873,0,0,76,0,-76
28874,1,0,11,0,-11
28875,1,1,505,1689,1184
28876,1,1,191,1542,1351
28877,1,1,753,1439,686
28878,0,0,43,0,-43
28879,0,0,118,0,-118
28880,0,0,2,0,-2
28881,1,1,1272,1756,484
28882,1,1,1692,1514,-178
28883,1,0,59,0,-59
28884,1,0,29,0,-29
28885,1,1,282,1486,1204
28886,1,0,3,0,-3
28887,1,0,136,0,-136
28888,1,1,962,1218,256
28889,0,0,78,0,-78
28890,0,0,27,0,-27
28891,1,1,583,1278,695
28892,1,0,0,0,0
28893,0,0,20,0,-20
28894,1,0,20,0,-20
28895,1,0,26,0,-26
28896,1,0,48,0,-48
28897,1,0,10,0,-10
28898,1,1,355,1496,1141
28899,0,0,35,0,-35
28900,0,0,1,0,-1
28901,0,0,62,0,-62
28902,1,0,78,0,-78
28903,1,1,371,1407,1036
28904,1,1,85,1249,1164
28905,1,1,157,1389,1232
28906,1,1,220,1207,987
28907,0,0,91,0,-91
28908,1,0,15,0,-15
28909,1,1,226,1391,1165
28910,0,0,5,0,-5
28911,1,0,45,0,-45
28912,0,0,16,0,-16
28913,1,1,1059,1432,373
28914,0,0,59,0,-59
28915,1,0,136,0,-136
28916,1,1,151,1223,1072
28917,1,0,0,0,0
28918,1,1,393,1660,1267
28919,0,0,1,0,-1
28920,1,1,278,1425,1147
28921,1,0,94,0,-94
28922,1,1,166,1205,1039
28923,1,1,225,1291,1066
28924,1,0,34,0,-34
28925,0,0,5,0,-5
28926,1,1,149,1709,1560
28927,0,0,52,0,-52
28928,1,0,43,0,-43
28929,1,0,15,0,-15
28930,1,0,12,0,-12
28931,0,0,62,0,-62
28932,1,1,1021,1220,199
28933,0,0,3,0,-3
28934,0,0,27,0,-27
28935,1,1,145,1210,1065
28936,1,1,2483,1636,-847
28937,1,1,163,1726,1563
28938,1,1,382,1391,1009
28939,0,0,28,0,-28
28940,0,0,9,0,-9
28941,0,0,77,0,-77
28942,1,0,36,0,-36
28943,1,0,38,0,-38
28944,1,0,29,0,-29
28945,1,1,298,1339,1041
28946,0,0,15,0,-15
28947,1,1,386,1265,879
28948,1,1,230,1507,1277
28949,1,0,6,0,-6
28950,1,1,412,1304,892
28951,0,0,3,0,-3
28952,1,1,961,1264,303
28953,1,1,1395,1430,35
28954,1,0,26,0,-26
28955,1,1,176,2175,1999
28956,1,1,466,1293,827
28957,0,0,4,0,-4
28958,1,0,10,0,-10
28959,0,0,0,0,0
28960,0,0,54,0,-54
28961,0,0,85,0,-85
28962,1,0,37,0,-37
28963,0,0,0,0,0
28964,1,0,139,0,-139
28965,0,0,124,0,-124
28966,1,1,401,2029,1628
28967,1,1,327,1326,999
28968,1,1,1273,1260,-13
28969,1,1,779,1289,510
28970,0,0,69,0,-69
28971,0,0,8,0,-8
28972,1,1,327,1453,1126
28973,0,0,50,0,-50
28974,0,0,160,0,-160
28975,0,0,50,0,-50
28976,1,0,76,0,-76
28977,0,0,17,0,-17
28978,0,0,49,0,-49
28979,0,0,118,0,-118
28980,1,0,12,0,-12
28981,1,0,26,0,-26
28982,1,1,457,1453,996
28983,1,1,623,2931,2308
28984,0,0,37,0,-37
28985,0,0,15,0,-15
28986,0,0,31,0,-31
28987,0,0,121,0,-121
28988,1,0,31,0,-31
28989,0,0,41,0,-41
28990,0,0,167,0,-167
28991,1,0,40,0,-40
28992,0,0,44,0,-44
28993,0,0,9,0,-9
28994,0,0,26,0,-26
28995,1,1,610,1319,709
28996,1,0,0,0,0
28997,1,0,52,0,-52
28998,1,0,25,0,-25
28999,0,0,81,0,-81
29000,1,0,3,0,-3
29001,1,0,6,0,-6
29002,0,0,204,0,-204
29003,1,0,12,0,-12
29004,0,0,24,0,-24
29005,1,0,18,0,-18
29006,1,0,50,0,-50
29007,1,1,131,1289,1158
29008,0,0,2,0,-2
29009,0,0,17,0,-17
29010,0,0,13,0,-13
29011,1,0,71,0,-71
29012,0,0,30,0,-30
29013,1,1,125,1957,1832
29014,1,1,405,1512,1107
29015,1,1,65,1268,1203
29016,0,0,0,0,0
29017,1,1,90,1742,1652
29018,1,1,460,1290,830
29019,1,0,85,0,-85
29020,1,1,403,1338,935
29021,0,0,5,0,-5
29022,1,1,129,1572,1443
29023,1,1,48,1389,1341
29024,1,0,65,0,-65
29025,0,0,2,0,-2
29026,1,0,3,0,-3
29027,1,0,58,0,-58
29028,1,1,258,1255,997
29029,0,0,22,0,-22
29030,0,0,50,0,-50
29031,1,0,51,0,-51
29032,0,0,16,0,-16
29033,0,0,0,0,0
29034,1,0,37,0,-37
29035,0,0,126,0,-126
29036,0,0,58,0,-58
29037,1,0,7,0,-7
29038,1,1,451,1249,798
29039,0,0,9,0,-9
29040,0,0,9,0,-9
29041,1,0,93,0,-93
29042,0,0,142,0,-142
29043,0,0,7,0,-7
29044,1,0,2,0,-2
29045,0,0,8,0,-8
29046,0,0,25,0,-25
29047,1,1,34,1835,1801
29048,0,0,134,0,-134
29049,0,0,107,0,-107
29050,0,0,2,0,-2
29051,1,1,216,1652,1436
29052,0,0,48,0,-48
29053,1,1,430,4509,4079
29054,0,0,26,0,-26
29055,1,0,76,0,-76
29056,1,0,40,0,-40
29057,0,0,13,0,-13
29058,0,0,98,0,-98
29059,1,1,602,1687,1085
29060,1,0,55,0,-55
29061,1,1,1350,1584,234
29062,0,0,19,0,-19
29063,1,0,15,0,-15
29064,1,0,10,0,-10
29065,0,0,92,0,-92
29066,0,0,12,0,-12
29067,1,1,1683,2024,341
29068,1,0,31,0,-31
29069,0,0,11,0,-11
29070,1,1,350,1526,1176
29071,1,0,30,0,-30
29072,0,0,66,0,-66
29073,1,1,531,1226,695
29074,1,1,1197,1216,19
29075,1,0,80,0,-80
29076,1,1,278,1761,1483
29077,0,0,210,0,-210
29078,1,1,19,1214,1195
29079,1,1,402,1404,1002
29080,0,0,52,0,-52
29081,0,0,33,0,-33
29082,1,1,180,1426,1246
29083,1,0,40,0,-40
29084,1,1,43,2596,2553
29085,0,0,18,0,-18
29086,1,1,540,1888,1348
29087,1,0,2,0,-2
29088,0,0,23,0,-23
29089,0,0,99,0,-99
29090,1,0,5,0,-5
29091,1,0,113,0,-113
29092,1,1,3047,1447,-1600
29093,1,1,233,1319,1086
29094,0,0,144,0,-144
29095,1,1,1169,1360,191
29096,1,0,14,0,-14
29097,1,1,569,1204,635
29098,0,0,38,0,-38
29099,1,0,47,0,-47
29100,0,0,19,0,-19
29101,0,0,7,0,-7
29102,0,0,80,0,-80
29103,1,0,2,0,-2
29104,0,0,0,0,0
29105,1,0,27,0,-27
29106,1,0,109,0,-109
29107,1,1,714,1322,608
29108,1,0,4,0,-4
29109,1,1,176,1513,1337
29110,0,0,37,0,-37
29111,0,0,109,0,-109
29112,1,1,692,1458,766
29113,0,0,173,0,-173
29114,1,1,67,1200,1133
29115,1,0,16,0,-16
29116,1,0,20,0,-20
29117,1,0,150,0,-150
29118,0,0,24,0,-24
29119,1,0,37,0,-37
29120,1,1,730,1204,474
29121,0,0,53,0,-53
29122,0,0,6,0,-6
29123,1,1,880,1724,844
29124,0,0,91,0,-91
29125,1,0,36,0,-36
29126,1,1,56,1246,1190
29127,1,1,339,1221,882
29128,1,1,130,1293,1163
29129,1,1,387,1768,1381
29130,0,0,6,0,-6
29131,1,1,54,1535,1481
29132,1,1,130,1554,1424
29133,0,0,40,0,-40
29134,1,1,639,1332,693
29135,0,0,30,0,-30
29136,1,0,11,0,-11
29137,0,0,45,0,-45
29138,0,0,123,0,-123
29139,0,0,1,0,-1
29140,1,1,471,1559,1088
29141,0,0,6,0,-6
29142,0,0,37,0,-37
29143,1,0,68,0,-68
29144,1,1,892,1537,645
29145,0,0,65,0,-65
29146,1,1,66,1246,1180
29147,1,1,192,1967,1775
29148,0,0,6,0,-6
29149,0,0,26,0,-26
29150,1,0,32,0,-32
29151,1,1,960,1204,244
29152,1,1,1467,1209,-258
29153,1,1,1151,1205,54
29154,0,0,62,0,-62
29155,1,0,15,0,-15
29156,0,0,10,0,-10
29157,1,1,1617,2384,767
29158,1,1,135,1570,1435
29159,1,1,640,2311,1671
29160,1,0,12,0,-12
29161,1,1,547,1889,1342
29162,0,0,74,0,-74
29163,1,0,38,0,-38
29164,1,0,73,0,-73
29165,1,0,65,0,-65
29166,1,1,92,1725,1633
29167,1,0,112,0,-112
29168,1,0,57,0,-57
29169,1,0,4,0,-4
29170,0,0,16,0,-16
29171,1,0,86,0,-86
29172,1,1,237,1720,1483
29173,0,0,48,0,-48
29174,1,0,26,0,-26
29175,1,0,129,0,-129
29176,0,0,23,0,-23
29177,0,0,9,0,-9
29178,1,0,59,0,-59
29179,1,0,77,0,-77
29180,1,0,5,0,-5
29181,0,0,36,0,-36
29182,1,1,232,1358,1126
29183,0,0,38,0,-38
29184,1,1,47,1538,1491
29185,0,0,23,0,-23
29186,0,0,9,0,-9
29187,1,1,159,1325,1166
29188,1,0,70,0,-70
29189,1,1,559,1496,937
29190,1,1,95,1515,1420
29191,0,0,70,0,-70
29192,1,1,403,1905,1502
29193,1,0,249,0,-249
29194,1,1,120,1453,1333
29195,1,0,55,0,-55
29196,1,0,16,0,-16
29197,1,1,874,1366,492
29198,1,0,52,0,-52
29199,1,1,697,1200,503
29200,0,0,51,0,-51
29201,1,0,3,0,-3
29202,1,1,655,1343,688
29203,1,0,15,0,-15
29204,0,0,81,0,-81
29205,0,0,16,0,-16
29206,1,1,65,1227,1162
29207,0,0,9,0,-9
29208,1,0,114,0,-114
29209,1,1,534,2241,1707
29210,0,0,60,0,-60
29211,1,1,882,1525,643
29212,0,0,15,0,-15
29213,1,0,4,0,-4
29214,1,1,2267,1380,-887
29215,0,0,56,0,-56
29216,1,1,68,1742,1674
29217,0,0,51,0,-51
29218,1,0,15,0,-15
29219,1,0,11,0,-11
29220,1,0,16,0,-16
29221,1,0,9,0,-9
29222,0,0,21,0,-21
29223,1,0,24,0,-24
29224,1,0,120,0,-120
29225,0,0,81,0,-81
29226,0,0,3,0,-3
29227,0,0,46,0,-46
29228,1,1,438,1482,1044
29229,1,1,154,1264,1110
29230,0,0,4,0,-4
29231,1,0,1,0,-1
29232,0,0,58,0,-58
29233,0,0,72,0,-72
29234,1,0,24,0,-24
29235,1,0,30,0,-30
29236,1,0,37,0,-37
29237,1,0,3,0,-3
29238,0,0,131,0,-131
29239,0,0,93,0,-93
29240,0,0,76,0,-76
29241,0,0,92,0,-92
29242,0,0,32,0,-32
29243,1,0,48,0,-48
29244,1,0,6,0,-6
29245,1,1,354,1629,1275
29246,1,1,471,1445,974
29247,1,0,24,0,-24
29248,1,0,43,0,-43
29249,0,0,1,0,-1
29250,1,0,119,0,-119
29251,1,0,142,0,-142
29252,1,0,97,0,-97
29253,1,0,34,0,-34
29254,0,0,3,0,-3
29255,0,0,38,0,-38
29256,0,0,13,0,-13
29257,0,0,38,0,-38
29258,1,1,884,2021,1137
29259,1,1,341,1653,1312
29260,1,1,539,1201,662
29261,1,0,26,0,-26
29262,1,1,832,1724,892
29263,1,0,191,0,-191
29264,1,0,44,0,-44
29265,1,0,49,0,-49
29266,1,0,16,0,-16
29267,0,0,15,0,-15
29268,1,1,747,1371,624
29269,0,0,28,0,-28
29270,0,0,11,0,-11
29271,0,0,95,0,-95
29272,1,1,328,1332,1004
29273,0,0,37,0,-37
29274,1,0,4,0,-4
29275,0,0,33,0,-33
29276,1,1,68,1426,1358
29277,1,0,47,0,-47
29278,0,0,25,0,-25
29279,1,1,1210,1282,72
29280,0,0,5,0,-5
29281,1,1,282,1452,1170
29282,1,1,244,2165,1921
29283,1,0,2,0,-2
29284,0,0,72,0,-72
29285,0,0,29,0,-29
29286,0,0,5,0,-5
29287,0,0,256,0,-256
29288,0,0,16,0,-16
29289,0,0,99,0,-99
29290,1,0,50,0,-50
29291,1,0,118,0,-118
29292,1,0,4,0,-4
29293,0,0,9,0,-9
29294,1,1,665,1336,671
29295,1,0,108,0,-108
29296,1,0,49,0,-49
29297,0,0,21,0,-21
29298,0,0,36,0,-36
29299,1,1,125,1241,1116
29300,1,0,59,0,-59
29301,1,1,806,1206,400
29302,0,0,85,0,-85
29303,1,0,99,0,-99
29304,1,1,541,2100,1559
29305,1,1,2018,1925,-93
29306,0,0,18,0,-18
29307,1,0,4,0,-4
29308,0,0,139,0,-139
29309,0,0,19,0,-19
29310,1,0,116,0,-116
29311,1,0,1,0,-1
29312,1,1,1347,1201,-146
29313,1,0,15,0,-15
29314,1,0,56,0,-56
29315,1,0,39,0,-39
29316,1,0,66,0,-66
29317,0,0,5,0,-5
29318,1,1,282,2107,1825
29319,0,0,23,0,-23
29320,1,0,142,0,-142
29321,0,0,44,0,-44
29322,0,0,32,0,-32
29323,0,0,156,0,-156
29324,1,0,50,0,-50
29325,0,0,105,0,-105
29326,1,0,52,0,-52
29327,1,0,59,0,-59
29328,0,0,36,0,-36
29329,0,0,178,0,-178
29330,1,0,161,0,-161
29331,1,0,32,0,-32
29332,1,0,24,0,-24
29333,0,0,6,0,-6
29334,1,0,35,0,-35
29335,1,1,399,1253,854
29336,1,1,275,1513,1238
29337,1,1,716,1285,569
29338,0,0,18,0,-18
29339,0,0,5,0,-5
29340,1,0,9,0,-9
29341,1,0,11,0,-11
29342,1,0,27,0,-27
29343,1,1,612,3907,3295
29344,1,1,114,1258,1144
29345,0,0,13,0,-13
29346,0,0,48,0,-48
29347,0,0,30,0,-30
29348,1,1,418,1354,936
29349,0,0,55,0,-55
29350,0,0,7,0,-7
29351,1,0,56,0,-56
29352,0,0,135,0,-135
29353,0,0,121,0,-121
29354,1,1,455,1372,917
29355,0,0,53,0,-53
29356,1,0,86,0,-86
29357,0,0,50,0,-50
29358,1,1,1208,1814,606
29359,1,1,726,1339,613
29360,1,1,321,1791,1470
29361,0,0,22,0,-22
29362,1,0,30,0,-30
29363,1,1,57,1440,1383
29364,0,0,105,0,-105
29365,0,0,67,0,-67
29366,1,1,817,1866,1049
29367,1,0,8,0,-8
29368,0,0,8,0,-8
29369,1,0,29,0,-29
29370,1,1,327,1263,936
29371,1,1,358,1814,1456
29372,1,0,0,0,0
29373,0,0,127,0,-127
29374,0,0,79,0,-79
29375,0,0,66,0,-66
29376,1,0,61,0,-61
29377,0,0,21,0,-21
29378,0,0,13,0,-13
29379,0,0,10,0,-10
29380,1,0,25,0,-25
29381,1,0,94,0,-94
29382,1,0,34,0,-34
29383,0,0,37,0,-37
29384,0,0,32,0,-32
29385,1,1,142,1415,1273
29386,1,0,10,0,-10
29387,1,1,709,1889,1180
29388,1,0,0,0,0
29389,1,0,123,0,-123
29390,1,1,166,1345,1179
29391,0,0,43,0,-43
29392,1,1,453,1775,1322
29393,0,0,15,0,-15
29394,1,0,102,0,-102
29395,1,1,751,2250,1499
29396,1,0,55,0,-55
29397,1,0,11,0,-11
29398,1,0,52,0,-52
29399,0,0,131,0,-131
29400,1,1,311,1813,1502
29401,0,0,103,0,-103
29402,1,0,13,0,-13
29403,1,0,2,0,-2
29404,0,0,0,0,0
29405,0,0,92,0,-92
29406,0,0,49,0,-49
29407,0,0,43,0,-43
29408,1,1,132,1250,1118
29409,0,0,1,0,-1
29410,1,1,354,1206,852
29411,0,0,5,0,-5
29412,0,0,31,0,-31
29413,1,0,56,0,-56
29414,0,0,59,0,-59
29415,0,0,35,0,-35
29416,0,0,3,0,-3
29417,1,1,391,1403,1012
29418,1,0,8,0,-8
29419,1,1,501,1279,778
29420,0,0,113,0,-113
29421,1,0,88,0,-88
29422,1,0,23,0,-23
29423,1,0,7,0,-7
29424,0,0,29,0,-29
29425,0,0,18,0,-18
29426,1,1,774,1972,1198
29427,0,0,30,0,-30
29428,1,1,990,1690,700
29429,0,0,64,0,-64
29430,0,0,86,0,-86
29431,1,1,444,1256,812
29432,0,0,12,0,-12
29433,0,0,30,0,-30
29434,1,0,71,0,-71
29435,1,1,297,1239,942
29436,1,1,700,1203,503
29437,1,0,23,0,-23
29438,0,0,2,0,-2
29439,1,0,128,0,-128
29440,0,0,176,0,-176
29441,0,0,44,0,-44
29442,1,1,157,1255,1098
29443,0,0,9,0,-9
29444,1,1,385,1251,866
29445,0,0,28,0,-28
29446,0,0,120,0,-120
29447,1,0,16,0,-16
29448,0,0,13,0,-13
29449,0,0,28,0,-28
29450,1,0,17,0,-17
29451,1,0,76,0,-76
29452,1,0,28,0,-28
29453,1,0,114,0,-114
29454,1,0,41,0,-41
29455,1,0,117,0,-117
29456,1,1,48,1669,1621
29457,1,1,298,1509,1211
29458,1,1,171,1250,1079
29459,0,0,97,0,-97
29460,0,0,57,0,-57
29461,1,1,266,1692,1426
29462,1,1,765,1493,728
29463,0,0,4,0,-4
29464,1,0,120,0,-120
29465,0,0,65,0,-65
29466,1,0,21,0,-21
29467,1,1,375,2123,1748
29468,1,1,99,1363,1264
29469,0,0,32,0,-32
29470,0,0,6,0,-6
29471,1,0,20,0,-20
29472,1,1,312,1256,944
29473,1,0,18,0,-18
29474,1,1,623,1839,1216
29475,1,0,25,0,-25
29476,1,0,6,0,-6
29477,1,0,75,0,-75
29478,0,0,109,0,-109
29479,0,0,54,0,-54
29480,1,1,524,1255,731
29481,1,1,289,1711,1422
29482,0,0,29,0,-29
29483,1,0,160,0,-160
29484,1,1,161,1582,1421
29485,1,0,44,0,-44
29486,1,1,607,1619,1012
29487,1,1,662,1220,558
29488,0,0,5,0,-5
29489,1,0,4,0,-4
29490,0,0,10,0,-10
29491,0,0,201,0,-201
29492,1,1,987,1690,703
29493,1,1,223,1567,1344
29494,0,0,20,0,-20
29495,1,1,713,1259,546
29496,0,0,13,0,-13
29497,1,1,273,1251,978
29498,0,0,47,0,-47
29499,0,0,12,0,-12
29500,1,0,8,0,-8
29501,1,0,16,0,-16
29502,0,0,40,0,-40
29503,1,0,56,0,-56
29504,0,0,1,0,-1
29505,0,0,79,0,-79
29506,1,1,414,3227,2813
29507,1,0,25,0,-25
29508,1,0,36,0,-36
29509,0,0,134,0,-134
29510,0,0,17,0,-17
29511,1,1,577,1538,961
29512,0,0,3,0,-3
29513,1,1,487,1544,1057
29514,0,0,58,0,-58
29515,1,1,155,1255,1100
29516,0,0,34,0,-34
29517,0,0,36,0,-36
29518,1,0,29,0,-29
29519,1,0,83,0,-83
29520,1,0,22,0,-22
29521,0,0,73,0,-73
29522,0,0,79,0,-79
29523,0,0,65,0,-65
29524,1,0,10,0,-10
29525,1,0,12,0,-12
29526,0,0,59,0,-59
29527,0,0,13,0,-13
29528,0,0,53,0,-53
29529,0,0,128,0,-128
29530,0,0,135,0,-135
29531,1,0,13,0,-13
29532,0,0,67,0,-67
29533,1,1,447,1296,849
29534,1,1,349,1432,1083
29535,1,1,26,1278,1252
29536,0,0,40,0,-40
29537,1,1,453,1302,849
29538,1,1,428,2339,1911
29539,1,0,133,0,-133
29540,0,0,19,0,-19
29541,0,0,21,0,-21
29542,1,1,429,1470,1041
29543,1,1,48,1325,1277
29544,0,0,48,0,-48
29545,1,0,21,0,-21
29546,1,0,52,0,-52
29547,1,0,119,0,-119
29548,0,0,293,0,-293
29549,1,0,15,0,-15
29550,1,0,224,0,-224
29551,0,0,8,0,-8
29552,1,1,148,1525,1377
29553,1,1,148,1591,1443
29554,1,0,38,0,-38
29555,1,1,1411,1618,207
29556,1,1,179,1702,1523
29557,1,1,651,1699,1048
29558,0,0,10,0,-10
29559,1,1,355,1479,1124
29560,1,1,596,1684,1088
29561,0,0,16,0,-16
29562,1,0,120,0,-120
29563,0,0,137,0,-137
29564,1,0,13,0,-13
29565,0,0,21,0,-21
29566,1,1,247,1601,1354
29567,0,0,13,0,-13
29568,0,0,0,0,0
29569,0,0,63,0,-63
29570,0,0,42,0,-42
29571,1,1,234,1207,973
29572,0,0,33,0,-33
29573,1,0,30,0,-30
29574,0,0,13,0,-13
29575,0,0,84,0,-84
29576,0,0,24,0,-24
29577,1,1,113,1306,1193
29578,1,0,35,0,-35
29579,1,0,2,0,-2
29580,1,1,570,1477,907
29581,1,0,1,0,-1
29582,1,0,171,0,-171
29583,1,0,88,0,-88
29584,1,0,17,0,-17
29585,1,0,20,0,-20
29586,1,1,1240,5005,3765
29587,1,0,44,0,-44
29588,0,0,32,0,-32
29589,1,1,361,1613,1252
29590,1,0,11,0,-11
29591,1,0,60,0,-60
29592,1,0,3,0,-3
29593,0,0,112,0,-112
29594,1,0,3,0,-3
29595,1,0,19,0,-19
29596,1,1,120,1428,1308
29597,1,0,31,0,-31
29598,0,0,163,0,-163
29599,0,0,43,0,-43
29600,1,1,1972,1538,-434
29601,0,0,50,0,-50
29602,1,0,34,0,-34
29603,1,1,1803,1346,-457
29604,1,0,215,0,-215
29605,1,0,22,0,-22
29606,1,0,39,0,-39
29607,0,0,3,0,-3
29608,1,0,104,0,-104
29609,1,1,1159,1241,82
29610,1,1,1243,1524,281
29611,1,1,35,1267,1232
29612,0,0,28,0,-28
29613,0,0,30,0,-30
29614,1,0,12,0,-12
29615,0,0,94,0,-94
29616,0,0,5,0,-5
29617,1,0,12,0,-12
29618,0,0,27,0,-27
29619,1,1,1176,2309,1133
29620,1,0,16,0,-16
29621,0,0,109,0,-109
29622,1,0,16,0,-16
29623,0,0,5,0,-5
29624,1,0,60,0,-60
29625,1,1,349,1210,861
29626,1,1,414,1203,789
29627,1,0,369,0,-369
29628,0,0,40,0,-40
29629,1,0,22,0,-22
29630,1,1,1181,1291,110
29631,0,0,6,0,-6
29632,0,0,10,0,-10
29633,0,0,46,0,-46
29634,1,1,1325,1642,317
29635,0,0,3,0,-3
29636,0,0,45,0,-45
29637,1,1,1383,1229,-154
29638,1,0,155,0,-155
29639,0,0,7,0,-7
29640,1,0,0,0,0
29641,1,0,24,0,-24
29642,0,0,106,0,-106
29643,1,1,318,3964,3646
29644,1,1,336,1307,971
29645,1,1,2030,1323,-707
29646,1,1,1006,1673,667
29647,1,0,41,0,-41
29648,0,0,18,0,-18
29649,1,0,41,0,-41
29650,1,0,38,0,-38
29651,0,0,14,0,-14
29652,1,0,36,0,-36
29653,1,1,488,1366,878
29654,1,1,852,1429,577
29655,1,0,18,0,-18
29656,1,1,373,1209,836
29657,1,0,45,0,-45
29658,1,0,39,0,-39
29659,0,0,56,0,-56
29660,1,0,34,0,-34
29661,1,1,88,1458,1370
29662,0,0,135,0,-135
29663,1,0,35,0,-35
29664,0,0,19,0,-19
29665,0,0,25,0,-25
29666,0,0,57,0,-57
29667,0,0,22,0,-22
29668,0,0,74,0,-74
29669,0,0,53,0,-53
29670,1,0,40,0,-40
29671,1,0,10,0,-10
29672,0,0,29,0,-29
29673,1,1,925,1450,525
29674,1,1,1137,1217,80
29675,0,0,70,0,-70
29676,1,0,75,0,-75
29677,0,0,29,0,-29
29678,0,0,22,0,-22
29679,1,1,34,1238,1204
29680,1,1,12,3833,3821
29681,1,1,97,1440,1343
29682,1,0,41,0,-41
29683,0,0,83,0,-83
29684,1,0,77,0,-77
29685,1,0,136,0,-136
29686,1,0,6,0,-6
29687,0,0,80,0,-80
29688,1,1,179,1237,1058
29689,1,0,182,0,-182
29690,1,1,532,1347,815
29691,1,1,226,1982,1756
29692,1,1,930,1780,850
29693,1,0,8,0,-8
29694,1,1,183,1380,1197
29695,1,0,6,0,-6
29696,1,0,28,0,-28
29697,1,1,574,1465,891
29698,0,0,43,0,-43
29699,0,0,11,0,-11
29700,0,0,38,0,-38
29701,0,0,29,0,-29
29702,0,0,106,0,-106
29703,0,0,18,0,-18
29704,1,0,30,0,-30
29705,1,1,198,1231,1033
29706,1,1,480,3903,3423
29707,1,0,41,0,-41
29708,1,0,69,0,-69
29709,1,1,522,2814,2292
29710,1,1,1000,1536,536
29711,1,0,47,0,-47
29712,0,0,28,0,-28
29713,0,0,103,0,-103
29714,0,0,4,0,-4
29715,1,0,43,0,-43
29716,1,1,207,1235,1028
29717,1,1,164,1203,1039
29718,1,1,405,1266,861
29719,1,0,4,0,-4
29720,1,0,92,0,-92
29721,1,1,58,1756,1698
29722,0,0,21,0,-21
29723,1,1,1923,1470,-453
29724,1,0,16,0,-16
29725,1,0,5,0,-5
29726,1,0,84,0,-84
29727,1,1,1001,1313,312
29728,0,0,16,0,-16
29729,1,0,25,0,-25
29730,1,0,12,0,-12
29731,0,0,0,0,0
29732,1,0,34,0,-34
29733,1,0,52,0,-52
29734,1,1,178,1214,1036
29735,1,1,437,1274,837
29736,0,0,26,0,-26
29737,0,0,142,0,-142
29738,1,1,133,4118,3985
29739,0,0,68,0,-68
29740,0,0,43,0,-43
29741,1,1,167,1258,1091
29742,0,0,56,0,-56
29743,1,0,60,0,-60
29744,1,1,751,1346,595
29745,1,1,434,1259,825
29746,0,0,92,0,-92
29747,1,0,105,0,-105
29748,0,0,111,0,-111
29749,0,0,17,0,-17
29750,1,1,178,1842,1664
29751,0,0,136,0,-136
29752,1,0,9,0,-9
29753,0,0,214,0,-214
29754,0,0,37,0,-37
29755,0,0,50,0,-50
29756,1,1,158,1300,1142
29757,0,0,33,0,-33
29758,0,0,123,0,-123
29759,0,0,159,0,-159
29760,0,0,5,0,-5
29761,1,0,7,0,-7
29762,0,0,84,0,-84
29763,0,0,33,0,-33
29764,1,1,687,1368,681
29765,0,0,8,0,-8
29766,1,1,156,1233,1077
29767,1,1,314,1279,965
29768,1,0,157,0,-157
29769,1,1,195,1304,1109
29770,0,0,21,0,-21
29771,1,1,1138,1258,120
29772,1,0,18,0,-18
29773,0,0,295,0,-295
29774,1,1,147,1274,1127
29775,1,0,70,0,-70
29776,1,0,29,0,-29
29777,1,1,493,2628,2135
29778,1,1,759,1371,612
29779,1,1,489,2558,2069
29780,1,0,18,0,-18
29781,1,1,377,1207,830
29782,1,0,23,0,-23
29783,0,0,3,0,-3
29784,1,0,34,0,-34
29785,0,0,5,0,-5
29786,1,1,805,2536,1731
29787,1,1,42,1219,1177
29788,1,1,1207,1967,760
29789,1,1,1020,1215,195
29790,1,0,102,0,-102
29791,1,1,613,1209,596
29792,1,0,80,0,-80
29793,1,1,147,1362,1215
29794,1,1,489,1469,980
29795,1,1,1416,1347,-69
29796,0,0,38,0,-38
29797,0,0,77,0,-77
29798,1,0,1,0,-1
29799,1,1,555,1492,937
29800,0,0,13,0,-13
29801,1,1,706,1242,536
29802,1,0,4,0,-4
29803,1,0,70,0,-70
29804,1,0,79,0,-79
29805,0,0,61,0,-61
29806,1,0,59,0,-59
29807,1,1,254,1272,1018
29808,1,0,17,0,-17
29809,1,0,196,0,-196
29810,1,0,15,0,-15
29811,0,0,24,0,-24
29812,0,0,0,0,0
29813,1,1,1683,2906,1223
29814,1,1,167,1236,1069
29815,0,0,62,0,-62
29816,1,1,440,1252,812
29817,0,0,75,0,-75
29818,0,0,58,0,-58
29819,1,1,670,1256,586
29820,1,0,53,0,-53
29821,1,0,2,0,-2
29822,0,0,5,0,-5
29823,0,0,2,0,-2
29824,1,0,60,0,-60
29825,1,0,7,0,-7
29826,1,1,476,1421,945
29827,1,1,158,1300,1142
29828,1,0,65,0,-65
29829,0,0,12,0,-12
29830,1,0,2,0,-2
29831,0,0,78,0,-78
29832,1,0,153,0,-153
29833,1,0,76,0,-76
29834,0,0,129,0,-129
29835,1,0,21,0,-21
29836,0,0,82,0,-82
29837,1,0,82,0,-82
29838,0,0,54,0,-54
29839,0,0,73,0,-73
29840,1,1,874,1363,489
29841,1,1,316,2871,2555
29842,0,0,77,0,-77
29843,1,1,122,1619,1497
29844,1,1,526,1531,1005
29845,0,0,95,0,-95
29846,1,0,35,0,-35
29847,1,1,88,1292,1204
29848,1,0,19,0,-19
29849,1,0,138,0,-138
29850,1,0,25,0,-25
29851,1,0,136,0,-136
29852,1,1,557,1313,756
29853,1,0,94,0,-94
29854,0,0,41,0,-41
29855,0,0,186,0,-186
29856,1,0,23,0,-23
29857,0,0,7,0,-7
29858,1,0,229,0,-229
29859,1,1,143,1205,1062
29860,1,0,1,0,-1
29861,0,0,9,0,-9
29862,1,0,0,0,0
29863,0,0,15,0,-15
29864,0,0,19,0,-19
29865,0,0,74,0,-74
29866,0,0,11,0,-11
29867,0,0,79,0,-79
29868,1,1,159,2006,1847
29869,1,0,9,0,-9
29870,1,1,431,1260,829
29871,1,1,110,1319,1209
29872,0,0,37,0,-37
29873,0,0,89,0,-89
29874,1,1,634,1421,787
29875,0,0,18,0,-18
29876,1,0,8,0,-8
29877,0,0,51,0,-51
29878,0,0,21,0,-21
29879,1,1,250,1574,1324
29880,0,0,5,0,-5
29881,1,0,103,0,-103
29882,1,1,596,1212,616
29883,0,0,31,0,-31
29884,0,0,22,0,-22
29885,1,0,19,0,-19
29886,0,0,33,0,-33
29887,1,1,18,1252,1234
29888,1,0,48,0,-48
29889,1,0,55,0,-55
29890,1,1,1706,1545,-161
29891,1,1,113,3692,3579
29892,0,0,6,0,-6
29893,1,1,174,1852,1678
29894,1,0,17,0,-17
29895,1,1,290,1533,1243
29896,1,0,14,0,-14
29897,0,0,12,0,-12
29898,1,1,90,1304,1214
29899,0,0,262,0,-262
29900,0,0,61,0,-61
29901,1,0,42,0,-42
29902,1,1,569,1928,1359
29903,0,0,1,0,-1
29904,0,0,152,0,-152
29905,0,0,54,0,-54
29906,1,0,179,0,-179
29907,1,1,117,1449,1332
29908,0,0,107,0,-107
29909,0,0,130,0,-130
29910,1,1,1177,1709,532
29911,0,0,17,0,-17
29912,0,0,1,0,-1
29913,0,0,15,0,-15
29914,0,0,70,0,-70
29915,0,0,13,0,-13
29916,1,0,38,0,-38
29917,0,0,10,0,-10
29918,1,1,383,1213,830
29919,1,0,96,0,-96
29920,0,0,17,0,-17
29921,1,1,235,1242,1007
29922,1,1,46,1331,1285
29923,0,0,4,0,-4
29924,1,1,809,1241,432
29925,1,0,10,0,-10
29926,1,1,612,1263,651
29927,1,0,48,0,-48
29928,1,1,207,2038,1831
29929,1,1,663,1230,567
29930,1,0,28,0,-28
29931,1,1,313,1574,1261
29932,1,1,580,1225,645
29933,0,0,25,0,-25
29934,1,1,509,1927,1418
29935,1,1,88,1394,1306
29936,1,1,861,1481,620
29937,0,0,71,0,-71
29938,1,1,239,1447,1208
29939,1,1,296,1390,1094
29940,1,0,21,0,-21
29941,1,0,4,0,-4
29942,1,0,1,0,-1
29943,1,0,22,0,-22
29944,0,0,7,0,-7
29945,1,0,117,0,-117
29946,1,0,175,0,-175
29947,0,0,9,0,-9
29948,1,1,658,1298,640
29949,1,1,529,1318,789
29950,1,0,216,0,-216
29951,1,1,508,1212,704
29952,0,0,27,0,-27
29953,1,1,475,1519,1044
29954,1,1,175,1462,1287
29955,1,1,189,1217,1028
29956,1,0,1,0,-1
29957,0,0,111,0,-111
29958,1,1,181,1496,1315
29959,1,1,353,1992,1639
29960,1,1,385,2816,2431
29961,0,0,53,0,-53
29962,1,1,147,2164,2017
29963,0,0,41,0,-41
29964,0,0,135,0,-135
29965,1,1,611,1717,1106
29966,0,0,140,0,-140
29967,1,1,350,1282,932
29968,1,0,23,0,-23
29969,0,0,103,0,-103
29970,0,0,17,0,-17
29971,0,0,48,0,-48
29972,1,1,755,1245,490
29973,1,0,74,0,-74
29974,1,1,69,1376,1307
29975,0,0,145,0,-145
29976,1,1,1110,1250,140
29977,1,1,128,1216,1088
29978,1,0,65,0,-65
29979,0,0,49,0,-49
29980,1,0,128,0,-128
29981,1,1,77,1231,1154
29982,0,0,27,0,-27
29983,1,1,119,1254,1135
29984,0,0,5,0,-5
29985,0,0,109,0,-109
29986,1,0,61,0,-61
29987,1,0,3,0,-3
29988,1,0,40,0,-40
29989,1,0,105,0,-105
29990,1,1,223,1245,1022
29991,0,0,20,0,-20
29992,1,0,14,0,-14
29993,0,0,12,0,-12
29994,1,0,17,0,-17
29995,0,0,47,0,-47
29996,0,0,22,0,-22
29997,0,0,76,0,-76
29998,1,1,269,1373,1104
29999,1,1,228,1573,1345
30000,1,0,32,0,-32
30001,0,0,42,0,-42
30002,1,1,116,1891,1775
30003,1,1,344,1576,1232
30004,1,0,27,0,-27
30005,1,0,159,0,-159
30006,0,0,17,0,-17
30007,1,1,601,1831,1230
30008,1,1,416,1410,994
30009,0,0,26,0,-26
30010,1,0,48,0,-48
30011,1,0,36,0,-36
30012,1,1,452,1288,836
30013,0,0,33,0,-33
30014,1,0,15,0,-15
30015,1,0,115,0,-115
30016,0,0,94,0,-94
30017,1,0,27,0,-27
30018,0,0,68,0,-68
30019,0,0,28,0,-28
30020,0,0,24,0,-24
30021,1,1,434,1458,1024
30022,1,1,308,1279,971
30023,1,1,1782,2200,418
30024,0,0,53,0,-53
30025,0,0,26,0,-26
30026,1,1,381,1306,925
30027,1,0,33,0,-33
30028,0,0,26,0,-26
30029,1,1,207,1283,1076
30030,1,1,765,1744,979
30031,1,1,344,1777,1433
30032,0,0,50,0,-50
30033,1,0,24,0,-24
30034,0,0,38,0,-38
30035,1,0,109,0,-109
30036,1,0,107,0,-107
30037,1,0,5,0,-5
30038,0,0,140,0,-140
30039,0,0,1,0,-1
30040,0,0,68,0,-68
30041,0,0,33,0,-33
30042,0,0,78,0,-78
30043,0,0,13,0,-13
30044,0,0,16,0,-16
30045,1,0,20,0,-20
30046,1,0,7,0,-7
30047,1,0,104,0,-104
30048,1,0,112,0,-112
30049,1,1,180,1269,1089
30050,1,1,470,1356,886
30051,1,1,209,2274,2065
30052,1,0,7,0,-7
30053,1,0,1,0,-1
30054,1,1,489,1484,995
30055,1,0,16,0,-16
30056,1,0,28,0,-28
30057,1,0,62,0,-62
30058,0,0,13,0,-13
30059,1,0,39,0,-39
30060,0,0,0,0,0
30061,1,1,396,1299,903
30062,1,1,133,2113,1980
30063,1,0,13,0,-13
30064,1,0,27,0,-27
30065,0,0,7,0,-7
30066,1,0,102,0,-102
30067,1,1,54,2333,2279
30068,1,0,86,0,-86
30069,0,0,36,0,-36
30070,1,1,132,1334,1202
30071,1,1,300,2233,1933
30072,0,0,68,0,-68
30073,0,0,29,0,-29
30074,0,0,37,0,-37
30075,0,0,3,0,-3
30076,1,1,151,3724,3573
30077,0,0,84,0,-84
30078,0,0,4,0,-4
30079,0,0,20,0,-20
30080,0,0,44,0,-44
30081,1,1,132,2444,2312
30082,0,0,83,0,-83
30083,1,0,30,0,-30
30084,1,0,46,0,-46
30085,0,0,24,0,-24
30086,1,1,967,1367,400
30087,1,1,177,3577,3400
30088,0,0,4,0,-4
30089,1,0,75,0,-75
30090,0,0,61,0,-61
30091,0,0,49,0,-49
30092,1,1,85,1418,1333
30093,0,0,37,0,-37
30094,1,0,8,0,-8
30095,0,0,7,0,-7
30096,1,0,32,0,-32
30097,1,0,50,0,-50
30098,1,0,200,0,-200
30099,1,0,3,0,-3
30100,0,0,81,0,-81
30101,1,0,50,0,-50
30102,1,0,69,0,-69
30103,1,1,350,1374,1024
30104,0,0,5,0,-5
30105,0,0,10,0,-10
30106,1,1,662,1256,594
30107,1,1,1026,1856,830
30108,1,0,1,0,-1
30109,1,0,137,0,-137
30110,1,0,306,0,-306
30111,1,1,148,1240,1092
30112,1,0,125,0,-125
30113,1,0,149,0,-149
30114,1,1,1225,1226,1
30115,1,1,101,1313,1212
30116,1,0,18,0,-18
30117,0,0,82,0,-82
30118,0,0,19,0,-19
30119,0,0,8,0,-8
30120,1,0,55,0,-55
30121,0,0,31,0,-31
30122,0,0,31,0,-31
30123,1,0,21,0,-21
30124,1,1,611,2439,1828
30125,0,0,82,0,-82
30126,0,0,52,0,-52
30127,1,0,193,0,-193
30128,0,0,85,0,-85
30129,0,0,16,0,-16
30130,1,0,87,0,-87
30131,1,0,87,0,-87
30132,0,0,5,0,-5
30133,0,0,41,0,-41
30134,1,1,440,1211,771
30135,1,1,230,1316,1086
30136,1,1,174,1531,1357
30137,1,0,0,0,0
30138,1,1,165,4247,4082
30139,0,0,9,0,-9
30140,1,0,2,0,-2
30141,0,0,30,0,-30
30142,1,1,204,1289,1085
30143,1,0,159,0,-159
30144,1,0,8,0,-8
30145,1,1,410,1343,933
30146,1,0,42,0,-42
30147,1,0,13,0,-13
30148,0,0,65,0,-65
30149,1,0,22,0,-22
30150,0,0,58,0,-58
30151,1,0,116,0,-116
30152,1,1,231,1265,1034
30153,0,0,42,0,-42
30154,0,0,82,0,-82
30155,1,1,806,1324,518
30156,1,0,9,0,-9
30157,1,0,26,0,-26
30158,1,0,72,0,-72
30159,0,0,19,0,-19
30160,0,0,27,0,-27
30161,1,0,15,0,-15
30162,1,0,20,0,-20
30163,0,0,0,0,0
30164,1,1,174,1454,1280
30165,1,0,33,0,-33
30166,1,1,1707,1471,-236
30167,1,0,57,0,-57
30168,1,0,22,0,-22
30169,0,0,33,0,-33
30170,1,1,1027,3326,2299
30171,0,0,46,0,-46
30172,1,0,7,0,-7
30173,1,1,1171,1690,519
30174,1,1,857,1925,1068
30175,1,1,414,1446,1032
30176,1,0,72,0,-72
30177,0,0,65,0,-65
30178,0,0,12,0,-12
30179,0,0,2,0,-2
30180,1,1,802,1543,741
30181,1,0,10,0,-10
30182,1,1,428,1505,1077
30183,1,1,130,1744,1614
30184,1,1,346,1250,904
30185,1,0,5,0,-5
30186,0,0,60,0,-60
30187,0,0,12,0,-12
30188,0,0,3,0,-3
30189,1,1,216,3026,2810
30190,1,0,38,0,-38
30191,0,0,31,0,-31
30192,1,1,452,1446,994
30193,1,1,1058,1266,208
30194,1,1,210,1261,1051
30195,0,0,38,0,-38
30196,0,0,21,0,-21
30197,0,0,1,0,-1
30198,0,0,26,0,-26
30199,1,1,349,1357,1008
30200,1,0,76,0,-76
30201,0,0,126,0,-126
30202,1,0,85,0,-85
30203,0,0,165,0,-165
30204,0,0,23,0,-23
30205,0,0,14,0,-14
30206,1,0,112,0,-112
30207,0,0,13,0,-13
30208,1,0,34,0,-34
30209,0,0,0,0,0
30210,1,0,4,0,-4
30211,0,0,23,0,-23
30212,0,0,62,0,-62
30213,1,0,23,0,-23
30214,1,1,360,1693,1333
30215,1,1,1285,1384,99
30216,1,0,29,0,-29
30217,1,1,594,2116,1522
30218,1,0,1,0,-1
30219,1,0,26,0,-26
30220,1,1,912,2435,1523
30221,1,1,228,1460,1232
30222,0,0,12,0,-12
30223,0,0,131,0,-131
30224,1,1,317,1418,1101
30225,1,1,273,1275,1002
30226,0,0,11,0,-11
30227,1,1,908,1310,402
30228,1,0,20,0,-20
30229,0,0,74,0,-74
30230,0,0,60,0,-60
30231,0,0,177,0,-177
30232,0,0,11,0,-11
30233,1,0,213,0,-213
30234,0,0,59,0,-59
30235,0,0,7,0,-7
30236,1,0,37,0,-37
30237,0,0,31,0,-31
30238,0,0,24,0,-24
30239,1,1,223,1965,1742
30240,1,0,19,0,-19
30241,1,0,27,0,-27
30242,1,1,225,1363,1138
30243,1,1,813,1813,1000
30244,1,0,142,0,-142
30245,1,1,585,1855,1270
30246,1,1,23,1506,1483
30247,1,0,72,0,-72
30248,1,1,139,2012,1873
30249,0,0,3,0,-3
30250,0,0,46,0,-46
30251,1,0,43,0,-43
30252,0,0,22,0,-22
30253,1,0,35,0,-35
30254,0,0,10,0,-10
30255,0,0,41,0,-41
30256,1,0,186,0,-186
30257,0,0,14,0,-14
30258,1,1,980,1506,526
30259,0,0,8,0,-8
30260,1,0,117,0,-117
30261,1,0,55,0,-55
30262,0,0,171,0,-171
30263,1,1,343,1539,1196
30264,1,0,19,0,-19
30265,1,0,15,0,-15
30266,0,0,2,0,-2
30267,0,0,3,0,-3
30268,0,0,43,0,-43
30269,1,0,8,0,-8
30270,1,0,22,0,-22
30271,1,1,414,1566,1152
30272,1,0,17,0,-17
30273,1,0,18,0,-18
30274,0,0,6,0,-6
30275,1,1,275,1227,952
30276,1,1,383,3808,3425
30277,0,0,44,0,-44
30278,1,0,53,0,-53
30279,1,0,112,0,-112
30280,0,0,206,0,-206
30281,0,0,2,0,-2
30282,1,1,105,1253,1148
30283,0,0,16,0,-16
30284,1,1,185,1748,1563
30285,1,1,312,1204,892
30286,1,1,90,1911,1821
30287,1,0,30,0,-30
30288,0,0,41,0,-41
30289,1,0,159,0,-159
30290,1,0,50,0,-50
30291,0,0,0,0,0
30292,1,1,692,1238,546
30293,1,0,30,0,-30
30294,0,0,19,0,-19
30295,1,1,765,1310,545
30296,1,1,725,1214,489
30297,0,0,89,0,-89
30298,1,0,79,0,-79
30299,0,0,128,0,-128
30300,0,0,6,0,-6
30301,0,0,165,0,-165
30302,1,0,77,0,-77
30303,0,0,1,0,-1
30304,0,0,9,0,-9
30305,1,0,4,0,-4
30306,1,0,30,0,-30
30307,0,0,51,0,-51
30308,0,0,15,0,-15
30309,1,0,26,0,-26
30310,0,0,57,0,-57
30311,0,0,54,0,-54
30312,1,1,1187,6162,4975
30313,0,0,66,0,-66
30314,1,0,1,0,-1
30315,0,0,31,0,-31
30316,1,1,35,1434,1399
30317,1,1,332,1546,1214
30318,1,1,73,1734,1661
30319,0,0,18,0,-18
30320,1,0,61,0,-61
30321,0,0,108,0,-108
30322,1,1,1544,1267,-277
30323,0,0,53,0,-53
30324,0,0,60,0,-60
30325,0,0,14,0,-14
30326,1,0,58,0,-58
30327,1,0,202,0,-202
30328,1,1,152,1525,1373
30329,1,1,291,2011,1720
30330,0,0,49,0,-49
30331,1,1,1140,1228,88
30332,1,1,158,1306,1148
30333,0,0,114,0,-114
30334,0,0,39,0,-39
30335,1,0,68,0,-68
30336,0,0,40,0,-40
30337,1,1,585,1672,1087
30338,1,1,948,1660,712
30339,1,0,17,0,-17
30340,1,0,33,0,-33
30341,0,0,46,0,-46
30342,1,0,9,0,-9
30343,1,0,27,0,-27
30344,1,0,11,0,-11
30345,1,0,97,0,-97
30346,0,0,63,0,-63
30347,0,0,35,0,-35
30348,1,1,325,1303,978
30349,1,0,32,0,-32
30350,0,0,0,0,0
30351,1,1,1027,2850,1823
30352,1,0,15,0,-15
30353,0,0,46,0,-46
30354,1,1,528,1467,939
30355,0,0,8,0,-8
30356,1,0,18,0,-18
30357,1,1,138,1835,1697
30358,1,1,285,1267,982
30359,1,0,140,0,-140
30360,1,0,112,0,-112
30361,1,1,168,1284,1116
30362,1,1,677,1490,813
30363,1,0,293,0,-293
30364,1,0,40,0,-40
30365,1,1,475,1410,935
30366,0,0,51,0,-51
30367,1,0,5,0,-5
30368,0,0,10,0,-10
30369,0,0,18,0,-18
30370,0,0,22,0,-22
30371,1,1,197,1695,1498
30372,1,0,9,0,-9
30373,0,0,87,0,-87
30374,0,0,63,0,-63
30375,1,1,219,1329,1110
30376,0,0,18,0,-18
30377,0,0,54,0,-54
30378,1,1,242,1341,1099
30379,0,0,2,0,-2
30380,0,0,75,0,-75
30381,1,0,59,0,-59
30382,1,1,252,1392,1140
30383,1,1,393,1712,1319
30384,1,0,33,0,-33
30385,1,0,11,0,-11
30386,0,0,5,0,-5
30387,0,0,32,0,-32
30388,0,0,13,0,-13
30389,1,0,15,0,-15
30390,1,0,13,0,-13
30391,1,1,694,1259,565
30392,1,0,63,0,-63
30393,1,0,61,0,-61
30394,0,0,8,0,-8
30395,1,1,197,2185,1988
30396,0,0,64,0,-64
30397,1,1,2283,1699,-584
30398,1,1,489,1465,976
30399,0,0,37,0,-37
30400,1,0,58,0,-58
30401,1,0,7,0,-7
30402,0,0,8,0,-8
30403,1,0,15,0,-15
30404,1,0,33,0,-33
30405,1,0,87,0,-87
30406,0,0,67,0,-67
30407,1,0,14,0,-14
30408,1,1,99,1659,1560
30409,1,1,1927,1516,-411
30410,1,1,229,1363,1134
30411,1,0,31,0,-31
30412,1,0,29,0,-29
30413,1,0,30,0,-30
30414,1,0,121,0,-121
30415,1,1,1307,1518,211
30416,1,0,0,0,0
30417,0,0,29,0,-29
30418,1,0,278,0,-278
30419,1,0,26,0,-26
30420,0,0,48,0,-48
30421,1,0,54,0,-54
30422,0,0,40,0,-40
30423,1,1,184,2501,2317
30424,0,0,2,0,-2
30425,0,0,18,0,-18
30426,0,0,5,0,-5
30427,1,1,372,1295,923
30428,0,0,108,0,-108
30429,1,1,391,2227,1836
30430,1,1,589,1281,692
30431,1,1,262,3301,3039
30432,1,1,582,1665,1083
30433,0,0,20,0,-20
30434,1,1,466,1692,1226
30435,0,0,153,0,-153
30436,0,0,59,0,-59
30437,0,0,4,0,-4
30438,1,1,652,1220,568
30439,0,0,55,0,-55
30440,1,1,226,1368,1142
30441,1,1,70,1208,1138
30442,0,0,47,0,-47
30443,1,1,506,2254,1748
30444,0,0,96,0,-96
30445,0,0,12,0,-12
30446,1,1,62,1251,1189
30447,1,0,5,0,-5
30448,1,0,0,0,0
30449,1,0,56,0,-56
30450,1,0,4,0,-4
30451,1,0,8,0,-8
30452,1,1,31,1737,1706
30453,0,0,33,0,-33
30454,1,0,14,0,-14
30455,0,0,66,0,-66
30456,1,0,35,0,-35
30457,0,0,111,0,-111
30458,0,0,86,0,-86
30459,0,0,150,0,-150
30460,1,0,7,0,-7
30461,0,0,9,0,-9
30462,0,0,2,0,-2
30463,0,0,31,0,-31
30464,1,0,13,0,-13
30465,0,0,21,0,-21
30466,0,0,75,0,-75
30467,1,1,348,1466,1118
30468,0,0,11,0,-11
30469,1,0,34,0,-34
30470,0,0,10,0,-10
30471,1,1,366,1668,1302
30472,1,0,21,0,-21
30473,1,0,41,0,-41
30474,1,0,3,0,-3
30475,1,0,68,0,-68
30476,1,0,173,0,-173
30477,1,1,127,1392,1265
30478,0,0,17,0,-17
30479,1,0,124,0,-124
30480,1,1,269,1320,1051
30481,1,1,697,1409,712
30482,1,1,220,1474,1254
30483,0,0,2,0,-2
30484,0,0,36,0,-36
30485,1,1,1590,2932,1342
30486,1,1,282,1292,1010
30487,1,0,40,0,-40
30488,1,1,548,2784,2236
30489,1,0,70,0,-70
30490,0,0,47,0,-47
30491,1,1,425,1539,1114
30492,1,1,1253,1416,163
30493,0,0,5,0,-5
30494,1,1,126,1339,1213
30495,0,0,72,0,-72
30496,1,0,26,0,-26
30497,1,0,18,0,-18
30498,1,1,1488,1393,-95
30499,0,0,47,0,-47
30500,1,1,170,1243,1073
30501,1,1,534,1268,734
30502,0,0,468,0,-468
30503,0,0,64,0,-64
30504,1,1,179,1963,1784
30505,1,1,417,1666,1249
30506,1,1,940,2023,1083
30507,0,0,161,0,-161
30508,0,0,5,0,-5
30509,1,0,17,0,-17
30510,1,0,14,0,-14
30511,1,0,35,0,-35
30512,0,0,34,0,-34
30513,1,0,27,0,-27
30514,1,0,19,0,-19
30515,1,1,595,1858,1263
30516,1,1,86,1321,1235
30517,0,0,28,0,-28
30518,1,0,1,0,-1
30519,0,0,170,0,-170
30520,1,0,1,0,-1
30521,0,0,1,0,-1
30522,1,0,39,0,-39
30523,1,0,32,0,-32
30524,0,0,55,0,-55
30525,0,0,31,0,-31
30526,1,1,445,2416,1971
30527,0,0,12,0,-12
30528,1,0,15,0,-15
30529,1,0,15,0,-15
30530,0,0,95,0,-95
30531,0,0,17,0,-17
30532,0,0,5,0,-5
30533,1,0,170,0,-170
30534,0,0,51,0,-51
30535,0,0,3,0,-3
30536,0,0,30,0,-30
30537,0,0,46,0,-46
30538,1,0,67,0,-67
30539,1,1,265,1365,1100
30540,1,1,208,1307,1099
30541,1,0,81,0,-81
30542,1,0,13,0,-13
30543,1,1,359,2173,1814
30544,0,0,3,0,-3
30545,1,0,11,0,-11
30546,1,0,10,0,-10
30547,1,0,24,0,-24
30548,0,0,68,0,-68
30549,1,0,12,0,-12
30550,0,0,67,0,-67
30551,0,0,67,0,-67
30552,1,1,172,1389,1217
30553,1,0,32,0,-32
30554,1,1,37,1235,1198
30555,0,0,110,0,-110
30556,1,0,9,0,-9
30557,0,0,190,0,-190
30558,1,0,76,0,-76
30559,1,0,16,0,-16
30560,0,0,31,0,-31
30561,1,1,464,2049,1585
30562,1,1,270,1303,1033
30563,0,0,2,0,-2
30564,1,0,94,0,-94
30565,1,1,462,1541,1079
30566,0,0,8,0,-8
30567,0,0,11,0,-11
30568,1,0,2,0,-2
30569,0,0,40,0,-40
30570,1,1,22,1945,1923
30571,0,0,44,0,-44
30572,1,0,55,0,-55
30573,0,0,4,0,-4
30574,0,0,42,0,-42
30575,1,0,52,0,-52
30576,1,0,39,0,-39
30577,1,1,377,1648,1271
30578,0,0,84,0,-84
30579,0,0,18,0,-18
30580,0,0,23,0,-23
30581,1,1,599,1269,670
30582,1,0,41,0,-41
30583,0,0,49,0,-49
30584,1,1,953,1416,463
30585,0,0,93,0,-93
30586,1,0,160,0,-160
30587,1,0,113,0,-113
30588,1,1,176,1948,1772
30589,1,0,41,0,-41
30590,0,0,12,0,-12
30591,1,1,400,2939,2539
30592,0,0,6,0,-6
30593,1,0,30,0,-30
30594,1,1,260,1398,1138
30595,1,0,21,0,-21
30596,1,0,90,0,-90
30597,0,0,40,0,-40
30598,0,0,28,0,-28
30599,0,0,17,0,-17
30600,1,1,268,1332,1064
30601,0,0,37,0,-37
30602,0,0,169,0,-169
30603,0,0,0,0,0
30604,1,1,759,1420,661
30605,1,1,713,1251,538
30606,0,0,120,0,-120
30607,1,1,440,1284,844
30608,0,0,133,0,-133
30609,1,1,1249,1239,-10
30610,0,0,63,0,-63
30611,1,0,79,0,-79
30612,0,0,65,0,-65
30613,0,0,33,0,-33
30614,0,0,64,0,-64
30615,0,0,55,0,-55
30616,0,0,137,0,-137
30617,0,0,20,0,-20
30618,0,0,148,0,-148
30619,0,0,58,0,-58
30620,1,0,45,0,-45
30621,1,0,156,0,-156
30622,0,0,108,0,-108
30623,0,0,42,0,-42
30624,1,1,311,1232,921
30625,1,0,78,0,-78
30626,0,0,112,0,-112
30627,0,0,19,0,-19
30628,1,1,1175,2029,854
30629,1,1,602,1320,718
30630,0,0,12,0,-12
30631,1,0,28,0,-28
30632,1,0,43,0,-43
30633,1,1,283,1465,1182
30634,0,0,6,0,-6
30635,1,1,620,1223,603
30636,0,0,51,0,-51
30637,0,0,77,0,-77
30638,1,0,29,0,-29
30639,1,0,107,0,-107
30640,1,1,78,1229,1151
30641,0,0,31,0,-31
30642,1,0,53,0,-53
30643,1,0,45,0,-45
30644,0,0,103,0,-103
30645,1,1,346,1887,1541
30646,1,0,67,0,-67
30647,1,1,95,1353,1258
30648,0,0,87,0,-87
30649,1,0,45,0,-45
30650,0,0,1,0,-1
30651,1,1,90,1364,1274
30652,0,0,70,0,-70
30653,0,0,4,0,-4
30654,0,0,21,0,-21
30655,1,1,386,1300,914
30656,0,0,32,0,-32
30657,1,1,1764,1202,-562
30658,1,1,459,1259,800
30659,1,0,53,0,-53
30660,0,0,66,0,-66
30661,1,1,326,1401,1075
30662,0,0,32,0,-32
30663,1,1,37,1572,1535
30664,1,1,1076,4546,3470
30665,1,0,3,0,-3
30666,1,0,349,0,-349
30667,0,0,62,0,-62
30668,0,0,48,0,-48
30669,0,0,31,0,-31
30670,1,1,134,1214,1080
30671,1,0,35,0,-35
30672,1,0,63,0,-63
30673,1,1,2035,1344,-691
30674,0,0,133,0,-133
30675,1,1,530,1293,763
30676,1,0,84,0,-84
30677,1,0,11,0,-11
30678,0,0,90,0,-90
30679,0,0,219,0,-219
30680,1,1,355,1694,1339
30681,1,0,3,0,-3
30682,1,1,2702,1308,-1394
30683,1,0,126,0,-126
30684,1,1,915,1570,655
30685,1,1,899,1280,381
30686,0,0,37,0,-37
30687,0,0,11,0,-11
30688,1,0,54,0,-54
30689,0,0,12,0,-12
30690,0,0,7,0,-7
30691,0,0,14,0,-14
30692,1,1,266,3196,2930
30693,0,0,40,0,-40
30694,1,0,30,0,-30
30695,1,1,2386,1275,-1111
30696,0,0,97,0,-97
30697,1,1,393,1259,866
30698,0,0,137,0,-137
30699,1,0,48,0,-48
30700,0,0,73,0,-73
30701,1,0,61,0,-61
30702,0,0,118,0,-118
30703,0,0,51,0,-51
30704,1,0,5,0,-5
30705,1,0,72,0,-72
30706,1,0,63,0,-63
30707,0,0,108,0,-108
30708,1,1,522,1434,912
30709,0,0,49,0,-49
30710,1,1,608,1353,745
30711,0,0,240,0,-240
30712,0,0,134,0,-134
30713,1,0,26,0,-26
30714,0,0,17,0,-17
30715,0,0,62,0,-62
30716,1,1,1261,1489,228
30717,0,0,1,0,-1
30718,0,0,83,0,-83
30719,1,0,48,0,-48
30720,1,0,226,0,-226
30721,1,0,19,0,-19
30722,1,1,531,1254,723
30723,1,1,1294,1381,87
30724,1,1,136,1329,1193
30725,1,1,212,1458,1246
30726,1,1,338,1274,936
30727,1,0,42,0,-42
30728,1,1,1051,1283,232
30729,1,1,82,1499,1417
30730,0,0,63,0,-63
30731,0,0,31,0,-31
30732,1,1,121,3187,3066
30733,1,1,115,1295,1180
30734,1,1,497,1939,1442
30735,1,1,305,2099,1794
30736,0,0,83,0,-83
30737,0,0,56,0,-56
30738,0,0,27,0,-27
30739,1,0,3,0,-3
30740,0,0,33,0,-33
30741,1,0,69,0,-69
30742,1,1,1099,1827,728
30743,1,0,36,0,-36
30744,1,1,568,1255,687
30745,1,0,19,0,-19
30746,0,0,117,0,-117
30747,1,1,389,1301,912
30748,0,0,151,0,-151
30749,1,1,351,2823,2472
30750,0,0,63,0,-63
30751,0,0,34,0,-34
30752,1,1,1327,2423,1096
30753,1,1,84,2800,2716
30754,1,0,3,0,-3
30755,1,0,6,0,-6
30756,0,0,3,0,-3
30757,1,0,24,0,-24
30758,0,0,91,0,-91
30759,1,1,408,1521,1113
30760,1,1,1035,1254,219
30761,0,0,66,0,-66
30762,1,0,11,0,-11
30763,0,0,73,0,-73
30764,1,1,299,1507,1208
30765,0,0,32,0,-32
30766,0,0,33,0,-33
30767,1,1,289,1390,1101
30768,1,0,81,0,-81
30769,1,1,910,1739,829
30770,0,0,8,0,-8
30771,0,0,102,0,-102
30772,1,0,85,0,-85
30773,0,0,87,0,-87
30774,0,0,30,0,-30
30775,0,0,31,0,-31
30776,0,0,23,0,-23
30777,1,0,131,0,-131
30778,1,0,90,0,-90
30779,1,0,120,0,-120
30780,0,0,18,0,-18
30781,1,0,26,0,-26
30782,1,1,705,1572,867
30783,1,1,680,1293,613
30784,1,1,1655,1226,-429
30785,1,1,348,1352,1004
30786,1,1,153,1521,1368
30787,1,0,13,0,-13
30788,1,1,219,1360,1141
30789,1,1,581,1235,654
30790,1,0,20,0,-20
30791,1,1,133,1960,1827
30792,1,0,111,0,-111
30793,0,0,73,0,-73
30794,0,0,45,0,-45
30795,0,0,8,0,-8
30796,0,0,93,0,-93
30797,0,0,24,0,-24
30798,1,1,74,1515,1441
30799,0,0,1,0,-1
30800,1,1,705,1390,685
30801,1,1,507,1264,757
30802,1,1,1536,1611,75
30803,1,1,277,1524,1247
30804,1,0,66,0,-66
30805,0,0,6,0,-6
30806,0,0,16,0,-16
30807,1,0,18,0,-18
30808,1,0,7,0,-7
30809,1,1,521,1284,763
30810,1,1,497,1358,861
30811,1,1,41,1239,1198
30812,1,0,6,0,-6
30813,1,0,114,0,-114
30814,1,1,2899,2478,-421
30815,0,0,11,0,-11
30816,1,1,209,1211,1002
30817,1,0,52,0,-52
30818,1,1,205,1479,1274
30819,1,1,670,1697,1027
30820,1,0,30,0,-30
30821,1,1,2205,1256,-949
30822,1,0,1,0,-1
30823,1,0,24,0,-24
30824,0,0,44,0,-44
30825,0,0,49,0,-49
30826,0,0,12,0,-12
30827,0,0,11,0,-11
30828,1,0,175,0,-175
30829,0,0,66,0,-66
30830,1,1,133,1210,1077
30831,0,0,69,0,-69
30832,1,0,93,0,-93
30833,0,0,72,0,-72
30834,1,1,287,1280,993
30835,1,1,1070,2042,972
30836,1,1,1250,1283,33
30837,1,0,58,0,-58
30838,0,0,11,0,-11
30839,1,1,404,1531,1127
30840,0,0,101,0,-101
30841,0,0,88,0,-88
30842,0,0,21,0,-21
30843,1,1,366,1612,1246
30844,1,1,303,1515,1212
30845,0,0,23,0,-23
30846,0,0,23,0,-23
30847,1,0,86,0,-86
30848,1,0,100,0,-100
30849,0,0,34,0,-34
30850,0,0,146,0,-146
30851,1,0,36,0,-36
30852,1,0,13,0,-13
30853,0,0,121,0,-121
30854,1,0,57,0,-57
30855,0,0,3,0,-3
30856,0,0,14,0,-14
30857,1,1,167,1539,1372
30858,1,0,32,0,-32
30859,1,0,18,0,-18
30860,1,0,38,0,-38
30861,1,0,205,0,-205
30862,1,1,183,1436,1253
30863,1,0,63,0,-63
30864,1,1,115,1346,1231
30865,0,0,254,0,-254
30866,0,0,14,0,-14
30867,1,1,549,1224,675
30868,1,0,53,0,-53
30869,1,0,9,0,-9
30870,1,1,720,1316,596
30871,0,0,16,0,-16
30872,0,0,160,0,-160
30873,0,0,47,0,-47
30874,0,0,35,0,-35
30875,1,1,2251,1342,-909
30876,1,0,110,0,-110
30877,1,0,11,0,-11
30878,1,1,875,1318,443
30879,0,0,92,0,-92
30880,1,1,105,1587,1482
30881,1,1,15,1343,1328
30882,0,0,144,0,-144
30883,0,0,39,0,-39
30884,0,0,89,0,-89
30885,1,0,79,0,-79
30886,0,0,119,0,-119
30887,1,0,137,0,-137
30888,1,0,86,0,-86
30889,1,1,103,2119,2016
30890,0,0,15,0,-15
30891,1,1,553,1337,784
30892,1,0,69,0,-69
30893,0,0,47,0,-47
30894,1,1,2283,1368,-915
30895,0,0,34,0,-34
30896,0,0,4,0,-4
30897,0,0,14,0,-14
30898,0,0,78,0,-78
30899,1,1,3375,1473,-1902
30900,1,1,187,1944,1757
30901,0,0,74,0,-74
30902,1,1,51,1418,1367
30903,1,1,217,2637,2420
30904,1,0,93,0,-93
30905,1,1,1593,1203,-390
30906,1,0,68,0,-68
30907,1,1,514,1926,1412
30908,1,1,481,1396,915
30909,1,0,88,0,-88
30910,0,0,132,0,-132
30911,1,1,986,1709,723
30912,0,0,59,0,-59
30913,0,0,21,0,-21
30914,1,1,227,1214,987
30915,0,0,13,0,-13
30916,1,0,5,0,-5
30917,0,0,69,0,-69
30918,1,1,2541,1202,-1339
30919,1,0,10,0,-10
30920,1,1,352,1430,1078
30921,1,0,133,0,-133
30922,0,0,16,0,-16
30923,1,1,445,1277,832
30924,0,0,3,0,-3
30925,1,1,48,1483,1435
30926,0,0,62,0,-62
30927,1,0,5,0,-5
30928,0,0,25,0,-25
30929,0,0,15,0,-15
30930,1,0,41,0,-41
30931,1,0,73,0,-73
30932,0,0,21,0,-21
30933,1,0,2,0,-2
30934,1,1,501,2938,2437
30935,0,0,16,0,-16
30936,1,1,220,1336,1116
30937,1,1,2196,1223,-973
30938,1,0,9,0,-9
30939,1,0,58,0,-58
30940,0,0,7,0,-7
30941,1,1,2907,2477,-430
30942,1,0,28,0,-28
30943,0,0,3,0,-3
30944,0,0,29,0,-29
30945,0,0,2,0,-2
30946,1,1,174,1978,1804
30947,1,0,84,0,-84
30948,0,0,68,0,-68
30949,1,0,13,0,-13
30950,1,1,672,1573,901
30951,1,1,920,1918,998
30952,1,0,184,0,-184
30953,1,0,148,0,-148
30954,1,1,733,1515,782
30955,0,0,18,0,-18
30956,1,1,538,1222,684
30957,1,1,1647,2004,357
30958,1,1,994,1507,513
30959,0,0,21,0,-21
30960,1,1,236,1444,1208
30961,1,1,302,1681,1379
30962,0,0,60,0,-60
30963,0,0,62,0,-62
30964,0,0,85,0,-85
30965,0,0,104,0,-104
30966,1,1,161,1201,1040
30967,1,0,95,0,-95
30968,0,0,73,0,-73
30969,0,0,9,0,-9
30970,0,0,32,0,-32
30971,1,0,3,0,-3
30972,1,0,74,0,-74
30973,1,1,198,1253,1055
30974,0,0,25,0,-25
30975,1,0,155,0,-155
30976,0,0,16,0,-16
30977,1,0,58,0,-58
30978,0,0,0,0,0
30979,1,0,10,0,-10
30980,0,0,59,0,-59
30981,1,0,17,0,-17
30982,0,0,19,0,-19
30983,0,0,35,0,-35
30984,1,1,72,1295,1223
30985,1,1,529,1302,773
30986,0,0,18,0,-18
30987,1,1,2273,1821,-452
30988,1,1,1155,1250,95
30989,1,1,191,1381,1190
30990,1,0,33,0,-33
30991,0,0,0,0,0
30992,0,0,5,0,-5
30993,1,1,37,1553,1516
30994,0,0,15,0,-15
30995,1,0,48,0,-48
30996,1,0,17,0,-17
30997,1,1,387,1410,1023
30998,1,1,1586,1266,-320
30999,1,0,39,0,-39
31000,1,1,351,1394,1043
31001,1,0,8,0,-8
31002,1,1,377,1216,839
31003,1,1,213,1435,1222
31004,0,0,13,0,-13
31005,1,1,67,1565,1498
31006,1,1,365,1303,938
31007,1,0,12,0,-12
31008,1,1,1734,1242,-492
31009,0,0,52,0,-52
31010,0,0,9,0,-9
31011,0,0,33,0,-33
31012,1,1,355,1413,1058
31013,1,1,430,1301,871
31014,0,0,42,0,-42
31015,1,0,114,0,-114
31016,0,0,163,0,-163
31017,0,0,145,0,-145
31018,1,0,20,0,-20
31019,0,0,46,0,-46
31020,1,0,20,0,-20
31021,1,0,98,0,-98
31022,0,0,17,0,-17
31023,0,0,44,0,-44
31024,0,0,90,0,-90
31025,1,0,71,0,-71
31026,0,0,161,0,-161
31027,1,1,319,1214,895
31028,1,0,13,0,-13
31029,1,0,35,0,-35
31030,1,1,64,1208,1144
31031,1,0,59,0,-59
31032,1,0,24,0,-24
31033,1,0,29,0,-29
31034,1,0,58,0,-58
31035,0,0,26,0,-26
31036,0,0,3,0,-3
31037,0,0,10,0,-10
31038,0,0,29,0,-29
31039,1,0,0,0,0
31040,0,0,51,0,-51
31041,0,0,0,0,0
31042,1,0,63,0,-63
31043,1,0,17,0,-17
31044,0,0,1,0,-1
31045,1,1,131,1279,1148
31046,0,0,13,0,-13
31047,1,1,80,1403,1323
31048,1,1,921,1233,312
31049,1,1,1900,1341,-559
31050,1,1,669,1805,1136
31051,0,0,101,0,-101
31052,1,0,76,0,-76
31053,0,0,10,0,-10
31054,1,0,61,0,-61
31055,1,0,69,0,-69
31056,0,0,0,0,0
31057,0,0,126,0,-126
31058,1,1,2612,1233,-1379
31059,1,1,173,1247,1074
31060,1,1,696,2227,1531
31061,0,0,26,0,-26
31062,1,1,1100,1217,117
31063,1,1,164,1225,1061
31064,1,0,7,0,-7
31065,1,1,1048,1432,384
31066,1,0,48,0,-48
31067,0,0,262,0,-262
31068,1,1,348,1496,1148
31069,0,0,6,0,-6
31070,0,0,75,0,-75
31071,0,0,22,0,-22
31072,1,1,1267,3147,1880
31073,0,0,35,0,-35
31074,1,0,43,0,-43
31075,0,0,12,0,-12
31076,0,0,123,0,-123
31077,1,0,16,0,-16
31078,0,0,11,0,-11
31079,1,1,1342,1310,-32
31080,1,0,56,0,-56
31081,1,1,251,1633,1382
31082,1,0,24,0,-24
31083,1,1,357,1780,1423
31084,0,0,90,0,-90
31085,0,0,42,0,-42
31086,1,1,1020,1228,208
31087,0,0,32,0,-32
31088,0,0,38,0,-38
31089,1,0,199,0,-199
31090,1,0,18,0,-18
31091,0,0,115,0,-115
31092,1,1,129,1390,1261
31093,1,1,1795,1317,-478
31094,1,1,644,1517,873
31095,0,0,15,0,-15
31096,0,0,11,0,-11
31097,0,0,34,0,-34
31098,0,0,40,0,-40
31099,1,1,1066,2576,1510
31100,0,0,15,0,-15
31101,0,0,147,0,-147
31102,1,0,1,0,-1
31103,1,0,13,0,-13
31104,1,1,474,1299,825
31105,1,1,36,2044,2008
31106,1,0,3,0,-3
31107,1,0,79,0,-79
31108,0,0,46,0,-46
31109,1,1,521,2944,2423
31110,1,1,813,1897,1084
31111,1,1,100,1588,1488
31112,1,1,1071,1304,233
31113,1,0,4,0,-4
31114,0,0,117,0,-117
31115,0,0,37,0,-37
31116,1,0,33,0,-33
31117,0,0,72,0,-72
31118,1,0,15,0,-15
31119,1,1,120,1783,1663
31120,1,0,37,0,-37
31121,1,1,761,3909,3148
31122,1,0,39,0,-39
31123,1,1,1277,1211,-66
31124,1,1,834,1236,402
31125,1,0,128,0,-128
31126,1,1,309,1304,995
31127,1,1,837,2212,1375
31128,1,0,7,0,-7
31129,0,0,105,0,-105
31130,1,1,131,2017,1886
31131,1,1,15,1407,1392
31132,1,1,1282,1319,37
31133,1,0,153,0,-153
31134,0,0,39,0,-39
31135,0,0,143,0,-143
31136,1,0,90,0,-90
31137,0,0,19,0,-19
31138,0,0,1,0,-1
31139,1,1,408,1326,918
31140,1,0,22,0,-22
31141,1,1,730,2235,1505
31142,0,0,5,0,-5
31143,1,1,150,1739,1589
31144,0,0,127,0,-127
31145,1,0,23,0,-23
31146,1,0,27,0,-27
31147,0,0,22,0,-22
31148,0,0,81,0,-81
31149,1,0,4,0,-4
31150,1,1,400,1481,1081
31151,0,0,19,0,-19
31152,1,1,780,1324,544
31153,1,0,11,0,-11
31154,1,0,26,0,-26
31155,1,1,268,1314,1046
31156,1,1,1150,1287,137
31157,1,0,3,0,-3
31158,0,0,54,0,-54
31159,0,0,131,0,-131
31160,0,0,43,0,-43
31161,0,0,104,0,-104
31162,0,0,58,0,-58
31163,1,1,259,1247,988
31164,0,0,5,0,-5
31165,1,1,260,1581,1321
31166,1,0,194,0,-194
31167,1,0,34,0,-34
31168,0,0,9,0,-9
31169,1,1,408,1287,879
31170,0,0,118,0,-118
31171,0,0,21,0,-21
31172,1,1,678,1604,926
31173,1,0,9,0,-9
31174,0,0,32,0,-32
31175,0,0,3,0,-3
31176,1,0,12,0,-12
31177,1,0,29,0,-29
31178,1,1,149,1306,1157
31179,0,0,255,0,-255
31180,0,0,11,0,-11
31181,0,0,109,0,-109
31182,0,0,26,0,-26
31183,0,0,33,0,-33
31184,1,1,631,1548,917
31185,0,0,0,0,0
31186,1,1,712,1534,822
31187,0,0,7,0,-7
31188,1,0,0,0,0
31189,0,0,4,0,-4
31190,0,0,20,0,-20
31191,1,1,1371,1884,513
31192,0,0,111,0,-111
31193,0,0,50,0,-50
31194,1,0,86,0,-86
31195,0,0,144,0,-144
31196,0,0,49,0,-49
31197,1,0,49,0,-49
31198,1,0,35,0,-35
31199,1,1,191,1209,1018
31200,0,0,4,0,-4
31201,1,0,77,0,-77
31202,1,0,61,0,-61
31203,1,1,78,1727,1649
31204,0,0,86,0,-86
31205,0,0,24,0,-24
31206,1,0,55,0,-55
31207,1,1,470,1470,1000
31208,0,0,22,0,-22
31209,1,1,397,1861,1464
31210,1,1,1026,1280,254
31211,0,0,85,0,-85
31212,0,0,156,0,-156
31213,1,0,78,0,-78
31214,1,0,6,0,-6
31215,1,1,262,1287,1025
31216,0,0,0,0,0
31217,0,0,23,0,-23
31218,0,0,42,0,-42
31219,1,0,17,0,-17
31220,0,0,2,0,-2
31221,0,0,33,0,-33
31222,0,0,92,0,-92
31223,1,1,566,1979,1413
31224,0,0,45,0,-45
31225,1,1,386,1374,988
31226,0,0,8,0,-8
31227,0,0,59,0,-59
31228,1,1,242,1828,1586
31229,1,0,28,0,-28
31230,0,0,113,0,-113
31231,1,0,28,0,-28
31232,0,0,134,0,-134
31233,0,0,63,0,-63
31234,0,0,32,0,-32
31235,0,0,56,0,-56
31236,1,0,3,0,-3
31237,1,0,26,0,-26
31238,1,1,1129,1373,244
31239,0,0,3,0,-3
31240,1,1,224,1344,1120
31241,0,0,20,0,-20
31242,0,0,26,0,-26
31243,1,0,68,0,-68
31244,0,0,88,0,-88
31245,0,0,32,0,-32
31246,1,1,124,1244,1120
31247,0,0,47,0,-47
31248,1,1,2037,1221,-816
31249,0,0,57,0,-57
31250,1,1,191,1244,1053
31251,0,0,131,0,-131
31252,1,1,169,1413,1244
31253,0,0,62,0,-62
31254,1,0,16,0,-16
31255,1,1,360,2067,1707
31256,1,1,850,1604,754
31257,0,0,94,0,-94
31258,1,0,53,0,-53
31259,1,1,106,1273,1167
31260,1,1,309,1354,1045
31261,1,0,45,0,-45
31262,1,1,1117,1946,829
31263,1,1,326,2026,1700
31264,1,1,1994,2162,168
31265,1,0,142,0,-142
31266,0,0,74,0,-74
31267,0,0,26,0,-26
31268,1,0,128,0,-128
31269,1,1,279,1591,1312
31270,1,0,49,0,-49
31271,0,0,180,0,-180
31272,0,0,50,0,-50
31273,1,0,0,0,0
31274,0,0,5,0,-5
31275,0,0,153,0,-153
31276,0,0,53,0,-53
31277,0,0,100,0,-100
31278,1,1,553,1345,792
31279,0,0,53,0,-53
31280,0,0,158,0,-158
31281,0,0,28,0,-28
31282,0,0,12,0,-12
31283,1,1,328,1628,1300
31284,1,0,18,0,-18
31285,0,0,0,0,0
31286,1,1,2384,1210,-1174
31287,0,0,68,0,-68
31288,1,1,341,1546,1205
31289,0,0,49,0,-49
31290,1,1,695,1238,543
31291,1,0,7,0,-7
31292,0,0,7,0,-7
31293,0,0,5,0,-5
31294,0,0,41,0,-41
31295,0,0,34,0,-34
31296,0,0,31,0,-31
31297,1,1,137,2461,2324
31298,0,0,4,0,-4
31299,1,0,1,0,-1
31300,0,0,65,0,-65
31301,1,1,572,1289,717
31302,0,0,31,0,-31
31303,1,1,750,1593,843
31304,1,1,468,1778,1310
31305,1,0,57,0,-57
31306,0,0,75,0,-75
31307,1,1,361,1341,980
31308,1,0,14,0,-14
31309,1,1,1735,1485,-250
31310,1,1,116,1574,1458
31311,1,0,14,0,-14
31312,1,1,123,1427,1304
31313,0,0,23,0,-23
31314,1,1,321,3801,3480
31315,0,0,18,0,-18
31316,1,0,11,0,-11
31317,1,0,36,0,-36
31318,1,1,187,1234,1047
31319,1,0,14,0,-14
31320,0,0,18,0,-18
31321,1,0,3,0,-3
31322,1,0,91,0,-91
31323,1,1,67,1797,1730
31324,1,1,2120,1233,-887
31325,1,1,2591,1347,-1244
31326,1,0,51,0,-51
31327,0,0,30,0,-30
31328,1,1,101,1201,1100
31329,1,1,442,1290,848
31330,1,1,315,1338,1023
31331,1,0,45,0,-45
31332,0,0,139,0,-139
31333,0,0,19,0,-19
31334,1,1,109,1834,1725
31335,0,0,21,0,-21
31336,1,1,636,1303,667
31337,1,0,31,0,-31
31338,0,0,34,0,-34
31339,1,0,36,0,-36
31340,1,0,42,0,-42
31341,1,1,508,1227,719
31342,0,0,52,0,-52
31343,0,0,140,0,-140
31344,0,0,27,0,-27
31345,1,1,468,1570,1102
31346,0,0,9,0,-9
31347,0,0,7,0,-7
31348,1,1,170,1625,1455
31349,1,1,2036,1541,-495
31350,0,0,4,0,-4
31351,1,1,144,1611,1467
31352,0,0,74,0,-74
31353,1,1,841,1402,561
31354,1,1,76,1284,1208
31355,1,1,137,1252,1115
31356,0,0,89,0,-89
31357,0,0,7,0,-7
31358,1,0,10,0,-10
31359,1,1,399,1434,1035
31360,1,0,7,0,-7
31361,1,0,47,0,-47
31362,1,0,46,0,-46
31363,0,0,6,0,-6
31364,1,0,175,0,-175
31365,0,0,278,0,-278
31366,1,1,178,1292,1114
31367,1,1,230,1421,1191
31368,0,0,49,0,-49
31369,0,0,188,0,-188
31370,0,0,54,0,-54
31371,0,0,47,0,-47
31372,1,0,25,0,-25
31373,0,0,25,0,-25
31374,1,0,159,0,-159
31375,1,0,18,0,-18
31376,1,0,26,0,-26
31377,0,0,60,0,-60
31378,0,0,54,0,-54
31379,0,0,55,0,-55
31380,0,0,32,0,-32
31381,1,0,5,0,-5
31382,1,1,30,5263,5233
31383,0,0,19,0,-19
31384,0,0,171,0,-171
31385,1,1,177,1500,1323
31386,1,0,28,0,-28
31387,0,0,96,0,-96
31388,0,0,92,0,-92
31389,0,0,103,0,-103
31390,1,0,24,0,-24
31391,1,1,123,1268,1145
31392,1,1,154,1954,1800
31393,1,1,712,1238,526
31394,1,0,18,0,-18
31395,1,0,11,0,-11
31396,0,0,98,0,-98
31397,0,0,4,0,-4
31398,0,0,18,0,-18
31399,1,1,198,2870,2672
31400,1,1,272,3579,3307
31401,0,0,88,0,-88
31402,0,0,184,0,-184
31403,0,0,10,0,-10
31404,1,1,45,1306,1261
31405,1,1,891,1229,338
31406,0,0,30,0,-30
31407,1,0,106,0,-106
31408,1,0,48,0,-48
31409,1,0,49,0,-49
31410,1,1,1595,2011,416
31411,1,0,27,0,-27
31412,1,1,203,1246,1043
31413,0,0,36,0,-36
31414,0,0,22,0,-22
31415,0,0,51,0,-51
31416,1,0,105,0,-105
31417,1,1,87,1204,1117
31418,1,1,438,1381,943
31419,1,1,265,1347,1082
31420,1,0,17,0,-17
31421,1,1,521,1208,687
31422,1,1,642,1307,665
31423,1,1,9,2003,1994
31424,0,0,10,0,-10
31425,1,0,6,0,-6
31426,1,0,35,0,-35
31427,1,1,98,1639,1541
31428,1,0,136,0,-136
31429,1,1,402,1232,830
31430,1,0,92,0,-92
31431,1,1,315,1800,1485
31432,0,0,14,0,-14
31433,1,1,1965,2621,656
31434,1,0,79,0,-79
31435,1,0,74,0,-74
31436,0,0,29,0,-29
31437,1,0,25,0,-25
31438,1,0,105,0,-105
31439,1,0,18,0,-18
31440,1,0,92,0,-92
31441,1,1,290,1340,1050
31442,1,1,375,1472,1097
31443,0,0,124,0,-124
31444,1,0,41,0,-41
31445,0,0,287,0,-287
31446,1,1,1557,1392,-165
31447,1,1,697,1483,786
31448,0,0,46,0,-46
31449,1,1,64,1512,1448
31450,1,1,248,1314,1066
31451,0,0,31,0,-31
31452,1,1,603,2575,1972
31453,1,0,25,0,-25
31454,1,0,47,0,-47
31455,0,0,0,0,0
31456,1,1,330,1344,1014
31457,1,1,2496,1482,-1014
31458,1,0,40,0,-40
31459,0,0,67,0,-67
31460,1,0,66,0,-66
31461,1,1,168,1660,1492
31462,1,0,34,0,-34
31463,1,0,20,0,-20
31464,1,1,1092,1247,155
31465,0,0,37,0,-37
31466,0,0,2,0,-2
31467,0,0,16,0,-16
31468,1,0,64,0,-64
31469,1,1,365,1215,850
31470,1,0,37,0,-37
31471,1,1,424,1447,1023
31472,1,1,548,1392,844
31473,1,0,43,0,-43
31474,0,0,21,0,-21
31475,0,0,45,0,-45
31476,1,1,336,1217,881
31477,0,0,6,0,-6
31478,0,0,56,0,-56
31479,0,0,7,0,-7
31480,1,0,25,0,-25
31481,0,0,36,0,-36
31482,1,0,9,0,-9
31483,0,0,3,0,-3
31484,0,0,99,0,-99
31485,1,1,419,1400,981
31486,0,0,25,0,-25
31487,1,1,909,1200,291
31488,1,1,13,1729,1716
31489,1,1,99,1860,1761
31490,0,0,7,0,-7
31491,0,0,39,0,-39
31492,1,1,183,1579,1396
31493,0,0,1,0,-1
31494,1,0,14,0,-14
31495,0,0,55,0,-55
31496,1,0,0,0,0
31497,0,0,44,0,-44
31498,1,0,64,0,-64
31499,0,0,43,0,-43
31500,0,0,1,0,-1
31501,1,0,28,0,-28
31502,0,0,14,0,-14
31503,1,0,30,0,-30
31504,0,0,73,0,-73
31505,1,0,2,0,-2
31506,1,0,52,0,-52
31507,1,1,205,2151,1946
31508,1,0,188,0,-188
31509,0,0,32,0,-32
31510,1,1,385,1627,1242
31511,1,0,18,0,-18
31512,1,1,451,1605,1154
31513,0,0,8,0,-8
31514,1,0,1,0,-1
31515,0,0,32,0,-32
31516,1,0,1,0,-1
31517,1,0,35,0,-35
31518,0,0,60,0,-60
31519,0,0,65,0,-65
31520,0,0,30,0,-30
31521,1,1,459,1315,856
31522,0,0,202,0,-202
31523,1,0,7,0,-7
31524,1,1,1233,1518,285
31525,1,1,1979,1271,-708
31526,0,0,38,0,-38
31527,0,0,32,0,-32
31528,0,0,48,0,-48
31529,1,0,81,0,-81
31530,1,0,190,0,-190
31531,1,1,255,1464,1209
31532,1,0,92,0,-92
31533,0,0,35,0,-35
31534,0,0,28,0,-28
31535,0,0,19,0,-19
31536,1,1,479,1303,824
31537,1,0,74,0,-74
31538,1,0,100,0,-100
31539,1,1,464,1348,884
31540,0,0,98,0,-98
31541,1,0,51,0,-51
31542,1,0,51,0,-51
31543,1,0,32,0,-32
31544,1,1,1164,1201,37
31545,1,0,6,0,-6
31546,0,0,15,0,-15
31547,1,0,29,0,-29
31548,1,0,41,0,-41
31549,1,0,6,0,-6
31550,0,0,16,0,-16
31551,0,0,8,0,-8
31552,0,0,70,0,-70
31553,1,0,67,0,-67
31554,1,0,36,0,-36
31555,0,0,8,0,-8
31556,1,0,36,0,-36
31557,0,0,26,0,-26
31558,0,0,57,0,-57
31559,1,0,47,0,-47
31560,0,0,16,0,-16
31561,1,0,115,0,-115
31562,0,0,43,0,-43
31563,0,0,35,0,-35
31564,0,0,3,0,-3
31565,1,0,16,0,-16
31566,0,0,113,0,-113
31567,1,1,620,2399,1779
31568,1,0,29,0,-29
31569,1,1,164,1455,1291
31570,1,1,101,1332,1231
31571,0,0,8,0,-8
31572,1,1,113,1737,1624
31573,1,1,1309,1384,75
31574,0,0,56,0,-56
31575,1,0,23,0,-23
31576,1,0,45,0,-45
31577,0,0,70,0,-70
31578,0,0,37,0,-37
31579,1,1,1525,1206,-319
31580,1,0,8,0,-8
31581,1,1,1024,2168,1144
31582,0,0,3,0,-3
31583,0,0,0,0,0
31584,1,1,678,1756,1078
31585,0,0,14,0,-14
31586,1,0,64,0,-64
31587,0,0,50,0,-50
31588,1,0,94,0,-94
31589,0,0,44,0,-44
31590,0,0,183,0,-183
31591,0,0,100,0,-100
31592,0,0,6,0,-6
31593,1,1,221,3347,3126
31594,1,1,1120,1535,415
31595,1,1,318,1228,910
31596,1,1,213,1537,1324
31597,0,0,14,0,-14
31598,0,0,74,0,-74
31599,0,0,19,0,-19
31600,1,1,256,1777,1521
31601,1,1,868,1593,725
31602,0,0,16,0,-16
31603,1,0,31,0,-31
31604,1,0,10,0,-10
31605,0,0,118,0,-118
31606,1,1,757,1360,603
31607,1,1,159,2222,2063
31608,1,1,270,1389,1119
31609,1,0,29,0,-29
31610,1,1,189,1314,1125
31611,0,0,116,0,-116
31612,1,1,287,1919,1632
31613,1,0,27,0,-27
31614,1,0,59,0,-59
31615,0,0,133,0,-133
31616,1,1,119,1494,1375
31617,0,0,78,0,-78
31618,0,0,43,0,-43
31619,0,0,37,0,-37
31620,0,0,11,0,-11
31621,0,0,27,0,-27
31622,1,1,459,1373,914
31623,0,0,28,0,-28
31624,0,0,51,0,-51
31625,1,0,156,0,-156
31626,0,0,77,0,-77
31627,1,0,183,0,-183
31628,0,0,208,0,-208
31629,0,0,61,0,-61
31630,0,0,35,0,-35
31631,0,0,36,0,-36
31632,0,0,11,0,-11
31633,0,0,97,0,-97
31634,1,1,708,1392,684
31635,0,0,10,0,-10
31636,1,0,0,0,0
31637,0,0,74,0,-74
31638,1,1,257,2163,1906
31639,1,1,495,1232,737
31640,0,0,16,0,-16
31641,0,0,21,0,-21
31642,1,1,592,1222,630
31643,1,0,96,0,-96
31644,1,0,0,0,0
31645,1,0,33,0,-33
31646,1,1,252,1374,1122
31647,1,0,2,0,-2
31648,1,1,554,1386,832
31649,1,0,58,0,-58
31650,1,0,111,0,-111
31651,1,1,208,1473,1265
31652,1,1,291,1500,1209
31653,0,0,15,0,-15
31654,1,0,84,0,-84
31655,0,0,83,0,-83
31656,1,1,112,1427,1315
31657,0,0,11,0,-11
31658,0,0,38,0,-38
31659,0,0,40,0,-40
31660,1,0,66,0,-66
31661,1,0,3,0,-3
31662,0,0,16,0,-16
31663,1,0,10,0,-10
31664,0,0,122,0,-122
31665,1,1,521,1238,717
31666,1,0,92,0,-92
31667,1,0,17,0,-17
31668,1,0,84,0,-84
31669,1,0,121,0,-121
31670,0,0,39,0,-39
31671,1,0,99,0,-99
31672,1,0,38,0,-38
31673,0,0,68,0,-68
31674,1,1,884,1324,440
31675,1,0,111,0,-111
31676,0,0,32,0,-32
31677,0,0,23,0,-23
31678,1,0,32,0,-32
31679,0,0,8,0,-8
31680,1,0,47,0,-47
31681,0,0,10,0,-10
31682,1,0,2,0,-2
31683,1,1,245,1278,1033
31684,1,1,295,1638,1343
31685,0,0,31,0,-31
31686,1,0,9,0,-9
31687,0,0,81,0,-81
31688,1,1,609,1629,1020
31689,1,0,0,0,0
31690,1,0,0,0,0
31691,1,1,1422,1824,402
31692,1,1,72,1242,1170
31693,1,0,107,0,-107
31694,1,1,287,1427,1140
31695,1,1,812,3355,2543
31696,1,1,509,1341,832
31697,1,0,63,0,-63
31698,1,1,1863,1278,-585
31699,1,0,49,0,-49
31700,1,0,156,0,-156
31701,1,0,7,0,-7
31702,1,1,98,1215,1117
31703,1,0,10,0,-10
31704,1,0,328,0,-328
31705,0,0,57,0,-57
31706,1,0,56,0,-56
31707,0,0,3,0,-3
31708,0,0,0,0,0
31709,1,1,1203,1393,190
31710,0,0,0,0,0
31711,1,0,15,0,-15
31712,1,0,7,0,-7
31713,0,0,60,0,-60
31714,0,0,212,0,-212
31715,1,1,113,1433,1320
31716,1,1,218,1335,1117
31717,1,0,3,0,-3
31718,1,0,144,0,-144
31719,1,1,422,1672,1250
31720,1,1,1055,1345,290
31721,1,1,2835,2131,-704
31722,1,0,16,0,-16
31723,1,1,37,1263,1226
31724,0,0,2,0,-2
31725,0,0,189,0,-189
31726,1,0,1,0,-1
31727,1,0,64,0,-64
31728,1,1,859,1496,637
31729,0,0,38,0,-38
31730,1,0,27,0,-27
31731,1,1,395,1539,1144
31732,0,0,4,0,-4
31733,0,0,8,0,-8
31734,1,0,98,0,-98
31735,1,1,1208,1538,330
31736,0,0,0,0,0
31737,1,1,185,1209,1024
31738,1,0,142,0,-142
31739,0,0,7,0,-7
31740,1,1,236,2202,1966
31741,1,1,118,2079,1961
31742,0,0,4,0,-4
31743,1,1,234,1339,1105
31744,1,1,86,4203,4117
31745,1,0,91,0,-91
31746,0,0,24,0,-24
31747,0,0,2,0,-2
31748,0,0,59,0,-59
31749,1,0,11,0,-11
31750,1,1,234,1960,1726
31751,1,1,338,1625,1287
31752,1,1,186,1220,1034
31753,1,0,58,0,-58
31754,0,0,35,0,-35
31755,1,1,86,1415,1329
31756,1,1,186,1251,1065
31757,1,1,706,1489,783
31758,1,0,36,0,-36
31759,1,1,826,1264,438
31760,1,1,128,1699,1571
31761,1,0,7,0,-7
31762,1,0,3,0,-3
31763,1,0,45,0,-45
31764,0,0,101,0,-101
31765,1,0,100,0,-100
31766,0,0,80,0,-80
31767,1,1,81,1353,1272
31768,1,0,56,0,-56
31769,1,1,100,1328,1228
31770,1,1,120,1821,1701
31771,1,1,503,1552,1049
31772,1,1,216,1295,1079
31773,0,0,31,0,-31
31774,0,0,17,0,-17
31775,0,0,14,0,-14
31776,1,1,44,2845,2801
31777,1,0,62,0,-62
31778,1,0,66,0,-66
31779,1,1,212,1222,1010
31780,0,0,16,0,-16
31781,1,0,72,0,-72
31782,0,0,12,0,-12
31783,1,1,247,2463,2216
31784,1,0,75,0,-75
31785,1,1,98,1597,1499
31786,1,1,380,1315,935
31787,1,0,15,0,-15
31788,0,0,2,0,-2
31789,0,0,4,0,-4
31790,0,0,129,0,-129
31791,0,0,4,0,-4
31792,0,0,119,0,-119
31793,1,0,51,0,-51
31794,1,1,531,1820,1289
31795,1,0,39,0,-39
31796,0,0,12,0,-12
31797,1,0,5,0,-5
31798,1,0,7,0,-7
31799,1,1,364,1384,1020
31800,1,0,8,0,-8
31801,1,1,236,1878,1642
31802,0,0,16,0,-16
31803,1,1,1197,1346,149
31804,1,1,847,1309,462
31805,1,1,1046,2752,1706
31806,0,0,14,0,-14
31807,1,1,796,1357,561
31808,0,0,70,0,-70
31809,0,0,84,0,-84
31810,0,0,1,0,-1
31811,0,0,43,0,-43
31812,1,0,1,0,-1
31813,0,0,58,0,-58
31814,1,1,273,1228,955
31815,0,0,13,0,-13
31816,1,0,43,0,-43
31817,1,1,602,1501,899
31818,1,1,112,1372,1260
31819,1,0,95,0,-95
31820,1,0,2,0,-2
31821,0,0,3,0,-3
31822,0,0,54,0,-54
31823,1,0,2,0,-2
31824,0,0,9,0,-9
31825,1,1,108,1680,1572
31826,1,0,49,0,-49
31827,1,0,37,0,-37
31828,1,0,26,0,-26
31829,0,0,5,0,-5
31830,0,0,44,0,-44
31831,0,0,27,0,-27
31832,1,0,0,0,0
31833,1,0,92,0,-92
31834,1,0,148,0,-148
31835,0,0,13,0,-13
31836,0,0,26,0,-26
31837,0,0,49,0,-49
31838,0,0,121,0,-121
31839,0,0,50,0,-50
31840,1,1,426,1486,1060
31841,1,0,14,0,-14
31842,0,0,69,0,-69
31843,1,0,91,0,-91
31844,1,0,181,0,-181
31845,1,0,9,0,-9
31846,0,0,41,0,-41
31847,1,1,885,1557,672
31848,1,1,240,1308,1068
31849,1,0,113,0,-113
31850,1,0,65,0,-65
31851,0,0,92,0,-92
31852,0,0,88,0,-88
31853,0,0,15,0,-15
31854,1,1,757,1607,850
31855,1,0,31,0,-31
31856,0,0,34,0,-34
31857,1,0,134,0,-134
31858,1,1,205,1201,996
31859,1,0,67,0,-67
31860,1,1,51,1668,1617
31861,1,1,401,1307,906
31862,0,0,44,0,-44
31863,0,0,77,0,-77
31864,1,1,11,1533,1522
31865,1,1,679,1437,758
31866,1,0,32,0,-32
31867,1,0,33,0,-33
31868,1,1,461,1529,1068
31869,0,0,42,0,-42
31870,0,0,0,0,0
31871,0,0,83,0,-83
31872,1,0,2,0,-2
31873,0,0,76,0,-76
31874,1,0,51,0,-51
31875,1,0,97,0,-97
31876,0,0,18,0,-18
31877,1,0,37,0,-37
31878,0,0,115,0,-115
31879,0,0,87,0,-87
31880,1,0,94,0,-94
31881,1,1,1467,1206,-261
31882,1,0,3,0,-3
31883,0,0,4,0,-4
31884,1,1,1410,1258,-152
31885,1,0,3,0,-3
31886,1,0,54,0,-54
31887,0,0,34,0,-34
31888,1,1,309,2512,2203
31889,1,1,2544,1272,-1272
31890,1,0,11,0,-11
31891,1,0,9,0,-9
31892,1,0,23,0,-23
31893,1,1,293,1997,1704
31894,0,0,66,0,-66
31895,1,1,289,2243,1954
31896,0,0,357,0,-357
31897,0,0,20,0,-20
31898,0,0,47,0,-47
31899,0,0,43,0,-43
31900,0,0,101,0,-101
31901,0,0,88,0,-88
31902,1,0,45,0,-45
31903,1,0,32,0,-32
31904,1,0,18,0,-18
31905,0,0,4,0,-4
31906,0,0,21,0,-21
31907,1,1,805,1352,547
31908,1,0,74,0,-74
31909,1,0,99,0,-99
31910,1,0,6,0,-6
31911,1,0,5,0,-5
31912,1,0,18,0,-18
31913,1,0,43,0,-43
31914,1,1,193,1251,1058
31915,0,0,54,0,-54
31916,0,0,107,0,-107
31917,0,0,52,0,-52
31918,0,0,34,0,-34
31919,0,0,174,0,-174
31920,1,0,11,0,-11
31921,1,1,256,1391,1135
31922,1,0,18,0,-18
31923,0,0,8,0,-8
31924,1,0,43,0,-43
31925,0,0,26,0,-26
31926,1,1,119,1625,1506
31927,1,0,27,0,-27
31928,1,0,9,0,-9
31929,1,1,633,3405,2772
31930,0,0,14,0,-14
31931,1,1,1451,1726,275
31932,1,0,12,0,-12
31933,0,0,169,0,-169
31934,1,0,25,0,-25
31935,1,0,8,0,-8
31936,0,0,67,0,-67
31937,1,1,276,1205,929
31938,1,1,105,1391,1286
31939,0,0,52,0,-52
31940,1,1,487,1366,879
31941,0,0,172,0,-172
31942,1,0,101,0,-101
31943,1,0,19,0,-19
31944,1,1,379,2003,1624
31945,1,1,430,1921,1491
31946,0,0,9,0,-9
31947,0,0,92,0,-92
31948,1,1,107,1225,1118
31949,0,0,36,0,-36
31950,0,0,0,0,0
31951,0,0,65,0,-65
31952,1,1,522,1682,1160
31953,1,0,75,0,-75
31954,1,1,349,1497,1148
31955,1,1,821,1342,521
31956,0,0,18,0,-18
31957,0,0,32,0,-32
31958,1,0,55,0,-55
31959,1,1,276,1787,1511
31960,0,0,12,0,-12
31961,0,0,0,0,0
31962,0,0,55,0,-55
31963,1,0,61,0,-61
31964,1,0,24,0,-24
31965,1,1,580,1549,969
31966,1,1,686,1557,871
31967,1,1,289,1650,1361
31968,1,1,57,1269,1212
31969,1,1,410,1306,896
31970,1,1,554,1376,822
31971,1,1,720,2587,1867
31972,1,1,541,1805,1264
31973,1,1,815,1340,525
31974,1,0,33,0,-33
31975,1,0,67,0,-67
31976,0,0,331,0,-331
31977,1,1,560,4031,3471
31978,1,1,78,1317,1239
31979,1,1,2280,1359,-921
31980,0,0,151,0,-151
31981,1,1,1268,2106,838
31982,0,0,82,0,-82
31983,1,0,39,0,-39
31984,1,1,422,1922,1500
31985,0,0,22,0,-22
31986,0,0,148,0,-148
31987,0,0,150,0,-150
31988,1,1,128,1229,1101
31989,0,0,36,0,-36
31990,0,0,19,0,-19
31991,1,1,298,1980,1682
31992,1,0,29,0,-29
31993,0,0,34,0,-34
31994,1,0,6,0,-6
31995,1,0,61,0,-61
31996,1,0,22,0,-22
31997,0,0,15,0,-15
31998,1,0,23,0,-23
31999,0,0,56,0,-56
32000,1,1,561,1314,753
32001,0,0,1,0,-1
32002,1,0,91,0,-91
32003,1,1,700,1790,1090
32004,1,1,760,2105,1345
32005,1,1,2066,1240,-826
32006,1,1,266,1201,935
32007,1,0,60,0,-60
32008,1,1,995,1497,502
32009,1,0,58,0,-58
32010,1,1,177,1977,1800
32011,0,0,61,0,-61
32012,0,0,22,0,-22
32013,0,0,13,0,-13
32014,1,1,238,1784,1546
32015,0,0,16,0,-16
32016,1,0,131,0,-131
32017,1,1,145,1515,1370
32018,1,0,92,0,-92
32019,0,0,139,0,-139
32020,0,0,7,0,-7
32021,0,0,121,0,-121
32022,1,0,14,0,-14
32023,1,0,31,0,-31
32024,0,0,30,0,-30
32025,0,0,1,0,-1
32026,1,0,180,0,-180
32027,1,0,39,0,-39
32028,1,0,15,0,-15
32029,0,0,1,0,-1
32030,0,0,12,0,-12
32031,0,0,37,0,-37
32032,1,0,73,0,-73
32033,0,0,4,0,-4
32034,0,0,102,0,-102
32035,0,0,72,0,-72
32036,0,0,3,0,-3
32037,0,0,41,0,-41
32038,1,0,62,0,-62
32039,1,1,380,1217,837
32040,1,0,38,0,-38
32041,1,0,100,0,-100
32042,0,0,14,0,-14
32043,0,0,89,0,-89
32044,0,0,31,0,-31
32045,0,0,4,0,-4
32046,1,0,7,0,-7
32047,0,0,41,0,-41
32048,0,0,49,0,-49
32049,0,0,58,0,-58
32050,1,0,104,0,-104
32051,1,0,11,0,-11
32052,1,0,71,0,-71
32053,1,1,51,1490,1439
32054,1,0,23,0,-23
32055,0,0,49,0,-49
32056,0,0,25,0,-25
32057,1,0,76,0,-76
32058,1,1,245,1574,1329
32059,1,0,14,0,-14
32060,1,0,12,0,-12
32061,1,0,5,0,-5
32062,0,0,47,0,-47
32063,1,0,21,0,-21
32064,0,0,152,0,-152
32065,1,1,399,3656,3257
32066,1,1,223,1257,1034
32067,0,0,1,0,-1
32068,0,0,43,0,-43
32069,0,0,40,0,-40
32070,1,1,1476,4293,2817
32071,1,1,1538,1263,-275
32072,0,0,25,0,-25
32073,1,1,410,1221,811
32074,0,0,11,0,-11
32075,1,1,326,1253,927
32076,0,0,11,0,-11
32077,1,1,151,1436,1285
32078,1,0,18,0,-18
32079,0,0,23,0,-23
32080,1,1,160,1310,1150
32081,1,1,628,1674,1046
32082,1,1,556,1397,841
32083,1,0,20,0,-20
32084,0,0,45,0,-45
32085,0,0,43,0,-43
32086,1,1,645,1332,687
32087,0,0,33,0,-33
32088,0,0,12,0,-12
32089,0,0,10,0,-10
32090,1,1,12,1981,1969
32091,1,0,20,0,-20
32092,0,0,130,0,-130
32093,1,1,322,1557,1235
32094,0,0,95,0,-95
32095,0,0,11,0,-11
32096,0,0,86,0,-86
32097,1,0,74,0,-74
32098,1,0,11,0,-11
32099,0,0,2,0,-2
32100,1,0,77,0,-77
32101,1,1,459,1946,1487
32102,0,0,156,0,-156
32103,1,1,836,1234,398
32104,1,1,219,2545,2326
32105,0,0,41,0,-41
32106,1,1,528,1830,1302
32107,1,1,291,1750,1459
32108,0,0,108,0,-108
32109,1,0,85,0,-85
32110,1,0,39,0,-39
32111,1,1,268,1930,1662
32112,0,0,21,0,-21
32113,0,0,15,0,-15
32114,1,0,18,0,-18
32115,1,1,325,1395,1070
32116,0,0,72,0,-72
32117,0,0,123,0,-123
32118,1,0,14,0,-14
32119,1,1,606,1737,1131
32120,1,0,44,0,-44
32121,1,1,100,1389,1289
32122,0,0,56,0,-56
32123,1,0,4,0,-4
32124,1,0,38,0,-38
32125,1,0,12,0,-12
32126,1,1,402,1946,1544
32127,1,1,171,3360,3189
32128,0,0,22,0,-22
32129,0,0,12,0,-12
32130,0,0,78,0,-78
32131,1,0,68,0,-68
32132,0,0,43,0,-43
32133,1,1,771,1278,507
32134,1,0,16,0,-16
32135,0,0,70,0,-70
32136,0,0,86,0,-86
32137,1,1,1025,1233,208
32138,0,0,18,0,-18
32139,1,1,321,1550,1229
32140,0,0,15,0,-15
32141,1,0,15,0,-15
32142,0,0,40,0,-40
32143,1,1,167,1393,1226
32144,0,0,13,0,-13
32145,1,0,17,0,-17
32146,1,1,77,2153,2076
32147,1,1,211,1291,1080
32148,0,0,12,0,-12
32149,1,0,48,0,-48
32150,0,0,8,0,-8
32151,1,0,10,0,-10
32152,1,0,25,0,-25
32153,0,0,32,0,-32
32154,1,1,309,1413,1104
32155,1,0,40,0,-40
32156,1,0,81,0,-81
32157,0,0,21,0,-21
32158,0,0,2,0,-2
32159,1,0,124,0,-124
32160,1,0,11,0,-11
32161,1,1,65,1436,1371
32162,0,0,2,0,-2
32163,1,1,204,2778,2574
32164,1,1,771,1571,800
32165,0,0,15,0,-15
32166,0,0,0,0,0
32167,1,0,21,0,-21
32168,1,0,6,0,-6
32169,1,1,110,1694,1584
32170,0,0,26,0,-26
32171,0,0,32,0,-32
32172,1,1,266,1227,961
32173,1,1,603,1215,612
32174,0,0,28,0,-28
32175,1,0,14,0,-14
32176,0,0,169,0,-169
32177,1,1,187,1539,1352
32178,1,1,316,1227,911
32179,1,0,70,0,-70
32180,1,1,128,1858,1730
32181,1,0,9,0,-9
32182,1,0,10,0,-10
32183,0,0,53,0,-53
32184,0,0,26,0,-26
32185,1,0,126,0,-126
32186,1,0,106,0,-106
32187,1,0,3,0,-3
32188,0,0,32,0,-32
32189,1,0,91,0,-91
32190,1,1,302,1606,1304
32191,1,1,157,2150,1993
32192,1,0,1,0,-1
32193,1,1,736,1762,1026
32194,0,0,8,0,-8
32195,1,1,897,2244,1347
32196,1,1,718,1233,515
32197,1,1,9,2145,2136
32198,0,0,68,0,-68
32199,0,0,6,0,-6
32200,1,0,55,0,-55
32201,1,0,39,0,-39
32202,0,0,60,0,-60
32203,0,0,10,0,-10
32204,0,0,42,0,-42
32205,0,0,84,0,-84
32206,1,1,177,1297,1120
32207,1,0,103,0,-103
32208,1,1,176,1313,1137
32209,1,0,22,0,-22
32210,1,0,6,0,-6
32211,0,0,8,0,-8
32212,1,0,24,0,-24
32213,0,0,67,0,-67
32214,0,0,31,0,-31
32215,1,0,37,0,-37
32216,1,0,16,0,-16
32217,0,0,76,0,-76
32218,1,0,193,0,-193
32219,1,1,606,1233,627
32220,1,0,13,0,-13
32221,1,0,24,0,-24
32222,0,0,116,0,-116
32223,1,1,1327,3658,2331
32224,0,0,284,0,-284
32225,1,0,34,0,-34
32226,0,0,47,0,-47
32227,0,0,2,0,-2
32228,0,0,13,0,-13
32229,1,0,19,0,-19
32230,0,0,59,0,-59
32231,1,1,329,1301,972
32232,1,0,9,0,-9
32233,1,1,407,2043,1636
32234,0,0,154,0,-154
32235,0,0,3,0,-3
32236,0,0,90,0,-90
32237,1,0,50,0,-50
32238,1,1,251,1358,1107
32239,1,0,10,0,-10
32240,1,1,420,2471,2051
32241,1,0,48,0,-48
32242,1,1,171,1644,1473
32243,1,0,9,0,-9
32244,0,0,97,0,-97
32245,1,1,1328,1965,637
32246,0,0,29,0,-29
32247,1,0,37,0,-37
32248,1,1,530,1284,754
32249,0,0,50,0,-50
32250,1,0,8,0,-8
32251,0,0,1,0,-1
32252,0,0,170,0,-170
32253,1,1,520,1228,708
32254,0,0,134,0,-134
32255,1,1,713,1596,883
32256,0,0,40,0,-40
32257,1,1,970,1340,370
32258,0,0,27,0,-27
32259,0,0,63,0,-63
32260,1,0,6,0,-6
32261,1,1,232,1350,1118
32262,1,1,72,1275,1203
32263,1,0,8,0,-8
32264,0,0,23,0,-23
32265,0,0,69,0,-69
32266,1,0,4,0,-4
32267,1,1,348,1706,1358
32268,0,0,1,0,-1
32269,0,0,247,0,-247
32270,1,0,7,0,-7
32271,1,0,23,0,-23
32272,1,1,177,1434,1257
32273,1,1,149,1364,1215
32274,0,0,66,0,-66
32275,1,0,31,0,-31
32276,0,0,57,0,-57
32277,1,0,28,0,-28
32278,0,0,14,0,-14
32279,1,1,331,1285,954
32280,1,1,335,1288,953
32281,1,1,355,1843,1488
32282,1,0,41,0,-41
32283,1,1,256,1359,1103
32284,0,0,128,0,-128
32285,1,1,1575,1278,-297
32286,0,0,39,0,-39
32287,0,0,26,0,-26
32288,0,0,11,0,-11
32289,1,1,375,1872,1497
32290,1,0,103,0,-103
32291,1,0,26,0,-26
32292,0,0,2,0,-2
32293,1,0,19,0,-19
32294,1,1,2404,2655,251
32295,1,1,119,1436,1317
32296,1,0,2,0,-2
32297,1,1,836,1285,449
32298,1,1,233,1378,1145
32299,0,0,145,0,-145
32300,1,0,405,0,-405
32301,1,1,981,1210,229
32302,0,0,62,0,-62
32303,1,0,29,0,-29
32304,1,1,573,1729,1156
32305,1,0,50,0,-50
32306,1,0,196,0,-196
32307,1,0,1,0,-1
32308,1,1,121,2019,1898
32309,1,1,758,1469,711
32310,1,0,4,0,-4
32311,0,0,133,0,-133
32312,1,0,4,0,-4
32313,0,0,63,0,-63
32314,0,0,13,0,-13
32315,1,0,71,0,-71
32316,0,0,12,0,-12
32317,1,1,1793,1813,20
32318,1,0,24,0,-24
32319,1,0,8,0,-8
32320,1,0,76,0,-76
32321,0,0,4,0,-4
32322,1,0,135,0,-135
32323,0,0,10,0,-10
32324,1,1,1146,1454,308
32325,1,0,14,0,-14
32326,0,0,8,0,-8
32327,1,1,1381,1567,186
32328,1,0,28,0,-28
32329,1,1,1038,1764,726
32330,1,0,65,0,-65
32331,1,1,398,1583,1185
32332,1,1,316,1636,1320
32333,1,0,16,0,-16
32334,1,0,0,0,0
32335,0,0,6,0,-6
32336,1,1,85,2021,1936
32337,1,1,430,1253,823
32338,0,0,55,0,-55
32339,1,0,21,0,-21
32340,1,0,63,0,-63
32341,0,0,131,0,-131
32342,1,0,22,0,-22
32343,0,0,10,0,-10
32344,0,0,1,0,-1
32345,1,0,44,0,-44
32346,1,0,24,0,-24
32347,0,0,19,0,-19
32348,1,1,129,1456,1327
32349,1,0,5,0,-5
32350,1,0,20,0,-20
32351,1,0,2,0,-2
32352,0,0,23,0,-23
32353,1,1,2175,1278,-897
32354,1,0,149,0,-149
32355,0,0,24,0,-24
32356,1,1,305,1639,1334
32357,1,1,611,1619,1008
32358,0,0,11,0,-11
32359,1,0,105,0,-105
32360,1,1,59,1692,1633
32361,1,1,574,1888,1314
32362,1,1,1526,1605,79
32363,0,0,17,0,-17
32364,0,0,100,0,-100
32365,1,0,38,0,-38
32366,0,0,213,0,-213
32367,1,0,13,0,-13
32368,1,0,29,0,-29
32369,1,0,11,0,-11
32370,1,1,136,1237,1101
32371,1,1,178,1523,1345
32372,1,1,77,1924,1847
32373,1,1,1643,1267,-376
32374,0,0,4,0,-4
32375,1,0,19,0,-19
32376,1,0,35,0,-35
32377,0,0,9,0,-9
32378,0,0,102,0,-102
32379,1,0,62,0,-62
32380,1,1,472,1493,1021
32381,1,1,824,1479,655
32382,0,0,16,0,-16
32383,1,0,51,0,-51
32384,0,0,20,0,-20
32385,0,0,2,0,-2
32386,0,0,13,0,-13
32387,0,0,132,0,-132
32388,1,1,363,2432,2069
32389,1,0,85,0,-85
32390,0,0,18,0,-18
32391,0,0,219,0,-219
32392,0,0,78,0,-78
32393,1,0,4,0,-4
32394,1,1,192,1309,1117
32395,0,0,45,0,-45
32396,1,1,1151,1747,596
32397,1,1,120,1218,1098
32398,0,0,17,0,-17
32399,1,1,3211,1202,-2009
32400,0,0,105,0,-105
32401,1,1,1159,1211,52
32402,0,0,16,0,-16
32403,1,1,446,1383,937
32404,1,0,91,0,-91
32405,1,0,7,0,-7
32406,0,0,2,0,-2
32407,1,0,29,0,-29
32408,0,0,32,0,-32
32409,1,1,779,1615,836
32410,1,0,89,0,-89
32411,0,0,117,0,-117
32412,1,1,628,2650,2022
32413,0,0,31,0,-31
32414,0,0,1,0,-1
32415,1,0,21,0,-21
32416,0,0,12,0,-12
32417,1,0,3,0,-3
32418,0,0,12,0,-12
32419,1,1,541,1250,709
32420,0,0,5,0,-5
32421,0,0,20,0,-20
32422,1,1,48,1275,1227
32423,1,1,1658,2294,636
32424,1,0,21,0,-21
32425,0,0,7,0,-7
32426,1,1,123,1266,1143
32427,1,0,52,0,-52
32428,0,0,81,0,-81
32429,1,0,134,0,-134
32430,0,0,22,0,-22
32431,0,0,46,0,-46
32432,1,1,247,5711,5464
32433,0,0,51,0,-51
32434,1,0,63,0,-63
32435,1,0,21,0,-21
32436,1,1,1187,1227,40
32437,0,0,65,0,-65
32438,1,0,2,0,-2
32439,1,0,32,0,-32
32440,1,1,788,1879,1091
32441,0,0,91,0,-91
32442,0,0,72,0,-72
32443,0,0,128,0,-128
32444,1,0,11,0,-11
32445,1,1,733,1225,492
32446,1,1,650,1580,930
32447,0,0,13,0,-13
32448,0,0,88,0,-88
32449,1,1,731,1640,909
32450,0,0,12,0,-12
32451,0,0,121,0,-121
32452,0,0,65,0,-65
32453,1,1,786,2440,1654
32454,0,0,47,0,-47
32455,1,0,12,0,-12
32456,1,0,88,0,-88
32457,0,0,8,0,-8
32458,1,1,605,1277,672
32459,0,0,86,0,-86
32460,1,1,738,1228,490
32461,0,0,9,0,-9
32462,1,1,231,1233,1002
32463,1,1,939,2407,1468
32464,1,1,166,1282,1116
32465,0,0,17,0,-17
32466,0,0,74,0,-74
32467,0,0,17,0,-17
32468,1,1,150,2319,2169
32469,1,1,271,1710,1439
32470,1,0,78,0,-78
32471,0,0,17,0,-17
32472,1,1,299,1331,1032
32473,1,0,52,0,-52
32474,0,0,3,0,-3
32475,0,0,45,0,-45
32476,0,0,19,0,-19
32477,0,0,93,0,-93
32478,1,1,1269,1633,364
32479,0,0,36,0,-36
32480,1,0,141,0,-141
32481,0,0,59,0,-59
32482,1,0,22,0,-22
32483,0,0,41,0,-41
32484,0,0,1,0,-1
32485,0,0,9,0,-9
32486,0,0,91,0,-91
32487,0,0,27,0,-27
32488,1,1,626,1228,602
32489,1,1,282,1307,1025
32490,0,0,29,0,-29
32491,1,0,50,0,-50
32492,0,0,30,0,-30
32493,1,1,984,2075,1091
32494,0,0,8,0,-8
32495,1,1,225,1585,1360
32496,1,1,361,1677,1316
32497,1,1,464,2047,1583
32498,1,0,136,0,-136
32499,1,0,137,0,-137
32500,0,0,4,0,-4
32501,1,1,10,1218,1208
32502,1,1,308,1396,1088
32503,1,1,952,1417,465
32504,0,0,354,0,-354
32505,1,0,15,0,-15
32506,1,1,769,1261,492
32507,0,0,24,0,-24
32508,0,0,4,0,-4
32509,1,0,17,0,-17
32510,0,0,87,0,-87
32511,1,0,33,0,-33
32512,1,0,2,0,-2
32513,1,1,206,1344,1138
32514,1,0,10,0,-10
32515,1,1,336,2182,1846
32516,1,1,1269,1391,122
32517,0,0,4,0,-4
32518,1,1,784,1309,525
32519,1,1,222,1263,1041
32520,0,0,1,0,-1
32521,0,0,14,0,-14
32522,1,0,36,0,-36
32523,1,1,1693,1228,-465
32524,0,0,258,0,-258
32525,0,0,133,0,-133
32526,0,0,0,0,0
32527,1,1,344,1221,877
32528,1,1,1177,2220,1043
32529,1,0,58,0,-58
32530,1,0,0,0,0
32531,0,0,27,0,-27
32532,0,0,78,0,-78
32533,1,0,59,0,-59
32534,1,1,1367,1234,-133
32535,1,1,635,1266,631
32536,1,1,475,1627,1152
32537,1,0,56,0,-56
32538,0,0,54,0,-54
32539,0,0,220,0,-220
32540,1,0,56,0,-56
32541,1,1,105,1458,1353
32542,1,0,102,0,-102
32543,0,0,20,0,-20
32544,1,0,80,0,-80
32545,0,0,3,0,-3
32546,0,0,37,0,-37
32547,1,0,17,0,-17
32548,1,0,3,0,-3
32549,0,0,0,0,0
32550,1,1,804,1203,399
32551,1,1,356,1663,1307
32552,1,1,1117,4137,3020
32553,1,1,948,1324,376
32554,0,0,0,0,0
32555,1,1,15,1327,1312
32556,0,0,67,0,-67
32557,0,0,8,0,-8
32558,1,0,22,0,-22
32559,1,0,53,0,-53
32560,0,0,183,0,-183
32561,1,0,24,0,-24
32562,1,1,921,3210,2289
32563,0,0,44,0,-44
32564,0,0,3,0,-3
32565,1,1,865,1227,362
32566,1,0,68,0,-68
32567,1,1,136,1454,1318
32568,0,0,195,0,-195
32569,1,1,696,1360,664
32570,0,0,67,0,-67
32571,0,0,9,0,-9
32572,0,0,6,0,-6
32573,1,0,37,0,-37
32574,0,0,22,0,-22
32575,1,0,8,0,-8
32576,1,1,507,1722,1215
32577,1,1,499,1819,1320
32578,1,1,750,1418,668
32579,0,0,46,0,-46
32580,0,0,29,0,-29
32581,1,1,712,1339,627
32582,0,0,19,0,-19
32583,1,0,22,0,-22
32584,1,1,95,1319,1224
32585,1,1,80,2508,2428
32586,1,0,157,0,-157
32587,1,1,1449,1602,153
32588,1,0,0,0,0
32589,0,0,35,0,-35
32590,0,0,35,0,-35
32591,0,0,24,0,-24
32592,1,0,30,0,-30
32593,1,0,20,0,-20
32594,0,0,54,0,-54
32595,1,1,714,1429,715
32596,1,1,308,1979,1671
32597,0,0,18,0,-18
32598,1,1,501,1674,1173
32599,1,0,15,0,-15
32600,0,0,42,0,-42
32601,0,0,59,0,-59
32602,1,1,397,1320,923
32603,1,1,696,1291,595
32604,0,0,115,0,-115
32605,0,0,183,0,-183
32606,0,0,5,0,-5
32607,1,0,0,0,0
32608,1,0,39,0,-39
32609,0,0,38,0,-38
32610,1,0,5,0,-5
32611,1,0,8,0,-8
32612,1,1,149,1571,1422
32613,1,1,237,1200,963
32614,0,0,53,0,-53
32615,1,1,356,1281,925
32616,1,1,1072,1219,147
32617,1,0,17,0,-17
32618,1,0,41,0,-41
32619,0,0,83,0,-83
32620,0,0,21,0,-21
32621,1,0,104,0,-104
32622,1,1,236,2808,2572
32623,1,1,2015,1231,-784
32624,1,0,12,0,-12
32625,0,0,65,0,-65
32626,1,0,66,0,-66
32627,0,0,11,0,-11
32628,1,0,2,0,-2
32629,0,0,10,0,-10
32630,1,0,48,0,-48
32631,1,1,585,1270,685
32632,0,0,36,0,-36
32633,0,0,18,0,-18
32634,1,0,54,0,-54
32635,1,0,65,0,-65
32636,1,0,9,0,-9
32637,1,1,758,1411,653
32638,1,1,786,1418,632
32639,1,0,3,0,-3
32640,1,1,85,1458,1373
32641,1,0,21,0,-21
32642,1,0,46,0,-46
32643,0,0,25,0,-25
32644,1,0,214,0,-214
32645,1,0,81,0,-81
32646,0,0,101,0,-101
32647,1,1,717,1716,999
32648,1,0,29,0,-29
32649,0,0,71,0,-71
32650,1,0,89,0,-89
32651,1,1,133,1561,1428
32652,1,0,20,0,-20
32653,0,0,24,0,-24
32654,0,0,34,0,-34
32655,1,1,133,1422,1289
32656,1,0,18,0,-18
32657,1,0,44,0,-44
32658,1,0,10,0,-10
32659,0,0,7,0,-7
32660,1,0,15,0,-15
32661,0,0,31,0,-31
32662,1,0,12,0,-12
32663,1,0,211,0,-211
32664,0,0,0,0,0
32665,1,1,674,1207,533
32666,1,0,0,0,0
32667,1,0,52,0,-52
32668,0,0,2,0,-2
32669,1,0,82,0,-82
32670,1,0,83,0,-83
32671,1,0,35,0,-35
32672,1,0,3,0,-3
32673,0,0,32,0,-32
32674,1,0,130,0,-130
32675,0,0,92,0,-92
32676,1,0,208,0,-208
32677,1,0,31,0,-31
32678,0,0,51,0,-51
32679,1,1,303,1235,932
32680,1,0,50,0,-50
32681,0,0,36,0,-36
32682,1,0,8,0,-8
32683,1,0,7,0,-7
32684,1,1,622,1467,845
32685,1,0,20,0,-20
32686,1,0,8,0,-8
32687,1,0,43,0,-43
32688,0,0,41,0,-41
32689,0,0,1,0,-1
32690,0,0,10,0,-10
32691,1,0,16,0,-16
32692,1,0,13,0,-13
32693,1,0,6,0,-6
32694,1,0,8,0,-8
32695,1,0,1,0,-1
32696,1,0,21,0,-21
32697,1,1,735,1461,726
32698,1,1,1199,1397,198
32699,1,0,120,0,-120
32700,1,1,427,1319,892
32701,1,1,1335,1425,90
32702,1,0,89,0,-89
32703,0,0,25,0,-25
32704,1,0,32,0,-32
32705,1,0,40,0,-40
32706,1,0,37,0,-37
32707,1,1,719,1266,547
32708,0,0,68,0,-68
32709,0,0,18,0,-18
32710,0,0,26,0,-26
32711,1,0,104,0,-104
32712,1,1,50,1370,1320
32713,1,1,2298,1359,-939
32714,0,0,72,0,-72
32715,1,1,47,1460,1413
32716,1,1,353,1457,1104
32717,0,0,11,0,-11
32718,1,1,248,3239,2991
32719,1,0,36,0,-36
32720,1,0,7,0,-7
32721,1,0,63,0,-63
32722,1,0,3,0,-3
32723,1,0,54,0,-54
32724,0,0,5,0,-5
32725,0,0,108,0,-108
32726,1,0,15,0,-15
32727,0,0,3,0,-3
32728,0,0,56,0,-56
32729,1,0,39,0,-39
32730,1,0,47,0,-47
32731,0,0,7,0,-7
32732,1,1,180,1213,1033
32733,1,1,203,1513,1310
32734,0,0,12,0,-12
32735,0,0,31,0,-31
32736,1,1,269,1374,1105
32737,0,0,71,0,-71
32738,0,0,24,0,-24
32739,1,1,1011,1645,634
32740,1,0,33,0,-33
32741,1,0,45,0,-45
32742,0,0,32,0,-32
32743,1,1,552,1838,1286
32744,1,1,598,1302,704
32745,0,0,10,0,-10
32746,0,0,69,0,-69
32747,1,1,487,1705,1218
32748,0,0,93,0,-93
32749,1,1,267,2297,2030
32750,1,1,1925,2122,197
32751,1,0,3,0,-3
32752,0,0,74,0,-74
32753,0,0,5,0,-5
32754,1,1,1321,1552,231
32755,0,0,5,0,-5
32756,0,0,41,0,-41
32757,0,0,111,0,-111
32758,0,0,66,0,-66
32759,0,0,10,0,-10
32760,0,0,132,0,-132
32761,1,1,1332,1219,-113
32762,1,0,24,0,-24
32763,1,1,520,1521,1001
32764,0,0,24,0,-24
32765,1,0,15,0,-15
32766,0,0,55,0,-55
32767,1,0,29,0,-29
32768,0,0,1,0,-1
32769,1,1,224,1457,1233
32770,0,0,15,0,-15
32771,1,1,394,1561,1167
32772,1,1,376,1276,900
32773,1,1,3138,1609,-1529
32774,1,1,606,1300,694
32775,0,0,40,0,-40
32776,1,0,73,0,-73
32777,0,0,34,0,-34
32778,1,0,24,0,-24
32779,1,1,164,1361,1197
32780,1,0,13,0,-13
32781,1,1,180,1303,1123
32782,0,0,71,0,-71
32783,0,0,22,0,-22
32784,1,1,492,1210,718
32785,0,0,48,0,-48
32786,0,0,106,0,-106
32787,1,0,106,0,-106
32788,0,0,5,0,-5
32789,0,0,17,0,-17
32790,0,0,8,0,-8
32791,1,1,15,1268,1253
32792,0,0,54,0,-54
32793,0,0,69,0,-69
32794,0,0,7,0,-7
32795,0,0,9,0,-9
32796,1,1,592,1803,1211
32797,1,0,51,0,-51
32798,1,1,92,1469,1377
32799,0,0,58,0,-58
32800,1,1,170,1502,1332
32801,1,1,700,2551,1851
32802,1,0,11,0,-11
32803,1,1,642,1341,699
32804,1,0,105,0,-105
32805,1,1,331,1220,889
32806,1,0,10,0,-10
32807,1,1,53,1317,1264
32808,1,0,26,0,-26
32809,0,0,24,0,-24
32810,0,0,38,0,-38
32811,1,1,709,1254,545
32812,1,1,315,2281,1966
32813,0,0,149,0,-149
32814,1,1,759,1476,717
32815,1,0,65,0,-65
32816,1,1,624,1967,1343
32817,1,1,737,1345,608
32818,0,0,34,0,-34
32819,1,0,144,0,-144
32820,1,0,44,0,-44
32821,1,0,40,0,-40
32822,0,0,18,0,-18
32823,1,0,13,0,-13
32824,1,0,37,0,-37
32825,1,0,40,0,-40
32826,0,0,120,0,-120
32827,0,0,16,0,-16
32828,1,1,628,1210,582
32829,1,1,1122,3208,2086
32830,1,1,292,1468,1176
32831,1,0,7,0,-7
32832,1,0,5,0,-5
32833,1,1,466,1682,1216
32834,1,1,265,1687,1422
32835,1,1,189,1269,1080
32836,0,0,213,0,-213
32837,0,0,1,0,-1
32838,1,1,240,1229,989
32839,1,0,61,0,-61
32840,1,1,159,1850,1691
32841,1,0,60,0,-60
32842,0,0,28,0,-28
32843,1,0,5,0,-5
32844,1,0,51,0,-51
32845,1,0,27,0,-27
32846,1,1,433,1509,1076
32847,1,1,51,1216,1165
32848,1,1,181,1618,1437
32849,1,1,241,3702,3461
32850,0,0,17,0,-17
32851,1,0,59,0,-59
32852,0,0,20,0,-20
32853,0,0,0,0,0
32854,1,1,497,2742,2245
32855,1,1,787,1473,686
32856,0,0,83,0,-83
32857,0,0,46,0,-46
32858,0,0,73,0,-73
32859,1,1,1381,1957,576
32860,0,0,46,0,-46
32861,1,0,154,0,-154
32862,1,0,13,0,-13
32863,1,0,198,0,-198
32864,1,0,12,0,-12
32865,1,1,98,1454,1356
32866,0,0,14,0,-14
32867,1,0,53,0,-53
32868,0,0,212,0,-212
32869,1,0,40,0,-40
32870,1,0,11,0,-11
32871,1,0,38,0,-38
32872,1,1,893,1269,376
32873,0,0,18,0,-18
32874,1,0,48,0,-48
32875,1,0,54,0,-54
32876,0,0,26,0,-26
32877,1,0,22,0,-22
32878,1,1,1217,1663,446
32879,0,0,61,0,-61
32880,1,1,141,1272,1131
32881,1,0,51,0,-51
32882,0,0,98,0,-98
32883,1,1,557,1255,698
32884,1,0,37,0,-37
32885,1,1,631,4407,3776
32886,0,0,6,0,-6
32887,0,0,52,0,-52
32888,1,0,77,0,-77
32889,0,0,63,0,-63
32890,1,1,254,1227,973
32891,0,0,34,0,-34
32892,1,1,62,1231,1169
32893,1,0,66,0,-66
32894,0,0,14,0,-14
32895,1,1,697,2066,1369
32896,1,1,64,1714,1650
32897,1,1,382,1278,896
32898,1,0,3,0,-3
32899,1,1,1302,1507,205
32900,1,0,12,0,-12
32901,1,1,175,2941,2766
32902,1,0,18,0,-18
32903,1,0,83,0,-83
32904,0,0,43,0,-43
32905,1,1,61,1822,1761
32906,1,1,210,1677,1467
32907,0,0,98,0,-98
32908,1,0,32,0,-32
32909,0,0,204,0,-204
32910,1,0,111,0,-111
32911,0,0,64,0,-64
32912,0,0,31,0,-31
32913,0,0,22,0,-22
32914,0,0,2,0,-2
32915,1,1,502,1447,945
32916,1,0,187,0,-187
32917,1,0,22,0,-22
32918,0,0,29,0,-29
32919,0,0,67,0,-67
32920,1,1,557,1520,963
32921,1,0,87,0,-87
32922,1,1,1621,1509,-112
32923,0,0,21,0,-21
32924,0,0,140,0,-140
32925,0,0,22,0,-22
32926,1,0,51,0,-51
32927,1,1,263,1384,1121
32928,1,0,58,0,-58
32929,0,0,28,0,-28
32930,0,0,13,0,-13
32931,1,1,543,1285,742
32932,0,0,7,0,-7
32933,0,0,107,0,-107
32934,1,1,222,1304,1082
32935,1,0,19,0,-19
32936,1,0,1,0,-1
32937,0,0,12,0,-12
32938,1,0,10,0,-10
32939,1,0,16,0,-16
32940,0,0,19,0,-19
32941,1,1,106,1210,1104
32942,1,1,132,1606,1474
32943,1,1,62,1651,1589
32944,1,0,14,0,-14
32945,1,1,476,1867,1391
32946,1,1,45,2703,2658
32947,1,1,745,1507,762
32948,1,1,1837,1619,-218
32949,0,0,46,0,-46
32950,0,0,137,0,-137
32951,1,1,208,1238,1030
32952,0,0,46,0,-46
32953,1,1,1344,1511,167
32954,1,1,219,1226,1007
32955,0,0,39,0,-39
32956,0,0,13,0,-13
32957,1,1,392,2413,2021
32958,0,0,35,0,-35
32959,0,0,150,0,-150
32960,1,1,426,1254,828
32961,0,0,38,0,-38
32962,1,1,417,1516,1099
32963,0,0,37,0,-37
32964,1,0,229,0,-229
32965,1,1,470,1354,884
32966,1,1,767,1448,681
32967,1,1,250,1203,953
32968,1,0,25,0,-25
32969,0,0,68,0,-68
32970,0,0,76,0,-76
32971,1,0,7,0,-7
32972,1,0,1,0,-1
32973,0,0,65,0,-65
32974,0,0,48,0,-48
32975,1,1,897,1696,799
32976,1,0,0,0,0
32977,0,0,8,0,-8
32978,1,1,758,1550,792
32979,1,1,513,1609,1096
32980,1,1,428,2053,1625
32981,1,1,237,1238,1001
32982,0,0,48,0,-48
32983,0,0,22,0,-22
32984,1,1,618,1410,792
32985,0,0,100,0,-100
32986,0,0,5,0,-5
32987,1,0,39,0,-39
32988,0,0,101,0,-101
32989,1,0,16,0,-16
32990,0,0,5,0,-5
32991,0,0,63,0,-63
32992,1,0,0,0,0
32993,1,1,585,1231,646
32994,1,1,154,1351,1197
32995,1,0,82,0,-82
32996,1,0,4,0,-4
32997,1,0,13,0,-13
32998,1,0,56,0,-56
32999,0,0,158,0,-158
33000,0,0,114,0,-114
33001,0,0,13,0,-13
33002,1,1,506,1224,718
33003,0,0,14,0,-14
33004,0,0,16,0,-16
33005,0,0,45,0,-45
33006,1,0,1,0,-1
33007,0,0,58,0,-58
33008,0,0,10,0,-10
33009,1,0,6,0,-6
33010,0,0,0,0,0
33011,0,0,31,0,-31
33012,1,1,66,1740,1674
33013,1,0,11,0,-11
33014,1,0,73,0,-73
33015,1,0,44,0,-44
33016,1,0,47,0,-47
33017,1,0,29,0,-29
33018,1,1,785,1319,534
33019,0,0,49,0,-49
33020,1,0,111,0,-111
33021,1,0,44,0,-44
33022,0,0,49,0,-49
33023,1,1,1704,1345,-359
33024,0,0,94,0,-94
33025,1,0,32,0,-32
33026,0,0,66,0,-66
33027,1,1,84,1659,1575
33028,1,0,200,0,-200
33029,0,0,14,0,-14
33030,1,0,37,0,-37
33031,1,1,810,2013,1203
33032,1,0,171,0,-171
33033,0,0,7,0,-7
33034,1,1,1433,1216,-217
33035,0,0,188,0,-188
33036,1,0,4,0,-4
33037,1,1,851,1365,514
33038,1,0,28,0,-28
33039,1,1,166,1270,1104
33040,1,0,0,0,0
33041,1,1,1095,1413,318
33042,1,0,29,0,-29
33043,0,0,221,0,-221
33044,1,0,90,0,-90
33045,1,0,8,0,-8
33046,1,1,161,1248,1087
33047,1,0,15,0,-15
33048,1,1,254,1459,1205
33049,0,0,157,0,-157
33050,0,0,18,0,-18
33051,1,0,7,0,-7
33052,0,0,5,0,-5
33053,1,1,381,1209,828
33054,0,0,32,0,-32
33055,1,1,197,1236,1039
33056,1,1,340,1223,883
33057,0,0,81,0,-81
33058,1,1,340,1221,881
33059,1,1,51,1228,1177
33060,0,0,41,0,-41
33061,1,1,354,1354,1000
33062,1,0,64,0,-64
33063,0,0,20,0,-20
33064,0,0,40,0,-40
33065,0,0,36,0,-36
33066,1,0,5,0,-5
33067,1,1,104,1723,1619
33068,1,1,251,1369,1118
33069,0,0,56,0,-56
33070,1,1,1053,1203,150
33071,1,0,18,0,-18
33072,1,0,109,0,-109
33073,1,1,1876,1361,-515
33074,0,0,42,0,-42
33075,1,1,499,1316,817
33076,1,1,304,2030,1726
33077,1,0,26,0,-26
33078,0,0,15,0,-15
33079,1,0,86,0,-86
33080,1,0,0,0,0
33081,1,0,82,0,-82
33082,0,0,72,0,-72
33083,0,0,30,0,-30
33084,1,0,119,0,-119
33085,1,0,0,0,0
33086,1,1,173,3607,3434
33087,1,1,231,1238,1007
33088,0,0,21,0,-21
33089,1,1,837,1285,448
33090,1,1,558,1542,984
33091,0,0,12,0,-12
33092,0,0,76,0,-76
33093,0,0,132,0,-132
33094,0,0,3,0,-3
33095,1,0,142,0,-142
33096,1,1,206,1579,1373
33097,1,0,28,0,-28
33098,0,0,19,0,-19
33099,0,0,19,0,-19
33100,1,0,55,0,-55
33101,1,1,154,1690,1536
33102,1,0,1,0,-1
33103,1,1,1319,1532,213
33104,1,0,25,0,-25
33105,0,0,14,0,-14
33106,1,0,39,0,-39
33107,1,1,1179,1506,327
33108,1,1,133,1474,1341
33109,0,0,42,0,-42
33110,1,0,19,0,-19
33111,0,0,27,0,-27
33112,0,0,3,0,-3
33113,1,0,4,0,-4
33114,1,1,612,1230,618
33115,0,0,11,0,-11
33116,0,0,19,0,-19
33117,1,0,8,0,-8
33118,1,0,83,0,-83
33119,0,0,62,0,-62
33120,1,1,1471,1206,-265
33121,0,0,331,0,-331
33122,1,0,17,0,-17
33123,1,1,773,2193,1420
33124,0,0,75,0,-75
33125,1,0,30,0,-30
33126,0,0,11,0,-11
33127,1,1,1173,2227,1054
33128,1,1,315,1221,906
33129,0,0,13,0,-13
33130,0,0,50,0,-50
33131,1,1,71,1437,1366
33132,1,0,7,0,-7
33133,1,0,79,0,-79
33134,1,0,25,0,-25
33135,1,0,61,0,-61
33136,0,0,62,0,-62
33137,1,1,754,1585,831
33138,0,0,7,0,-7
33139,1,0,47,0,-47
33140,0,0,69,0,-69
33141,0,0,134,0,-134
33142,1,0,114,0,-114
33143,0,0,152,0,-152
33144,1,1,60,1725,1665
33145,0,0,83,0,-83
33146,0,0,87,0,-87
33147,0,0,64,0,-64
33148,1,1,550,1275,725
33149,1,0,6,0,-6
33150,0,0,9,0,-9
33151,1,1,427,1538,1111
33152,1,1,492,1247,755
33153,0,0,19,0,-19
33154,0,0,39,0,-39
33155,1,1,1026,1556,530
33156,1,1,192,6233,6041
33157,0,0,101,0,-101
33158,0,0,48,0,-48
33159,1,1,1007,1204,197
33160,0,0,0,0,0
33161,1,1,412,1650,1238
33162,0,0,16,0,-16
33163,0,0,10,0,-10
33164,1,0,35,0,-35
33165,0,0,2,0,-2
33166,1,0,28,0,-28
33167,1,0,82,0,-82
33168,1,1,723,1516,793
33169,0,0,73,0,-73
33170,1,0,122,0,-122
33171,0,0,4,0,-4
33172,1,1,58,1679,1621
33173,1,0,20,0,-20
33174,0,0,7,0,-7
33175,1,0,20,0,-20
33176,1,1,454,1217,763
33177,0,0,85,0,-85
33178,0,0,47,0,-47
33179,0,0,33,0,-33
33180,1,1,281,1292,1011
33181,0,0,80,0,-80
33182,0,0,80,0,-80
33183,1,0,172,0,-172
33184,0,0,9,0,-9
33185,0,0,17,0,-17
33186,1,1,588,1271,683
33187,1,1,795,1227,432
33188,0,0,146,0,-146
33189,0,0,1,0,-1
33190,1,0,65,0,-65
33191,0,0,5,0,-5
33192,0,0,20,0,-20
33193,1,0,15,0,-15
33194,1,0,28,0,-28
33195,1,1,910,1389,479
33196,0,0,19,0,-19
33197,1,1,2532,1860,-672
33198,1,1,986,1322,336
33199,0,0,97,0,-97
33200,1,1,269,2998,2729
33201,0,0,108,0,-108
33202,0,0,50,0,-50
33203,1,0,58,0,-58
33204,1,1,1041,1330,289
33205,0,0,56,0,-56
33206,0,0,103,0,-103
33207,1,0,27,0,-27
33208,1,1,659,1651,992
33209,0,0,196,0,-196
33210,1,1,75,1335,1260
33211,1,0,76,0,-76
33212,1,0,38,0,-38
33213,1,1,352,1468,1116
33214,0,0,36,0,-36
33215,1,0,45,0,-45
33216,1,0,57,0,-57
33217,0,0,1,0,-1
33218,1,0,65,0,-65
33219,1,1,270,1261,991
33220,0,0,6,0,-6
33221,0,0,231,0,-231
33222,0,0,10,0,-10
33223,1,0,70,0,-70
33224,0,0,90,0,-90
33225,0,0,14,0,-14
33226,0,0,26,0,-26
33227,0,0,32,0,-32
33228,1,1,233,1312,1079
33229,0,0,92,0,-92
33230,0,0,104,0,-104
33231,1,1,271,1563,1292
33232,0,0,17,0,-17
33233,0,0,9,0,-9
33234,0,0,4,0,-4
33235,1,0,50,0,-50
33236,1,1,785,1327,542
33237,1,1,1306,1708,402
33238,1,0,27,0,-27
33239,0,0,5,0,-5
33240,1,1,419,1317,898
33241,1,1,161,1268,1107
33242,0,0,40,0,-40
33243,1,0,26,0,-26
33244,1,0,53,0,-53
33245,1,0,27,0,-27
33246,0,0,64,0,-64
33247,1,1,18,1640,1622
33248,0,0,148,0,-148
33249,1,0,18,0,-18
33250,0,0,80,0,-80
33251,1,0,6,0,-6
33252,0,0,153,0,-153
33253,1,1,556,1410,854
33254,1,0,93,0,-93
33255,0,0,153,0,-153
33256,1,1,1063,1262,199
33257,1,0,7,0,-7
33258,0,0,30,0,-30
33259,1,1,73,1459,1386
33260,0,0,20,0,-20
33261,1,1,108,1915,1807
33262,1,0,14,0,-14
33263,1,0,16,0,-16
33264,0,0,6,0,-6
33265,0,0,223,0,-223
33266,1,0,69,0,-69
33267,1,0,18,0,-18
33268,1,0,197,0,-197
33269,1,0,0,0,0
33270,0,0,3,0,-3
33271,0,0,17,0,-17
33272,0,0,13,0,-13
33273,0,0,78,0,-78
33274,1,0,1,0,-1
33275,1,1,597,1311,714
33276,0,0,16,0,-16
33277,1,0,68,0,-68
33278,0,0,4,0,-4
33279,0,0,2,0,-2
33280,0,0,26,0,-26
33281,1,1,63,1333,1270
33282,1,0,58,0,-58
33283,1,1,1081,1409,328
33284,1,1,117,1438,1321
33285,1,1,705,1649,944
33286,0,0,93,0,-93
33287,0,0,5,0,-5
33288,1,0,1,0,-1
33289,1,0,95,0,-95
33290,1,0,171,0,-171
33291,1,0,7,0,-7
33292,0,0,54,0,-54
33293,1,0,67,0,-67
33294,1,0,6,0,-6
33295,1,1,120,1237,1117
33296,1,0,74,0,-74
33297,1,1,49,1399,1350
33298,1,1,202,1246,1044
33299,0,0,59,0,-59
33300,0,0,4,0,-4
33301,0,0,2,0,-2
33302,0,0,62,0,-62
33303,1,1,90,1600,1510
33304,0,0,6,0,-6
33305,1,1,103,1278,1175
33306,1,0,77,0,-77
33307,1,1,601,2140,1539
33308,1,0,3,0,-3
33309,0,0,4,0,-4
33310,1,0,93,0,-93
33311,1,1,396,1515,1119
33312,1,0,9,0,-9
33313,1,0,43,0,-43
33314,1,1,273,1373,1100
33315,1,0,8,0,-8
33316,1,1,339,1280,941
33317,1,1,1189,2897,1708
33318,1,0,51,0,-51
33319,0,0,8,0,-8
33320,1,1,587,2062,1475
33321,0,0,74,0,-74
33322,0,0,16,0,-16
33323,1,0,24,0,-24
33324,1,0,44,0,-44
33325,1,0,40,0,-40
33326,1,0,91,0,-91
33327,0,0,4,0,-4
33328,1,1,915,2013,1098
33329,1,1,264,1276,1012
33330,0,0,6,0,-6
33331,1,1,67,1555,1488
33332,0,0,59,0,-59
33333,0,0,48,0,-48
33334,1,0,138,0,-138
33335,1,0,26,0,-26
33336,0,0,139,0,-139
33337,0,0,96,0,-96
33338,0,0,44,0,-44
33339,1,0,34,0,-34
33340,0,0,45,0,-45
33341,1,1,136,2766,2630
33342,1,0,114,0,-114
33343,1,0,37,0,-37
33344,1,0,139,0,-139
33345,1,0,102,0,-102
33346,0,0,69,0,-69
33347,0,0,12,0,-12
33348,0,0,9,0,-9
33349,1,0,0,0,0
33350,1,0,112,0,-112
33351,0,0,66,0,-66
33352,1,1,33,1572,1539
33353,1,1,186,1677,1491
33354,0,0,84,0,-84
33355,0,0,15,0,-15
33356,1,1,446,1379,933
33357,0,0,65,0,-65
33358,1,0,37,0,-37
33359,1,1,713,1650,937
33360,1,0,106,0,-106
33361,1,0,24,0,-24
33362,1,1,223,1610,1387
33363,1,1,634,1210,576
33364,1,0,8,0,-8
33365,1,1,44,1760,1716
33366,0,0,27,0,-27
33367,1,1,26,1535,1509
33368,0,0,114,0,-114
33369,1,1,449,3625,3176
33370,1,0,40,0,-40
33371,0,0,48,0,-48
33372,1,1,374,1272,898
33373,1,0,91,0,-91
33374,1,0,104,0,-104
33375,1,1,266,1323,1057
33376,1,0,6,0,-6
33377,1,1,70,4554,4484
33378,0,0,28,0,-28
33379,1,1,485,1682,1197
33380,1,1,232,1566,1334
33381,1,0,38,0,-38
33382,1,0,18,0,-18
33383,1,0,203,0,-203
33384,1,1,756,1658,902
33385,0,0,41,0,-41
33386,0,0,37,0,-37
33387,0,0,89,0,-89
33388,1,0,14,0,-14
33389,1,0,37,0,-37
33390,1,1,761,2582,1821
33391,1,1,213,1404,1191
33392,1,1,1223,2794,1571
33393,1,0,90,0,-90
33394,1,0,12,0,-12
33395,1,1,226,1237,1011
33396,0,0,5,0,-5
33397,1,1,1338,1836,498
33398,1,0,67,0,-67
33399,0,0,48,0,-48
33400,1,0,41,0,-41
33401,1,0,32,0,-32
33402,0,0,78,0,-78
33403,1,1,846,1208,362
33404,1,0,0,0,0
33405,1,1,310,1855,1545
33406,0,0,6,0,-6
33407,0,0,86,0,-86
33408,1,1,699,1344,645
33409,1,0,175,0,-175
33410,0,0,67,0,-67
33411,0,0,46,0,-46
33412,1,0,41,0,-41
33413,1,0,34,0,-34
33414,1,0,73,0,-73
33415,1,0,0,0,0
33416,1,0,31,0,-31
33417,0,0,100,0,-100
33418,1,1,664,1363,699
33419,1,1,399,2341,1942
33420,1,1,483,1608,1125
33421,0,0,93,0,-93
33422,1,0,29,0,-29
33423,1,1,577,1616,1039
33424,0,0,41,0,-41
33425,0,0,0,0,0
33426,1,0,0,0,0
33427,0,0,8,0,-8
33428,0,0,6,0,-6
33429,0,0,0,0,0
33430,1,1,133,2036,1903
33431,1,0,132,0,-132
33432,1,0,39,0,-39
33433,1,0,30,0,-30
33434,1,0,85,0,-85
33435,0,0,26,0,-26
33436,1,1,967,1268,301
33437,1,1,1619,1215,-404
33438,1,1,358,2345,1987
33439,1,0,56,0,-56
33440,1,0,0,0,0
33441,1,1,95,3339,3244
33442,0,0,50,0,-50
33443,1,1,43,2040,1997
33444,1,0,18,0,-18
33445,1,1,267,2680,2413
33446,1,1,427,1254,827
33447,0,0,11,0,-11
33448,1,1,207,1312,1105
33449,0,0,45,0,-45
33450,0,0,23,0,-23
33451,1,1,455,1223,768
33452,1,1,183,1277,1094
33453,1,1,624,1314,690
33454,0,0,2,0,-2
33455,1,1,176,1592,1416
33456,0,0,71,0,-71
33457,1,1,127,1268,1141
33458,1,0,10,0,-10
33459,1,1,1182,1392,210
33460,0,0,99,0,-99
33461,0,0,22,0,-22
33462,1,1,321,3069,2748
33463,1,1,984,1437,453
33464,1,0,31,0,-31
33465,1,0,30,0,-30
33466,1,1,197,1375,1178
33467,0,0,166,0,-166
33468,1,1,115,1335,1220
33469,1,1,168,1620,1452
33470,0,0,140,0,-140
33471,0,0,51,0,-51
33472,1,0,25,0,-25
33473,1,0,17,0,-17
33474,1,1,1343,1758,415
33475,1,1,658,2063,1405
33476,0,0,73,0,-73
33477,1,0,21,0,-21
33478,1,1,101,1660,1559
33479,0,0,48,0,-48
33480,0,0,159,0,-159
33481,0,0,121,0,-121
33482,0,0,1,0,-1
33483,0,0,48,0,-48
33484,1,1,1227,1296,69
33485,0,0,16,0,-16
33486,1,1,705,2070,1365
33487,0,0,28,0,-28
33488,0,0,120,0,-120
33489,1,0,48,0,-48
33490,1,1,831,1399,568
33491,0,0,40,0,-40
33492,0,0,23,0,-23
33493,0,0,17,0,-17
33494,1,1,151,1322,1171
33495,1,1,87,1506,1419
33496,1,1,160,2041,1881
33497,1,0,9,0,-9
33498,1,1,358,2787,2429
33499,0,0,116,0,-116
33500,0,0,0,0,0
33501,1,1,1425,1251,-174
33502,0,0,108,0,-108
33503,1,0,5,0,-5
33504,1,1,233,1263,1030
33505,1,1,403,1259,856
33506,1,1,787,1335,548
33507,1,1,1564,1258,-306
33508,1,1,224,1374,1150
33509,0,0,131,0,-131
33510,1,1,248,1367,1119
33511,0,0,154,0,-154
33512,0,0,37,0,-37
33513,0,0,114,0,-114
33514,1,0,4,0,-4
33515,1,1,289,1463,1174
33516,0,0,55,0,-55
33517,1,1,675,1354,679
33518,1,1,730,1290,560
33519,1,0,0,0,0
33520,1,1,456,3038,2582
33521,1,1,667,1322,655
33522,1,1,369,1743,1374
33523,0,0,127,0,-127
33524,1,1,88,1243,1155
33525,0,0,2,0,-2
33526,1,1,54,1308,1254
33527,1,0,42,0,-42
33528,0,0,57,0,-57
33529,0,0,61,0,-61
33530,1,0,54,0,-54
33531,1,0,14,0,-14
33532,1,0,110,0,-110
33533,0,0,19,0,-19
33534,1,1,241,1986,1745
33535,1,0,6,0,-6
33536,0,0,27,0,-27
33537,1,0,5,0,-5
33538,1,1,14,1404,1390
33539,0,0,38,0,-38
33540,1,0,0,0,0
33541,1,1,117,1651,1534
33542,0,0,16,0,-16
33543,1,0,4,0,-4
33544,1,0,35,0,-35
33545,0,0,44,0,-44
33546,1,1,116,1920,1804
33547,1,1,195,1229,1034
33548,1,0,4,0,-4
33549,1,0,11,0,-11
33550,0,0,25,0,-25
33551,0,0,59,0,-59
33552,0,0,3,0,-3
33553,1,0,38,0,-38
33554,1,0,148,0,-148
33555,1,0,9,0,-9
33556,1,0,50,0,-50
33557,0,0,70,0,-70
33558,1,1,264,1364,1100
33559,1,1,735,1357,622
33560,1,1,3608,1299,-2309
33561,1,0,15,0,-15
33562,1,0,71,0,-71
33563,0,0,12,0,-12
33564,1,0,52,0,-52
33565,1,1,567,1249,682
33566,0,0,89,0,-89
33567,0,0,76,0,-76
33568,1,0,7,0,-7
33569,1,0,6,0,-6
33570,1,1,257,1947,1690
33571,1,1,127,1623,1496
33572,0,0,101,0,-101
33573,0,0,22,0,-22
33574,0,0,7,0,-7
33575,1,1,578,1256,678
33576,0,0,61,0,-61
33577,1,1,2015,2102,87
33578,1,0,5,0,-5
33579,1,1,948,1290,342
33580,0,0,7,0,-7
33581,1,0,142,0,-142
33582,0,0,45,0,-45
33583,0,0,113,0,-113
33584,1,0,58,0,-58
33585,1,1,733,1210,477
33586,1,0,107,0,-107
33587,1,0,67,0,-67
33588,0,0,8,0,-8
33589,0,0,31,0,-31
33590,1,1,642,1346,704
33591,0,0,33,0,-33
33592,1,0,55,0,-55
33593,1,0,3,0,-3
33594,0,0,53,0,-53
33595,1,0,1,0,-1
33596,1,0,23,0,-23
33597,1,1,38,1992,1954
33598,1,0,1,0,-1
33599,0,0,15,0,-15
33600,1,1,453,1516,1063
33601,1,0,7,0,-7
33602,1,1,1926,1469,-457
33603,0,0,30,0,-30
33604,1,1,67,1440,1373
33605,1,0,9,0,-9
33606,1,1,422,3728,3306
33607,1,1,244,2725,2481
33608,1,1,761,1593,832
33609,0,0,164,0,-164
33610,0,0,60,0,-60
33611,1,1,471,1377,906
33612,0,0,71,0,-71
33613,0,0,21,0,-21
33614,1,1,755,1558,803
33615,1,0,25,0,-25
33616,0,0,149,0,-149
33617,1,1,323,1647,1324
33618,1,0,169,0,-169
33619,0,0,20,0,-20
33620,1,1,206,1981,1775
33621,1,1,173,1710,1537
33622,0,0,1,0,-1
33623,1,1,1135,2201,1066
33624,0,0,5,0,-5
33625,0,0,42,0,-42
33626,1,1,84,1464,1380
33627,0,0,165,0,-165
33628,1,0,25,0,-25
33629,1,1,1156,1536,380
33630,1,1,88,1534,1446
33631,0,0,6,0,-6
33632,1,1,146,1658,1512
33633,0,0,50,0,-50
33634,0,0,31,0,-31
33635,0,0,1,0,-1
33636,1,1,830,1217,387
33637,0,0,5,0,-5
33638,1,1,172,1358,1186
33639,1,1,155,3330,3175
33640,1,0,14,0,-14
33641,1,1,525,1374,849
33642,1,1,1013,1338,325
33643,1,1,1036,2134,1098
33644,0,0,43,0,-43
33645,0,0,1,0,-1
33646,1,0,18,0,-18
33647,0,0,36,0,-36
33648,1,0,57,0,-57
33649,1,0,156,0,-156
33650,1,1,950,1431,481
33651,0,0,15,0,-15
33652,0,0,86,0,-86
33653,0,0,177,0,-177
33654,1,1,418,1317,899
33655,1,1,731,1618,887
33656,1,1,411,1446,1035
33657,0,0,46,0,-46
33658,1,0,0,0,0
33659,0,0,54,0,-54
33660,1,1,136,1411,1275
33661,0,0,35,0,-35
33662,1,0,53,0,-53
33663,1,0,71,0,-71
33664,1,0,24,0,-24
33665,0,0,116,0,-116
33666,1,0,47,0,-47
33667,1,0,59,0,-59
33668,0,0,34,0,-34
33669,0,0,29,0,-29
33670,0,0,20,0,-20
33671,1,0,125,0,-125
33672,0,0,8,0,-8
33673,1,0,32,0,-32
33674,0,0,13,0,-13
33675,0,0,13,0,-13
33676,1,0,8,0,-8
33677,1,1,271,1256,985
33678,1,0,47,0,-47
33679,1,0,6,0,-6
33680,0,0,131,0,-131
33681,1,0,51,0,-51
33682,0,0,101,0,-101
33683,1,0,123,0,-123
33684,0,0,89,0,-89
33685,0,0,27,0,-27
33686,1,1,171,1297,1126
33687,0,0,6,0,-6
33688,1,1,514,1836,1322
33689,0,0,45,0,-45
33690,1,0,73,0,-73
33691,0,0,78,0,-78
33692,1,1,609,3845,3236
33693,1,1,1013,1910,897
33694,0,0,15,0,-15
33695,0,0,3,0,-3
33696,0,0,55,0,-55
33697,1,0,0,0,0
33698,1,1,53,1295,1242
33699,0,0,25,0,-25
33700,0,0,34,0,-34
33701,1,0,22,0,-22
33702,1,1,58,1221,1163
33703,0,0,14,0,-14
33704,1,0,158,0,-158
33705,1,0,9,0,-9
33706,0,0,81,0,-81
33707,1,1,1080,2046,966
33708,1,1,1201,1433,232
33709,1,1,519,3723,3204
33710,1,1,1099,1290,191
33711,0,0,2,0,-2
33712,1,0,237,0,-237
33713,1,1,462,1265,803
33714,0,0,59,0,-59
33715,1,0,23,0,-23
33716,0,0,32,0,-32
33717,1,1,116,1852,1736
33718,1,1,548,1761,1213
33719,1,1,130,1230,1100
33720,0,0,33,0,-33
33721,1,1,319,1316,997
33722,1,1,1284,1239,-45
33723,0,0,38,0,-38
33724,0,0,15,0,-15
33725,0,0,6,0,-6
33726,1,0,13,0,-13
33727,1,0,54,0,-54
33728,0,0,11,0,-11
33729,1,0,33,0,-33
33730,1,0,2,0,-2
33731,1,0,3,0,-3
33732,1,1,152,1221,1069
33733,0,0,71,0,-71
33734,1,1,128,1614,1486
33735,0,0,17,0,-17
33736,1,1,189,1531,1342
33737,0,0,16,0,-16
33738,1,1,1688,1867,179
33739,1,1,626,1583,957
33740,0,0,71,0,-71
33741,1,0,7,0,-7
33742,1,1,23,1246,1223
33743,1,0,88,0,-88
33744,1,0,11,0,-11
33745,0,0,29,0,-29
33746,0,0,114,0,-114
33747,0,0,24,0,-24
33748,1,0,0,0,0
33749,1,0,50,0,-50
33750,0,0,35,0,-35
33751,0,0,26,0,-26
33752,1,1,1038,1331,293
33753,1,0,1,0,-1
33754,0,0,66,0,-66
33755,0,0,44,0,-44
33756,1,1,211,1783,1572
33757,1,0,51,0,-51
33758,0,0,0,0,0
33759,1,1,236,1223,987
33760,0,0,38,0,-38
33761,0,0,23,0,-23
33762,1,1,153,1576,1423
33763,1,1,274,1445,1171
33764,1,0,10,0,-10
33765,0,0,16,0,-16
33766,1,1,33,1226,1193
33767,1,1,633,1350,717
33768,1,1,360,1215,855
33769,0,0,18,0,-18
33770,1,1,632,1365,733
33771,1,1,29,1918,1889
33772,1,0,45,0,-45
33773,1,0,69,0,-69
33774,0,0,6,0,-6
33775,1,0,14,0,-14
33776,0,0,80,0,-80
33777,0,0,20,0,-20
33778,1,0,75,0,-75
33779,1,1,328,3577,3249
33780,1,0,22,0,-22
33781,1,1,304,1497,1193
33782,1,1,136,1537,1401
33783,0,0,31,0,-31
33784,1,1,496,1833,1337
33785,1,0,73,0,-73
33786,0,0,30,0,-30
33787,1,1,904,1286,382
33788,0,0,443,0,-443
33789,0,0,173,0,-173
33790,0,0,40,0,-40
33791,0,0,7,0,-7
33792,1,1,92,1756,1664
33793,0,0,13,0,-13
33794,0,0,18,0,-18
33795,1,1,165,2030,1865
33796,1,0,191,0,-191
33797,1,0,71,0,-71
33798,0,0,65,0,-65
33799,1,1,733,2817,2084
33800,1,0,40,0,-40
33801,0,0,2,0,-2
33802,1,1,1331,1799,468
33803,0,0,42,0,-42
33804,1,1,256,1952,1696
33805,0,0,17,0,-17
33806,0,0,7,0,-7
33807,1,0,23,0,-23
33808,1,0,18,0,-18
33809,1,1,288,1334,1046
33810,0,0,97,0,-97
33811,0,0,16,0,-16
33812,0,0,5,0,-5
33813,0,0,83,0,-83
33814,0,0,5,0,-5
33815,1,1,257,1311,1054
33816,1,0,138,0,-138
33817,0,0,21,0,-21
33818,1,1,966,1267,301
33819,1,0,70,0,-70
33820,1,1,1032,2121,1089
33821,1,0,125,0,-125
33822,0,0,7,0,-7
33823,1,1,361,2365,2004
33824,0,0,63,0,-63
33825,0,0,18,0,-18
33826,0,0,10,0,-10
33827,1,1,60,2541,2481
33828,0,0,12,0,-12
33829,1,1,824,1239,415
33830,0,0,181,0,-181
33831,1,0,70,0,-70
33832,0,0,7,0,-7
33833,1,0,202,0,-202
33834,0,0,4,0,-4
33835,0,0,82,0,-82
33836,1,1,100,1341,1241
33837,0,0,129,0,-129
33838,1,0,36,0,-36
33839,1,1,1023,1277,254
33840,0,0,33,0,-33
33841,1,0,179,0,-179
33842,1,0,40,0,-40
33843,1,1,256,1848,1592
33844,1,1,1434,1499,65
33845,1,1,160,1658,1498
33846,1,0,89,0,-89
33847,0,0,6,0,-6
33848,0,0,13,0,-13
33849,0,0,68,0,-68
33850,1,1,323,1383,1060
33851,1,1,329,1375,1046
33852,1,1,1283,4185,2902
33853,1,1,171,1410,1239
33854,1,1,565,1209,644
33855,1,0,61,0,-61
33856,0,0,60,0,-60
33857,0,0,53,0,-53
33858,0,0,14,0,-14
33859,1,1,426,1378,952
33860,1,0,77,0,-77
33861,1,0,124,0,-124
33862,1,0,193,0,-193
33863,0,0,7,0,-7
33864,1,0,63,0,-63
33865,1,1,1650,1246,-404
33866,0,0,1,0,-1
33867,1,0,72,0,-72
33868,0,0,115,0,-115
33869,0,0,54,0,-54
33870,1,1,336,1439,1103
33871,1,1,429,1201,772
33872,1,0,70,0,-70
33873,1,1,721,1271,550
33874,1,0,7,0,-7
33875,1,0,86,0,-86
33876,0,0,18,0,-18
33877,1,1,373,1711,1338
33878,1,1,242,1454,1212
33879,1,1,210,1228,1018
33880,1,0,12,0,-12
33881,0,0,42,0,-42
33882,1,0,88,0,-88
33883,0,0,110,0,-110
33884,1,0,83,0,-83
33885,1,0,91,0,-91
33886,1,0,20,0,-20
33887,0,0,20,0,-20
33888,1,0,25,0,-25
33889,0,0,74,0,-74
33890,0,0,60,0,-60
33891,1,0,27,0,-27
33892,1,1,246,2891,2645
33893,1,1,366,1600,1234
33894,1,1,562,1486,924
33895,1,1,1944,1682,-262
33896,0,0,72,0,-72
33897,0,0,99,0,-99
33898,0,0,37,0,-37
33899,1,0,94,0,-94
33900,1,0,3,0,-3
33901,0,0,62,0,-62
33902,0,0,56,0,-56
33903,0,0,47,0,-47
33904,1,1,111,1435,1324
33905,1,0,134,0,-134
33906,1,0,24,0,-24
33907,1,0,15,0,-15
33908,1,0,30,0,-30
33909,1,0,71,0,-71
33910,0,0,161,0,-161
33911,1,0,213,0,-213
33912,1,0,71,0,-71
33913,0,0,43,0,-43
33914,0,0,137,0,-137
33915,1,1,287,1504,1217
33916,1,0,28,0,-28
33917,1,1,1499,1293,-206
33918,0,0,30,0,-30
33919,1,1,1111,1284,173
33920,0,0,48,0,-48
33921,1,0,22,0,-22
33922,1,0,4,0,-4
33923,0,0,9,0,-9
33924,1,1,242,3314,3072
33925,0,0,2,0,-2
33926,1,0,19,0,-19
33927,1,0,93,0,-93
33928,1,1,628,1255,627
33929,0,0,38,0,-38
33930,1,1,553,1765,1212
33931,1,1,541,1538,997
33932,1,1,506,1643,1137
33933,1,1,538,1253,715
33934,1,1,1426,1519,93
33935,0,0,13,0,-13
33936,1,1,782,1222,440
33937,1,0,24,0,-24
33938,1,1,2125,1866,-259
33939,1,0,25,0,-25
33940,0,0,13,0,-13
33941,1,0,21,0,-21
33942,1,0,24,0,-24
33943,0,0,62,0,-62
33944,1,0,87,0,-87
33945,0,0,11,0,-11
33946,1,1,2867,2012,-855
33947,0,0,0,0,0
33948,1,1,394,5073,4679
33949,1,0,35,0,-35
33950,0,0,2,0,-2
33951,1,1,1117,1527,410
33952,1,1,398,1340,942
33953,1,0,39,0,-39
33954,1,0,21,0,-21
33955,0,0,86,0,-86
33956,1,0,147,0,-147
33957,0,0,56,0,-56
33958,1,0,41,0,-41
33959,1,0,70,0,-70
33960,1,1,464,1447,983
33961,1,0,19,0,-19
33962,1,1,221,1482,1261
33963,1,1,641,1701,1060
33964,0,0,25,0,-25
33965,0,0,15,0,-15
33966,1,0,10,0,-10
33967,1,1,353,2475,2122
33968,0,0,69,0,-69
33969,1,1,223,2641,2418
33970,0,0,101,0,-101
33971,1,0,1,0,-1
33972,1,1,239,1343,1104
33973,0,0,9,0,-9
33974,1,0,5,0,-5
33975,1,1,245,1387,1142
33976,1,1,346,1283,937
33977,1,0,2,0,-2
33978,1,1,587,1353,766
33979,0,0,20,0,-20
33980,0,0,73,0,-73
33981,1,1,714,1240,526
33982,0,0,6,0,-6
33983,1,1,345,1689,1344
33984,0,0,122,0,-122
33985,1,0,56,0,-56
33986,0,0,12,0,-12
33987,0,0,3,0,-3
33988,1,0,108,0,-108
33989,0,0,84,0,-84
33990,0,0,2,0,-2
33991,1,1,839,1618,779
33992,0,0,29,0,-29
33993,1,0,80,0,-80
33994,1,0,77,0,-77
33995,0,0,15,0,-15
33996,0,0,69,0,-69
33997,0,0,12,0,-12
33998,0,0,24,0,-24
33999,0,0,3,0,-3
34000,1,1,1054,1526,472
34001,1,0,61,0,-61
34002,0,0,17,0,-17
34003,1,1,52,1558,1506
34004,0,0,0,0,0
34005,1,0,39,0,-39
34006,0,0,4,0,-4
34007,0,0,35,0,-35
34008,1,1,175,1283,1108
34009,1,1,63,1263,1200
34010,1,1,434,1201,767
34011,1,0,55,0,-55
34012,1,0,10,0,-10
34013,0,0,21,0,-21
34014,1,0,66,0,-66
34015,1,1,407,1953,1546
34016,1,1,374,1908,1534
34017,1,1,1402,1227,-175
34018,0,0,129,0,-129
34019,1,1,427,1269,842
34020,0,0,9,0,-9
34021,1,1,323,1306,983
34022,0,0,43,0,-43
34023,1,0,4,0,-4
34024,0,0,9,0,-9
34025,0,0,8,0,-8
34026,1,0,52,0,-52
34027,0,0,98,0,-98
34028,0,0,81,0,-81
34029,0,0,49,0,-49
34030,1,0,41,0,-41
34031,1,1,370,1360,990
34032,0,0,60,0,-60
34033,1,0,26,0,-26
34034,1,1,305,1536,1231
34035,1,1,443,1703,1260
34036,1,0,68,0,-68
34037,1,1,509,1348,839
34038,1,0,40,0,-40
34039,1,0,186,0,-186
34040,0,0,20,0,-20
34041,0,0,37,0,-37
34042,0,0,52,0,-52
34043,0,0,3,0,-3
34044,0,0,41,0,-41
34045,1,0,0,0,0
34046,1,0,32,0,-32
34047,1,0,80,0,-80
34048,0,0,18,0,-18
34049,0,0,33,0,-33
34050,0,0,67,0,-67
34051,1,1,26,1514,1488
34052,1,0,217,0,-217
34053,1,1,846,1411,565
34054,0,0,1,0,-1
34055,0,0,40,0,-40
34056,0,0,14,0,-14
34057,1,0,0,0,0
34058,1,1,290,1440,1150
34059,1,1,1956,1237,-719
34060,0,0,31,0,-31
34061,1,0,94,0,-94
34062,1,1,341,1358,1017
34063,1,0,29,0,-29
34064,1,0,9,0,-9
34065,0,0,100,0,-100
34066,1,0,54,0,-54
34067,0,0,65,0,-65
34068,1,1,437,1496,1059
34069,0,0,7,0,-7
34070,1,1,118,1651,1533
34071,0,0,3,0,-3
34072,0,0,97,0,-97
34073,1,1,66,1552,1486
34074,1,1,1434,1289,-145
34075,1,1,331,1238,907
34076,0,0,80,0,-80
34077,1,1,2844,1239,-1605
34078,1,1,1095,3287,2192
34079,0,0,0,0,0
34080,1,0,23,0,-23
34081,1,1,281,1609,1328
34082,1,0,128,0,-128
34083,0,0,10,0,-10
34084,1,0,22,0,-22
34085,1,0,11,0,-11
34086,1,0,100,0,-100
34087,1,1,668,1505,837
34088,0,0,12,0,-12
34089,1,1,38,1355,1317
34090,0,0,37,0,-37
34091,1,0,15,0,-15
34092,1,1,738,1938,1200
34093,1,0,40,0,-40
34094,1,0,98,0,-98
34095,0,0,17,0,-17
34096,0,0,36,0,-36
34097,0,0,16,0,-16
34098,1,1,1662,1220,-442
34099,0,0,57,0,-57
34100,1,0,41,0,-41
34101,0,0,25,0,-25
34102,1,1,160,1676,1516
34103,1,0,35,0,-35
34104,1,0,14,0,-14
34105,0,0,16,0,-16
34106,1,1,62,1202,1140
34107,0,0,13,0,-13
34108,0,0,61,0,-61
34109,1,0,24,0,-24
34110,1,0,110,0,-110
34111,1,0,20,0,-20
34112,1,0,161,0,-161
34113,0,0,20,0,-20
34114,1,0,38,0,-38
34115,1,1,39,1503,1464
34116,0,0,55,0,-55
34117,1,0,15,0,-15
34118,1,0,9,0,-9
34119,1,1,207,3152,2945
34120,1,1,371,1340,969
34121,0,0,31,0,-31
34122,1,1,560,1273,713
34123,1,0,57,0,-57
34124,1,0,122,0,-122
34125,1,1,533,1325,792
34126,1,0,123,0,-123
34127,1,1,615,1212,597
34128,1,0,165,0,-165
34129,1,0,34,0,-34
34130,0,0,34,0,-34
34131,1,0,32,0,-32
34132,1,0,33,0,-33
34133,0,0,25,0,-25
34134,1,1,65,1737,1672
34135,1,0,135,0,-135
34136,1,0,22,0,-22
34137,0,0,7,0,-7
34138,1,1,313,3646,3333
34139,0,0,68,0,-68
34140,0,0,25,0,-25
34141,1,0,6,0,-6
34142,1,1,1604,1842,238
34143,1,0,32,0,-32
34144,0,0,116,0,-116
34145,1,1,76,1619,1543
34146,1,0,7,0,-7
34147,0,0,75,0,-75
34148,1,0,25,0,-25
34149,1,1,571,1316,745
34150,1,0,5,0,-5
34151,1,0,48,0,-48
34152,1,0,0,0,0
34153,1,0,2,0,-2
34154,0,0,18,0,-18
34155,0,0,14,0,-14
34156,0,0,48,0,-48
34157,1,0,37,0,-37
34158,0,0,19,0,-19
34159,0,0,16,0,-16
34160,1,0,122,0,-122
34161,0,0,16,0,-16
34162,0,0,10,0,-10
34163,0,0,12,0,-12
34164,1,0,57,0,-57
34165,0,0,10,0,-10
34166,0,0,82,0,-82
34167,1,0,20,0,-20
34168,1,1,227,1643,1416
34169,0,0,40,0,-40
34170,0,0,1,0,-1
34171,1,1,2968,1211,-1757
34172,1,1,63,1314,1251
34173,1,0,37,0,-37
34174,1,1,736,1317,581
34175,0,0,84,0,-84
34176,1,0,70,0,-70
34177,0,0,170,0,-170
34178,0,0,17,0,-17
34179,1,1,91,2085,1994
34180,0,0,10,0,-10
34181,1,0,10,0,-10
34182,0,0,157,0,-157
34183,0,0,195,0,-195
34184,1,0,15,0,-15
34185,0,0,135,0,-135
34186,1,1,258,1630,1372
34187,0,0,31,0,-31
34188,0,0,183,0,-183
34189,1,1,140,1441,1301
34190,0,0,4,0,-4
34191,1,0,2,0,-2
34192,1,1,247,1308,1061
34193,1,0,74,0,-74
34194,1,0,33,0,-33
34195,0,0,8,0,-8
34196,1,0,16,0,-16
34197,1,0,31,0,-31
34198,0,0,18,0,-18
34199,0,0,20,0,-20
34200,1,0,15,0,-15
34201,1,1,84,1573,1489
34202,1,1,851,1383,532
34203,1,0,7,0,-7
34204,1,0,42,0,-42
34205,1,0,22,0,-22
34206,1,1,129,1625,1496
34207,1,0,44,0,-44
34208,1,1,2117,1241,-876
34209,1,0,21,0,-21
34210,1,0,147,0,-147
34211,0,0,79,0,-79
34212,1,0,56,0,-56
34213,0,0,61,0,-61
34214,1,1,173,1554,1381
34215,1,1,152,1403,1251
34216,1,0,33,0,-33
34217,1,0,109,0,-109
34218,1,1,49,1287,1238
34219,0,0,2,0,-2
34220,1,1,261,1397,1136
34221,1,0,115,0,-115
34222,1,1,94,2019,1925
34223,1,1,2440,1575,-865
34224,1,1,774,1205,431
34225,0,0,74,0,-74
34226,0,0,21,0,-21
34227,0,0,41,0,-41
34228,1,0,16,0,-16
34229,1,1,120,1318,1198
34230,0,0,30,0,-30
34231,1,1,264,1463,1199
34232,1,1,1472,1405,-67
34233,1,0,42,0,-42
34234,0,0,64,0,-64
34235,1,1,164,1422,1258
34236,1,0,39,0,-39
34237,1,0,9,0,-9
34238,1,1,32,1460,1428
34239,1,1,362,1494,1132
34240,1,0,33,0,-33
34241,1,0,37,0,-37
34242,0,0,121,0,-121
34243,0,0,75,0,-75
34244,1,1,784,1411,627
34245,1,1,65,1390,1325
34246,1,1,559,1300,741
34247,1,0,6,0,-6
34248,0,0,32,0,-32
34249,1,0,10,0,-10
34250,0,0,45,0,-45
34251,1,1,65,1546,1481
34252,1,0,26,0,-26
34253,1,1,462,1428,966
34254,1,0,76,0,-76
34255,1,1,499,1443,944
34256,0,0,153,0,-153
34257,1,0,17,0,-17
34258,0,0,18,0,-18
34259,1,0,35,0,-35
34260,0,0,134,0,-134
34261,0,0,11,0,-11
34262,1,0,5,0,-5
34263,1,0,83,0,-83
34264,1,0,26,0,-26
34265,1,1,282,1604,1322
34266,0,0,5,0,-5
34267,1,0,24,0,-24
34268,1,1,528,1212,684
34269,1,1,217,1806,1589
34270,0,0,31,0,-31
34271,0,0,3,0,-3
34272,1,1,302,1236,934
34273,0,0,4,0,-4
34274,0,0,6,0,-6
34275,0,0,15,0,-15
34276,1,0,5,0,-5
34277,1,1,507,1210,703
34278,1,1,642,1308,666
34279,0,0,0,0,0
34280,1,1,726,1322,596
34281,1,0,167,0,-167
34282,1,1,61,1253,1192
34283,0,0,76,0,-76
34284,1,1,1440,1615,175
34285,1,1,422,1339,917
34286,1,0,25,0,-25
34287,1,0,49,0,-49
34288,1,1,71,1205,1134
34289,0,0,56,0,-56
34290,1,1,292,1209,917
34291,1,0,22,0,-22
34292,0,0,11,0,-11
34293,1,0,146,0,-146
34294,1,0,31,0,-31
34295,0,0,4,0,-4
34296,0,0,76,0,-76
34297,0,0,150,0,-150
34298,1,1,95,1321,1226
34299,1,0,22,0,-22
34300,1,0,81,0,-81
34301,1,1,634,1270,636
34302,1,0,5,0,-5
34303,0,0,53,0,-53
34304,1,0,0,0,0
34305,1,0,36,0,-36
34306,0,0,0,0,0
34307,1,1,23,1209,1186
34308,1,0,41,0,-41
34309,1,1,936,1228,292
34310,1,0,14,0,-14
34311,0,0,27,0,-27
34312,0,0,98,0,-98
34313,1,1,499,1514,1015
34314,1,0,52,0,-52
34315,0,0,3,0,-3
34316,1,1,1956,1705,-251
34317,0,0,89,0,-89
34318,0,0,3,0,-3
34319,1,0,42,0,-42
34320,0,0,23,0,-23
34321,1,0,18,0,-18
34322,1,0,7,0,-7
34323,0,0,194,0,-194
34324,1,0,72,0,-72
34325,0,0,16,0,-16
34326,1,0,54,0,-54
34327,0,0,24,0,-24
34328,1,0,5,0,-5
34329,1,0,98,0,-98
34330,1,1,477,1269,792
34331,1,0,45,0,-45
34332,1,1,147,1219,1072
34333,0,0,96,0,-96
34334,1,0,109,0,-109
34335,0,0,39,0,-39
34336,0,0,23,0,-23
34337,0,0,144,0,-144
34338,1,0,48,0,-48
34339,0,0,7,0,-7
34340,1,1,81,1276,1195
34341,1,0,82,0,-82
34342,0,0,65,0,-65
34343,1,1,952,1894,942
34344,0,0,43,0,-43
34345,1,0,98,0,-98
34346,0,0,2,0,-2
34347,1,0,13,0,-13
34348,0,0,39,0,-39
34349,1,0,63,0,-63
34350,1,1,1679,1351,-328
34351,0,0,40,0,-40
34352,0,0,136,0,-136
34353,1,1,868,1399,531
34354,1,1,659,1623,964
34355,0,0,27,0,-27
34356,1,0,8,0,-8
34357,1,0,90,0,-90
34358,1,0,56,0,-56
34359,0,0,114,0,-114
34360,1,1,355,1628,1273
34361,1,0,62,0,-62
34362,1,1,1063,1751,688
34363,0,0,66,0,-66
34364,1,0,5,0,-5
34365,1,0,19,0,-19
34366,0,0,31,0,-31
34367,1,1,46,1322,1276
34368,1,1,157,1760,1603
34369,1,0,1,0,-1
34370,1,0,99,0,-99
34371,0,0,27,0,-27
34372,1,1,164,2978,2814
34373,1,0,33,0,-33
34374,1,0,9,0,-9
34375,1,1,113,1513,1400
34376,1,1,504,1314,810
34377,1,0,21,0,-21
34378,1,0,60,0,-60
34379,0,0,62,0,-62
34380,1,0,9,0,-9
34381,0,0,33,0,-33
34382,1,1,980,1441,461
34383,1,1,333,1206,873
34384,0,0,14,0,-14
34385,1,1,173,1906,1733
34386,1,0,10,0,-10
34387,1,0,35,0,-35
34388,0,0,5,0,-5
34389,1,0,43,0,-43
34390,0,0,3,0,-3
34391,0,0,48,0,-48
34392,0,0,35,0,-35
34393,0,0,38,0,-38
34394,0,0,12,0,-12
34395,1,0,12,0,-12
34396,0,0,57,0,-57
34397,0,0,3,0,-3
34398,1,0,176,0,-176
34399,1,1,1805,1613,-192
34400,1,1,91,1261,1170
34401,0,0,88,0,-88
34402,0,0,65,0,-65
34403,0,0,52,0,-52
34404,1,0,66,0,-66
34405,0,0,2,0,-2
34406,0,0,17,0,-17
34407,0,0,59,0,-59
34408,1,0,54,0,-54
34409,0,0,12,0,-12
34410,1,0,7,0,-7
34411,1,0,34,0,-34
34412,0,0,21,0,-21
34413,0,0,39,0,-39
34414,1,1,19,1932,1913
34415,1,1,864,1437,573
34416,1,1,844,1435,591
34417,1,1,98,2589,2491
34418,1,1,1828,2129,301
34419,1,1,475,1820,1345
34420,1,0,56,0,-56
34421,0,0,156,0,-156
34422,1,1,412,1972,1560
34423,0,0,36,0,-36
34424,1,1,811,1207,396
34425,1,1,410,1593,1183
34426,1,1,268,3260,2992
34427,1,0,110,0,-110
34428,0,0,58,0,-58
34429,1,1,252,1869,1617
34430,1,0,17,0,-17
34431,1,0,10,0,-10
34432,1,1,3584,1826,-1758
34433,1,0,22,0,-22
34434,1,1,265,1400,1135
34435,1,1,326,1768,1442
34436,0,0,23,0,-23
34437,1,1,923,1609,686
34438,0,0,13,0,-13
34439,1,0,184,0,-184
34440,1,1,41,1323,1282
34441,1,1,81,1388,1307
34442,1,0,8,0,-8
34443,1,1,1660,1253,-407
34444,0,0,104,0,-104
34445,1,0,112,0,-112
34446,1,0,31,0,-31
34447,0,0,3,0,-3
34448,0,0,172,0,-172
34449,1,0,8,0,-8
34450,1,1,140,1223,1083
34451,1,0,113,0,-113
34452,1,1,564,1447,883
34453,0,0,63,0,-63
34454,1,0,4,0,-4
34455,0,0,93,0,-93
34456,1,1,76,1289,1213
34457,1,0,184,0,-184
34458,0,0,10,0,-10
34459,0,0,114,0,-114
34460,1,1,382,1764,1382
34461,1,1,708,1330,622
34462,1,1,1550,1950,400
34463,1,0,66,0,-66
34464,1,0,30,0,-30
34465,1,0,58,0,-58
34466,1,1,128,1221,1093
34467,1,0,13,0,-13
34468,1,0,28,0,-28
34469,1,0,36,0,-36
34470,1,0,32,0,-32
34471,1,1,441,1300,859
34472,1,0,3,0,-3
34473,0,0,36,0,-36
34474,0,0,470,0,-470
34475,1,1,905,1597,692
34476,1,1,77,1533,1456
34477,1,1,738,1451,713
34478,1,0,24,0,-24
34479,0,0,121,0,-121
34480,1,0,101,0,-101
34481,0,0,65,0,-65
34482,1,1,1026,1269,243
34483,0,0,29,0,-29
34484,0,0,46,0,-46
34485,1,0,85,0,-85
34486,0,0,101,0,-101
34487,0,0,6,0,-6
34488,1,1,799,1292,493
34489,1,0,566,0,-566
34490,0,0,3,0,-3
34491,1,0,51,0,-51
34492,1,0,87,0,-87
34493,0,0,21,0,-21
34494,0,0,167,0,-167
34495,1,0,108,0,-108
34496,1,0,35,0,-35
34497,0,0,119,0,-119
34498,0,0,25,0,-25
34499,1,0,19,0,-19
34500,0,0,3,0,-3
34501,1,1,929,1424,495
34502,1,1,235,1609,1374
34503,1,0,23,0,-23
34504,1,1,1008,1442,434
34505,1,0,34,0,-34
34506,0,0,259,0,-259
34507,0,0,74,0,-74
34508,1,0,0,0,0
34509,1,1,265,1988,1723
34510,0,0,47,0,-47
34511,0,0,41,0,-41
34512,1,1,2041,1489,-552
34513,1,0,63,0,-63
34514,0,0,15,0,-15
34515,1,0,54,0,-54
34516,1,1,79,1304,1225
34517,1,0,103,0,-103
34518,0,0,22,0,-22
34519,0,0,114,0,-114
34520,0,0,99,0,-99
34521,0,0,41,0,-41
34522,0,0,126,0,-126
34523,1,0,19,0,-19
34524,1,0,51,0,-51
34525,1,0,19,0,-19
34526,0,0,16,0,-16
34527,1,1,167,2370,2203
34528,1,1,185,1717,1532
34529,0,0,28,0,-28
34530,0,0,23,0,-23
34531,1,0,5,0,-5
34532,0,0,33,0,-33
34533,1,0,2,0,-2
34534,1,1,880,1404,524
34535,0,0,12,0,-12
34536,0,0,75,0,-75
34537,0,0,53,0,-53
34538,0,0,0,0,0
34539,0,0,46,0,-46
34540,0,0,4,0,-4
34541,0,0,49,0,-49
34542,1,0,117,0,-117
34543,1,0,12,0,-12
34544,1,1,497,2124,1627
34545,1,0,91,0,-91
34546,0,0,14,0,-14
34547,1,0,1,0,-1
34548,1,0,56,0,-56
34549,1,1,1424,1379,-45
34550,0,0,6,0,-6
34551,1,1,259,1239,980
34552,0,0,132,0,-132
34553,0,0,73,0,-73
34554,0,0,40,0,-40
34555,1,1,303,1258,955
34556,0,0,32,0,-32
34557,1,1,295,1695,1400
34558,0,0,1,0,-1
34559,0,0,31,0,-31
34560,1,0,80,0,-80
34561,1,0,232,0,-232
34562,1,0,9,0,-9
34563,0,0,73,0,-73
34564,1,1,297,1656,1359
34565,0,0,43,0,-43
34566,0,0,83,0,-83
34567,0,0,59,0,-59
34568,0,0,36,0,-36
34569,1,1,104,1297,1193
34570,1,0,17,0,-17
34571,0,0,34,0,-34
34572,1,1,527,1468,941
34573,1,0,6,0,-6
34574,1,0,64,0,-64
34575,1,0,40,0,-40
34576,1,0,29,0,-29
34577,1,0,15,0,-15
34578,1,0,13,0,-13
34579,0,0,108,0,-108
34580,1,0,11,0,-11
34581,1,0,63,0,-63
34582,0,0,72,0,-72
34583,1,0,32,0,-32
34584,1,0,185,0,-185
34585,0,0,3,0,-3
34586,0,0,102,0,-102
34587,0,0,119,0,-119
34588,1,0,3,0,-3
34589,0,0,111,0,-111
34590,0,0,27,0,-27
34591,1,1,446,1359,913
34592,1,1,230,1425,1195
34593,0,0,88,0,-88
34594,0,0,39,0,-39
34595,1,0,50,0,-50
34596,1,1,1064,1478,414
34597,0,0,64,0,-64
34598,0,0,42,0,-42
34599,0,0,89,0,-89
34600,1,0,85,0,-85
34601,1,0,27,0,-27
34602,1,0,31,0,-31
34603,1,0,35,0,-35
34604,1,1,1031,1589,558
34605,0,0,3,0,-3
34606,0,0,56,0,-56
34607,0,0,114,0,-114
34608,1,1,1241,1252,11
34609,1,1,490,1870,1380
34610,1,0,118,0,-118
34611,1,1,957,1234,277
34612,1,0,11,0,-11
34613,1,1,295,1364,1069
34614,0,0,31,0,-31
34615,0,0,5,0,-5
34616,0,0,5,0,-5
34617,1,0,18,0,-18
34618,1,0,81,0,-81
34619,1,1,189,1551,1362
34620,1,0,8,0,-8
34621,1,0,18,0,-18
34622,1,1,454,1315,861
34623,0,0,27,0,-27
34624,1,0,17,0,-17
34625,0,0,26,0,-26
34626,1,1,1054,1297,243
34627,0,0,140,0,-140
34628,1,0,56,0,-56
34629,1,1,310,1452,1142
34630,1,0,136,0,-136
34631,1,1,62,1342,1280
34632,1,0,8,0,-8
34633,1,1,104,1213,1109
34634,0,0,20,0,-20
34635,1,0,53,0,-53
34636,1,1,153,1274,1121
34637,1,0,6,0,-6
34638,0,0,23,0,-23
34639,0,0,64,0,-64
34640,1,1,401,1240,839
34641,0,0,25,0,-25
34642,0,0,24,0,-24
34643,1,0,1,0,-1
34644,0,0,61,0,-61
34645,1,0,173,0,-173
34646,1,1,819,1387,568
34647,0,0,46,0,-46
34648,0,0,105,0,-105
34649,1,1,571,1233,662
34650,0,0,326,0,-326
34651,1,1,324,1239,915
34652,0,0,12,0,-12
34653,1,1,570,1487,917
34654,1,0,32,0,-32
34655,0,0,17,0,-17
34656,1,1,1771,1392,-379
34657,1,0,79,0,-79
34658,0,0,19,0,-19
34659,1,0,3,0,-3
34660,1,1,176,1357,1181
34661,1,1,1479,1240,-239
34662,0,0,13,0,-13
34663,1,1,979,2925,1946
34664,0,0,99,0,-99
34665,1,1,616,1264,648
34666,0,0,84,0,-84
34667,0,0,23,0,-23
34668,1,1,647,1436,789
34669,1,1,657,1445,788
34670,1,0,19,0,-19
34671,0,0,13,0,-13
34672,0,0,20,0,-20
34673,1,0,4,0,-4
34674,1,0,8,0,-8
34675,1,0,8,0,-8
34676,0,0,7,0,-7
34677,1,1,74,1243,1169
34678,1,0,20,0,-20
34679,0,0,66,0,-66
34680,0,0,50,0,-50
34681,0,0,18,0,-18
34682,1,0,82,0,-82
34683,1,1,452,2627,2175
34684,0,0,40,0,-40
34685,0,0,75,0,-75
34686,0,0,102,0,-102
34687,1,0,4,0,-4
34688,0,0,61,0,-61
34689,1,0,24,0,-24
34690,1,1,626,2023,1397
34691,1,1,484,3015,2531
34692,1,0,52,0,-52
34693,0,0,8,0,-8
34694,1,0,138,0,-138
34695,1,1,392,1721,1329
34696,0,0,12,0,-12
34697,0,0,28,0,-28
34698,0,0,20,0,-20
34699,1,0,8,0,-8
34700,1,1,146,1388,1242
34701,1,0,127,0,-127
34702,1,0,18,0,-18
34703,0,0,27,0,-27
34704,1,1,177,1368,1191
34705,1,0,2,0,-2
34706,1,0,20,0,-20
34707,0,0,31,0,-31
34708,0,0,231,0,-231
34709,0,0,38,0,-38
34710,0,0,97,0,-97
34711,1,1,346,1406,1060
34712,1,1,119,1677,1558
34713,0,0,37,0,-37
34714,1,1,74,1202,1128
34715,1,1,616,2735,2119
34716,0,0,48,0,-48
34717,1,1,68,1372,1304
34718,1,0,6,0,-6
34719,1,0,26,0,-26
34720,1,1,526,1265,739
34721,0,0,41,0,-41
34722,1,0,21,0,-21
34723,1,1,311,2725,2414
34724,1,0,6,0,-6
34725,1,1,1101,1234,133
34726,1,1,234,3686,3452
34727,1,1,1142,1211,69
34728,0,0,10,0,-10
34729,1,0,143,0,-143
34730,1,0,85,0,-85
34731,0,0,30,0,-30
34732,1,1,564,1452,888
34733,0,0,167,0,-167
34734,1,0,31,0,-31
34735,0,0,43,0,-43
34736,0,0,19,0,-19
34737,1,0,159,0,-159
34738,1,0,39,0,-39
34739,1,1,616,1300,684
34740,1,1,161,1262,1101
34741,0,0,70,0,-70
34742,1,0,166,0,-166
34743,1,0,124,0,-124
34744,0,0,94,0,-94
34745,0,0,5,0,-5
34746,0,0,39,0,-39
34747,1,0,18,0,-18
34748,1,1,604,1753,1149
34749,0,0,50,0,-50
34750,0,0,32,0,-32
34751,0,0,11,0,-11
34752,1,0,11,0,-11
34753,1,0,8,0,-8
34754,1,0,12,0,-12
34755,1,0,73,0,-73
34756,1,0,16,0,-16
34757,0,0,50,0,-50
34758,0,0,37,0,-37
34759,1,1,467,1306,839
34760,1,1,200,1636,1436
34761,0,0,1,0,-1
34762,1,1,171,1222,1051
34763,1,1,2107,1576,-531
34764,0,0,26,0,-26
34765,0,0,9,0,-9
34766,1,0,30,0,-30
34767,1,0,29,0,-29
34768,1,0,143,0,-143
34769,1,0,73,0,-73
34770,0,0,24,0,-24
34771,0,0,21,0,-21
34772,1,1,280,2460,2180
34773,0,0,32,0,-32
34774,0,0,69,0,-69
34775,0,0,1,0,-1
34776,1,0,75,0,-75
34777,1,1,400,1377,977
34778,1,0,36,0,-36
34779,1,1,1701,1304,-397
34780,1,0,22,0,-22
34781,1,0,21,0,-21
34782,1,1,179,1348,1169
34783,1,0,7,0,-7
34784,0,0,49,0,-49
34785,1,1,571,1723,1152
34786,1,1,448,1201,753
34787,0,0,3,0,-3
34788,1,1,675,1348,673
34789,0,0,83,0,-83
34790,0,0,18,0,-18
34791,0,0,21,0,-21
34792,0,0,67,0,-67
34793,1,0,53,0,-53
34794,1,1,1500,2096,596
34795,0,0,29,0,-29
34796,1,1,46,1367,1321
34797,0,0,10,0,-10
34798,0,0,68,0,-68
34799,1,0,4,0,-4
34800,1,0,47,0,-47
34801,1,0,126,0,-126
34802,1,1,672,1360,688
34803,0,0,84,0,-84
34804,1,1,232,1246,1014
34805,0,0,117,0,-117
34806,0,0,91,0,-91
34807,1,1,1158,1657,499
34808,1,0,49,0,-49
34809,0,0,92,0,-92
34810,0,0,57,0,-57
34811,1,1,191,1256,1065
34812,0,0,198,0,-198
34813,1,0,22,0,-22
34814,1,1,323,2197,1874
34815,0,0,5,0,-5
34816,1,0,12,0,-12
34817,1,0,53,0,-53
34818,0,0,41,0,-41
34819,0,0,193,0,-193
34820,1,1,876,1550,674
34821,1,1,605,1548,943
34822,1,1,363,1411,1048
34823,0,0,19,0,-19
34824,0,0,149,0,-149
34825,1,0,11,0,-11
34826,1,1,233,1733,1500
34827,1,0,18,0,-18
34828,1,0,227,0,-227
34829,0,0,5,0,-5
34830,0,0,213,0,-213
34831,1,0,46,0,-46
34832,1,1,958,2076,1118
34833,0,0,160,0,-160
34834,1,1,308,1287,979
34835,1,0,12,0,-12
34836,1,0,146,0,-146
34837,0,0,64,0,-64
34838,1,1,637,1388,751
34839,1,0,13,0,-13
34840,1,1,569,1283,714
34841,1,0,7,0,-7
34842,1,1,59,2619,2560
34843,0,0,173,0,-173
34844,1,0,6,0,-6
34845,0,0,14,0,-14
34846,0,0,11,0,-11
34847,0,0,3,0,-3
34848,1,0,126,0,-126
34849,1,0,176,0,-176
34850,0,0,22,0,-22
34851,1,0,26,0,-26
34852,0,0,75,0,-75
34853,1,1,240,1622,1382
34854,0,0,76,0,-76
34855,1,0,3,0,-3
34856,1,0,74,0,-74
34857,0,0,30,0,-30
34858,1,1,648,1319,671
34859,0,0,36,0,-36
34860,0,0,69,0,-69
34861,1,1,360,1534,1174
34862,0,0,13,0,-13
34863,1,0,11,0,-11
34864,0,0,52,0,-52
34865,0,0,13,0,-13
34866,1,1,810,1531,721
34867,1,0,19,0,-19
34868,0,0,134,0,-134
34869,1,1,837,1251,414
34870,0,0,22,0,-22
34871,0,0,19,0,-19
34872,0,0,120,0,-120
34873,1,0,77,0,-77
34874,1,0,17,0,-17
34875,0,0,58,0,-58
34876,1,1,334,1250,916
34877,0,0,25,0,-25
34878,0,0,77,0,-77
34879,0,0,65,0,-65
34880,1,1,39,1231,1192
34881,1,0,62,0,-62
34882,0,0,63,0,-63
34883,0,0,13,0,-13
34884,1,0,40,0,-40
34885,1,1,527,1651,1124
34886,1,0,25,0,-25
34887,0,0,28,0,-28
34888,0,0,141,0,-141
34889,0,0,12,0,-12
34890,1,1,624,1922,1298
34891,1,0,22,0,-22
34892,1,1,704,1461,757
34893,1,1,342,1328,986
34894,0,0,165,0,-165
34895,0,0,50,0,-50
34896,0,0,3,0,-3
34897,0,0,45,0,-45
34898,0,0,8,0,-8
34899,1,0,25,0,-25
34900,1,0,48,0,-48
34901,0,0,116,0,-116
34902,1,0,16,0,-16
34903,1,0,19,0,-19
34904,0,0,47,0,-47
34905,1,0,40,0,-40
34906,0,0,20,0,-20
34907,0,0,65,0,-65
34908,0,0,1,0,-1
34909,0,0,67,0,-67
34910,1,0,7,0,-7
34911,1,1,462,1289,827
34912,1,1,532,1987,1455
34913,1,1,1552,1654,102
34914,0,0,210,0,-210
34915,1,1,363,1658,1295
34916,1,1,463,1419,956
34917,1,0,3,0,-3
34918,0,0,0,0,0
34919,1,1,179,1212,1033
34920,1,0,20,0,-20
34921,0,0,48,0,-48
34922,0,0,23,0,-23
34923,0,0,41,0,-41
34924,0,0,89,0,-89
34925,1,0,18,0,-18
34926,0,0,13,0,-13
34927,1,0,261,0,-261
34928,1,1,397,2024,1627
34929,1,1,283,1477,1194
34930,0,0,30,0,-30
34931,0,0,21,0,-21
34932,0,0,78,0,-78
34933,1,0,6,0,-6
34934,1,0,1,0,-1
34935,1,0,9,0,-9
34936,0,0,78,0,-78
34937,1,0,10,0,-10
34938,1,0,0,0,0
34939,1,1,2580,1519,-1061
34940,0,0,89,0,-89
34941,0,0,9,0,-9
34942,0,0,84,0,-84
34943,1,1,426,1340,914
34944,0,0,0,0,0
34945,1,0,18,0,-18
34946,1,0,164,0,-164
34947,1,0,6,0,-6
34948,0,0,14,0,-14
34949,0,0,49,0,-49
34950,0,0,16,0,-16
34951,1,1,814,1650,836
34952,1,1,525,1670,1145
34953,0,0,49,0,-49
34954,0,0,51,0,-51
34955,0,0,92,0,-92
34956,1,0,66,0,-66
34957,1,1,38,1217,1179
34958,0,0,38,0,-38
34959,0,0,21,0,-21
34960,0,0,81,0,-81
34961,1,0,40,0,-40
34962,1,0,91,0,-91
34963,0,0,38,0,-38
34964,0,0,6,0,-6
34965,1,0,28,0,-28
34966,1,1,1138,1533,395
34967,0,0,21,0,-21
34968,1,0,86,0,-86
34969,0,0,6,0,-6
34970,1,1,630,1358,728
34971,0,0,5,0,-5
34972,1,1,278,1285,1007
34973,0,0,74,0,-74
34974,1,0,112,0,-112
34975,0,0,74,0,-74
34976,1,0,12,0,-12
34977,0,0,46,0,-46
34978,1,0,271,0,-271
34979,1,1,159,2036,1877
34980,0,0,25,0,-25
34981,0,0,92,0,-92
34982,1,1,345,1225,880
34983,0,0,54,0,-54
34984,1,0,0,0,0
34985,1,1,90,1216,1126
34986,0,0,14,0,-14
34987,0,0,2,0,-2
34988,1,1,1680,2199,519
34989,1,1,183,1270,1087
34990,0,0,18,0,-18
34991,1,1,1101,1359,258
34992,1,1,908,1484,576
34993,0,0,50,0,-50
34994,1,1,483,1221,738
34995,0,0,199,0,-199
34996,0,0,36,0,-36
34997,1,1,1573,1847,274
34998,1,1,30,1284,1254
34999,0,0,13,0,-13
35000,0,0,102,0,-102
35001,0,0,50,0,-50
35002,0,0,93,0,-93
35003,1,0,21,0,-21
35004,0,0,0,0,0
35005,1,1,177,1292,1115
35006,1,0,50,0,-50
35007,1,0,98,0,-98
35008,1,0,62,0,-62
35009,1,0,95,0,-95
35010,0,0,65,0,-65
35011,1,1,176,1543,1367
35012,0,0,35,0,-35
35013,1,0,21,0,-21
35014,0,0,109,0,-109
35015,1,1,902,2958,2056
35016,1,1,102,1236,1134
35017,1,1,305,1346,1041
35018,0,0,81,0,-81
35019,1,0,48,0,-48
35020,1,0,3,0,-3
35021,1,0,31,0,-31
35022,1,1,425,1707,1282
35023,0,0,124,0,-124
35024,1,0,54,0,-54
35025,1,0,2,0,-2
35026,1,0,189,0,-189
35027,0,0,164,0,-164
35028,1,0,35,0,-35
35029,1,0,43,0,-43
35030,1,1,504,1475,971
35031,1,1,441,1386,945
35032,1,0,17,0,-17
35033,1,1,417,1814,1397
35034,1,1,520,1222,702
35035,1,1,257,1364,1107
35036,1,0,57,0,-57
35037,0,0,7,0,-7
35038,1,1,278,1679,1401
35039,1,0,23,0,-23
35040,1,0,36,0,-36
35041,1,1,597,1568,971
35042,1,1,379,1391,1012
35043,1,0,64,0,-64
35044,0,0,6,0,-6
35045,1,1,609,1959,1350
35046,1,0,20,0,-20
35047,1,0,38,0,-38
35048,1,0,86,0,-86
35049,1,1,390,1219,829
35050,1,0,10,0,-10
35051,0,0,24,0,-24
35052,1,0,27,0,-27
35053,1,1,491,1328,837
35054,0,0,0,0,0
35055,0,0,2,0,-2
35056,1,0,85,0,-85
35057,1,0,29,0,-29
35058,1,0,31,0,-31
35059,0,0,22,0,-22
35060,0,0,81,0,-81
35061,0,0,3,0,-3
35062,1,0,12,0,-12
35063,0,0,13,0,-13
35064,0,0,8,0,-8
35065,0,0,141,0,-141
35066,1,1,120,1773,1653
35067,1,1,1283,1452,169
35068,0,0,239,0,-239
35069,1,1,310,1514,1204
35070,1,0,11,0,-11
35071,0,0,150,0,-150
35072,1,1,611,1232,621
35073,0,0,23,0,-23
35074,1,0,89,0,-89
35075,0,0,48,0,-48
35076,1,1,1545,1588,43
35077,1,1,475,2290,1815
35078,0,0,0,0,0
35079,0,0,49,0,-49
35080,0,0,72,0,-72
35081,1,0,70,0,-70
35082,0,0,37,0,-37
35083,0,0,15,0,-15
35084,1,1,433,1264,831
35085,0,0,50,0,-50
35086,1,1,1028,1286,258
35087,1,0,82,0,-82
35088,1,0,230,0,-230
35089,0,0,31,0,-31
35090,1,1,244,1313,1069
35091,1,0,54,0,-54
35092,0,0,11,0,-11
35093,1,0,31,0,-31
35094,1,0,13,0,-13
35095,1,1,1778,4109,2331
35096,1,0,16,0,-16
35097,0,0,23,0,-23
35098,1,1,77,1704,1627
35099,1,1,112,2947,2835
35100,1,0,50,0,-50
35101,0,0,24,0,-24
35102,1,1,712,1261,549
35103,0,0,40,0,-40
35104,1,1,749,1298,549
35105,1,0,31,0,-31
35106,0,0,20,0,-20
35107,1,0,5,0,-5
35108,0,0,36,0,-36
35109,1,1,202,1278,1076
35110,0,0,94,0,-94
35111,1,1,766,1502,736
35112,1,0,46,0,-46
35113,1,1,390,1491,1101
35114,1,1,165,1273,1108
35115,0,0,14,0,-14
35116,1,0,150,0,-150
35117,1,1,97,1205,1108
35118,1,0,8,0,-8
35119,1,1,1507,1443,-64
35120,1,0,3,0,-3
35121,0,0,5,0,-5
35122,0,0,44,0,-44
35123,1,0,77,0,-77
35124,1,1,78,1360,1282
35125,1,0,117,0,-117
35126,1,0,16,0,-16
35127,1,0,56,0,-56
35128,0,0,19,0,-19
35129,0,0,59,0,-59
35130,0,0,74,0,-74
35131,0,0,13,0,-13
35132,0,0,33,0,-33
35133,1,0,32,0,-32
35134,1,1,931,1947,1016
35135,1,1,709,1404,695
35136,0,0,8,0,-8
35137,0,0,0,0,0
35138,1,1,1477,1205,-272
35139,1,0,18,0,-18
35140,0,0,67,0,-67
35141,0,0,90,0,-90
35142,1,1,457,1516,1059
35143,1,1,179,1239,1060
35144,1,0,22,0,-22
35145,1,1,44,1352,1308
35146,1,0,57,0,-57
35147,1,0,8,0,-8
35148,1,1,296,1248,952
35149,0,0,35,0,-35
35150,0,0,53,0,-53
35151,1,0,84,0,-84
35152,1,0,94,0,-94
35153,1,1,680,1206,526
35154,1,0,98,0,-98
35155,0,0,4,0,-4
35156,1,1,1135,1776,641
35157,1,0,21,0,-21
35158,1,1,108,1575,1467
35159,1,0,132,0,-132
35160,0,0,21,0,-21
35161,1,1,414,1533,1119
35162,0,0,39,0,-39
35163,1,0,94,0,-94
35164,1,0,62,0,-62
35165,0,0,85,0,-85
35166,1,1,528,1508,980
35167,0,0,9,0,-9
35168,1,1,143,1415,1272
35169,0,0,48,0,-48
35170,0,0,70,0,-70
35171,1,1,250,1764,1514
35172,1,1,1128,1324,196
35173,1,0,70,0,-70
35174,1,0,6,0,-6
35175,1,0,17,0,-17
35176,1,0,0,0,0
35177,1,0,66,0,-66
35178,1,0,16,0,-16
35179,0,0,133,0,-133
35180,0,0,15,0,-15
35181,1,1,3062,1379,-1683
35182,0,0,29,0,-29
35183,0,0,3,0,-3
35184,1,1,1703,1811,108
35185,0,0,62,0,-62
35186,1,0,21,0,-21
35187,1,0,20,0,-20
35188,1,0,66,0,-66
35189,1,0,70,0,-70
35190,1,1,455,2453,1998
35191,1,1,585,1272,687
35192,1,1,194,1364,1170
35193,1,0,46,0,-46
35194,0,0,7,0,-7
35195,0,0,2,0,-2
35196,1,0,72,0,-72
35197,1,0,55,0,-55
35198,1,1,521,1425,904
35199,1,0,48,0,-48
35200,0,0,55,0,-55
35201,1,0,47,0,-47
35202,1,0,35,0,-35
35203,1,0,87,0,-87
35204,1,0,32,0,-32
35205,1,1,2368,1888,-480
35206,1,0,85,0,-85
35207,1,0,49,0,-49
35208,1,1,255,1281,1026
35209,1,0,53,0,-53
35210,1,0,2,0,-2
35211,1,1,510,3898,3388
35212,1,0,4,0,-4
35213,0,0,79,0,-79
35214,1,1,167,2124,1957
35215,0,0,7,0,-7
35216,1,0,63,0,-63
35217,1,0,63,0,-63
35218,1,0,19,0,-19
35219,1,1,926,1388,462
35220,1,0,33,0,-33
35221,0,0,84,0,-84
35222,0,0,0,0,0
35223,0,0,92,0,-92
35224,0,0,106,0,-106
35225,0,0,2,0,-2
35226,1,0,40,0,-40
35227,1,1,247,1537,1290
35228,0,0,115,0,-115
35229,1,1,349,1262,913
35230,0,0,108,0,-108
35231,1,0,27,0,-27
35232,0,0,5,0,-5
35233,1,1,339,1387,1048
35234,0,0,61,0,-61
35235,0,0,108,0,-108
35236,0,0,1,0,-1
35237,1,1,225,1491,1266
35238,1,0,10,0,-10
35239,1,0,30,0,-30
35240,1,1,220,1452,1232
35241,1,0,42,0,-42
35242,0,0,2,0,-2
35243,0,0,29,0,-29
35244,1,1,997,1259,262
35245,1,1,783,1290,507
35246,1,1,477,1327,850
35247,1,0,0,0,0
35248,0,0,16,0,-16
35249,1,1,62,1337,1275
35250,0,0,85,0,-85
35251,1,1,375,1221,846
35252,0,0,112,0,-112
35253,1,0,84,0,-84
35254,1,1,711,1312,601
35255,0,0,144,0,-144
35256,1,1,353,1218,865
35257,1,0,47,0,-47
35258,0,0,17,0,-17
35259,1,1,412,1443,1031
35260,1,1,41,1878,1837
35261,1,1,810,1667,857
35262,0,0,5,0,-5
35263,1,0,51,0,-51
35264,0,0,143,0,-143
35265,1,0,27,0,-27
35266,0,0,57,0,-57
35267,1,0,27,0,-27
35268,0,0,21,0,-21
35269,1,1,224,1375,1151
35270,1,0,72,0,-72
35271,0,0,15,0,-15
35272,0,0,38,0,-38
35273,1,0,69,0,-69
35274,1,1,223,1213,990
35275,0,0,7,0,-7
35276,0,0,85,0,-85
35277,0,0,110,0,-110
35278,0,0,0,0,0
35279,1,0,14,0,-14
35280,0,0,123,0,-123
35281,1,1,1873,2320,447
35282,0,0,42,0,-42
35283,1,1,442,1438,996
35284,1,0,2,0,-2
35285,0,0,90,0,-90
35286,0,0,33,0,-33
35287,1,0,36,0,-36
35288,1,1,195,2004,1809
35289,1,0,8,0,-8
35290,0,0,76,0,-76
35291,0,0,50,0,-50
35292,1,0,68,0,-68
35293,0,0,21,0,-21
35294,0,0,88,0,-88
35295,0,0,26,0,-26
35296,1,1,171,1357,1186
35297,1,1,186,1557,1371
35298,1,1,56,1593,1537
35299,1,1,345,1256,911
35300,0,0,57,0,-57
35301,0,0,3,0,-3
35302,0,0,51,0,-51
35303,0,0,2,0,-2
35304,1,1,287,1417,1130
35305,1,0,148,0,-148
35306,1,1,274,1656,1382
35307,1,1,629,2349,1720
35308,1,1,348,1359,1011
35309,0,0,14,0,-14
35310,1,1,91,1316,1225
35311,1,1,496,1935,1439
35312,0,0,100,0,-100
35313,0,0,10,0,-10
35314,0,0,4,0,-4
35315,1,0,52,0,-52
35316,1,1,2440,1871,-569
35317,1,0,8,0,-8
35318,0,0,7,0,-7
35319,0,0,76,0,-76
35320,0,0,30,0,-30
35321,1,0,111,0,-111
35322,0,0,22,0,-22
35323,0,0,23,0,-23
35324,1,0,8,0,-8
35325,1,1,258,1271,1013
35326,1,1,229,1626,1397
35327,0,0,107,0,-107
35328,0,0,56,0,-56
35329,0,0,38,0,-38
35330,0,0,25,0,-25
35331,1,1,118,1222,1104
35332,1,1,261,1602,1341
35333,1,0,13,0,-13
35334,1,1,222,1306,1084
35335,1,0,18,0,-18
35336,0,0,16,0,-16
35337,0,0,64,0,-64
35338,1,1,25,1560,1535
35339,0,0,44,0,-44
35340,0,0,39,0,-39
35341,1,0,9,0,-9
35342,1,1,186,1560,1374
35343,0,0,28,0,-28
35344,0,0,24,0,-24
35345,1,1,604,1453,849
35346,1,1,241,1274,1033
35347,1,0,17,0,-17
35348,0,0,1,0,-1
35349,1,1,1706,1250,-456
35350,1,0,2,0,-2
35351,1,1,741,1252,511
35352,0,0,1,0,-1
35353,1,0,14,0,-14
35354,1,1,1377,1202,-175
35355,1,0,30,0,-30
35356,1,0,5,0,-5
35357,1,1,326,1970,1644
35358,1,1,397,1348,951
35359,1,0,36,0,-36
35360,0,0,29,0,-29
35361,0,0,13,0,-13
35362,1,0,17,0,-17
35363,1,1,128,2496,2368
35364,0,0,55,0,-55
35365,1,0,35,0,-35
35366,1,1,235,2067,1832
35367,0,0,6,0,-6
35368,0,0,64,0,-64
35369,0,0,70,0,-70
35370,1,1,441,1561,1120
35371,1,0,1,0,-1
35372,1,0,45,0,-45
35373,0,0,16,0,-16
35374,1,0,6,0,-6
35375,1,1,118,1977,1859
35376,0,0,31,0,-31
35377,1,0,37,0,-37
35378,1,1,58,2679,2621
35379,1,0,12,0,-12
35380,1,0,43,0,-43
35381,1,0,4,0,-4
35382,0,0,4,0,-4
35383,1,0,55,0,-55
35384,0,0,16,0,-16
35385,0,0,7,0,-7
35386,1,0,33,0,-33
35387,1,0,32,0,-32
35388,0,0,74,0,-74
35389,1,1,209,1243,1034
35390,1,1,185,1218,1033
35391,0,0,74,0,-74
35392,0,0,10,0,-10
35393,1,0,218,0,-218
35394,0,0,13,0,-13
35395,1,1,1093,1461,368
35396,1,1,189,1481,1292
35397,1,1,261,2414,2153
35398,1,1,74,1331,1257
35399,0,0,1,0,-1
35400,1,1,844,1307,463
35401,0,0,63,0,-63
35402,0,0,2,0,-2
35403,1,0,74,0,-74
35404,0,0,34,0,-34
35405,1,0,0,0,0
35406,1,0,13,0,-13
35407,0,0,31,0,-31
35408,0,0,2,0,-2
35409,0,0,55,0,-55
35410,0,0,9,0,-9
35411,1,1,210,1504,1294
35412,1,1,372,2577,2205
35413,1,1,1150,1285,135
35414,1,1,333,1595,1262
35415,0,0,23,0,-23
35416,0,0,131,0,-131
35417,1,0,18,0,-18
35418,1,1,1251,1313,62
35419,1,1,513,1268,755
35420,1,1,526,1526,1000
35421,0,0,21,0,-21
35422,1,1,131,1408,1277
35423,0,0,31,0,-31
35424,1,0,44,0,-44
35425,1,0,69,0,-69
35426,1,0,0,0,0
35427,1,0,35,0,-35
35428,0,0,43,0,-43
35429,0,0,37,0,-37
35430,1,0,55,0,-55
35431,0,0,62,0,-62
35432,0,0,315,0,-315
35433,1,0,37,0,-37
35434,0,0,3,0,-3
35435,1,1,1530,1220,-310
35436,1,1,825,1728,903
35437,1,1,358,2599,2241
35438,1,0,13,0,-13
35439,1,1,1165,1310,145
35440,0,0,38,0,-38
35441,1,1,355,1764,1409
35442,0,0,18,0,-18
35443,1,0,24,0,-24
35444,0,0,14,0,-14
35445,1,0,10,0,-10
35446,1,0,33,0,-33
35447,0,0,33,0,-33
35448,1,0,137,0,-137
35449,0,0,80,0,-80
35450,0,0,27,0,-27
35451,0,0,14,0,-14
35452,0,0,94,0,-94
35453,0,0,148,0,-148
35454,1,0,81,0,-81
35455,1,0,34,0,-34
35456,1,1,13,2076,2063
35457,1,0,97,0,-97
35458,1,1,630,1900,1270
35459,1,0,135,0,-135
35460,1,0,13,0,-13
35461,1,0,53,0,-53
35462,1,1,345,1524,1179
35463,1,1,855,2384,1529
35464,1,0,3,0,-3
35465,0,0,82,0,-82
35466,0,0,47,0,-47
35467,1,0,21,0,-21
35468,0,0,7,0,-7
35469,1,1,1465,1702,237
35470,0,0,122,0,-122
35471,1,0,2,0,-2
35472,0,0,18,0,-18
35473,0,0,13,0,-13
35474,0,0,75,0,-75
35475,1,0,16,0,-16
35476,1,0,138,0,-138
35477,1,1,1042,1313,271
35478,0,0,13,0,-13
35479,0,0,104,0,-104
35480,1,1,760,1241,481
35481,0,0,59,0,-59
35482,1,0,6,0,-6
35483,1,0,0,0,0
35484,0,0,45,0,-45
35485,1,1,70,1321,1251
35486,1,1,782,1483,701
35487,0,0,121,0,-121
35488,0,0,13,0,-13
35489,1,0,11,0,-11
35490,1,0,16,0,-16
35491,0,0,16,0,-16
35492,1,1,212,1529,1317
35493,0,0,64,0,-64
35494,0,0,18,0,-18
35495,1,0,147,0,-147
35496,1,1,284,1240,956
35497,1,0,53,0,-53
35498,1,1,117,1256,1139
35499,0,0,6,0,-6
35500,1,0,0,0,0
35501,1,0,43,0,-43
35502,1,0,111,0,-111
35503,1,1,173,1305,1132
35504,1,1,70,1691,1621
35505,1,1,261,1274,1013
35506,1,1,1007,1474,467
35507,1,0,41,0,-41
35508,1,0,36,0,-36
35509,0,0,5,0,-5
35510,0,0,31,0,-31
35511,1,1,216,1315,1099
35512,1,1,158,1235,1077
35513,0,0,40,0,-40
35514,1,0,14,0,-14
35515,1,1,1946,1423,-523
35516,0,0,1,0,-1
35517,0,0,1,0,-1
35518,0,0,130,0,-130
35519,1,0,54,0,-54
35520,1,0,112,0,-112
35521,1,1,147,1445,1298
35522,0,0,139,0,-139
35523,1,0,8,0,-8
35524,1,0,7,0,-7
35525,1,0,54,0,-54
35526,0,0,30,0,-30
35527,1,1,570,1386,816
35528,1,1,610,1235,625
35529,1,1,145,1212,1067
35530,1,1,464,2170,1706
35531,1,0,62,0,-62
35532,0,0,138,0,-138
35533,0,0,13,0,-13
35534,0,0,310,0,-310
35535,0,0,110,0,-110
35536,1,0,0,0,0
35537,0,0,13,0,-13
35538,1,1,85,1508,1423
35539,0,0,101,0,-101
35540,1,1,907,1296,389
35541,1,1,1020,1369,349
35542,1,1,204,1245,1041
35543,0,0,150,0,-150
35544,1,0,162,0,-162
35545,1,1,160,1688,1528
35546,0,0,3,0,-3
35547,0,0,46,0,-46
35548,1,0,8,0,-8
35549,1,0,3,0,-3
35550,1,0,1,0,-1
35551,1,1,555,1252,697
35552,0,0,2,0,-2
35553,1,0,11,0,-11
35554,1,0,1,0,-1
35555,0,0,78,0,-78
35556,0,0,62,0,-62
35557,1,1,39,1568,1529
35558,1,1,418,1259,841
35559,1,1,494,1392,898
35560,0,0,17,0,-17
35561,1,1,632,1272,640
35562,1,0,90,0,-90
35563,1,1,340,1975,1635
35564,0,0,13,0,-13
35565,0,0,2,0,-2
35566,1,0,46,0,-46
35567,1,0,42,0,-42
35568,1,1,1559,1623,64
35569,0,0,31,0,-31
35570,1,0,59,0,-59
35571,1,0,36,0,-36
35572,1,0,172,0,-172
35573,1,1,1880,1523,-357
35574,1,1,382,1491,1109
35575,1,1,451,2569,2118
35576,0,0,3,0,-3
35577,1,1,1361,1229,-132
35578,1,1,139,1936,1797
35579,0,0,35,0,-35
35580,0,0,3,0,-3
35581,1,1,281,1552,1271
35582,1,0,0,0,0
35583,0,0,18,0,-18
35584,0,0,22,0,-22
35585,0,0,10,0,-10
35586,0,0,55,0,-55
35587,0,0,4,0,-4
35588,1,1,850,1236,386
35589,1,1,105,1345,1240
35590,1,1,333,1624,1291
35591,0,0,18,0,-18
35592,0,0,44,0,-44
35593,1,0,70,0,-70
35594,0,0,202,0,-202
35595,1,0,16,0,-16
35596,1,1,21,2301,2280
35597,1,0,0,0,0
35598,0,0,244,0,-244
35599,1,0,4,0,-4
35600,1,0,42,0,-42
35601,0,0,152,0,-152
35602,1,1,68,1459,1391
35603,0,0,31,0,-31
35604,1,1,358,1351,993
35605,0,0,134,0,-134
35606,1,0,38,0,-38
35607,1,0,45,0,-45
35608,1,1,99,1253,1154
35609,1,0,7,0,-7
35610,0,0,223,0,-223
35611,1,0,10,0,-10
35612,0,0,180,0,-180
35613,1,0,1,0,-1
35614,0,0,5,0,-5
35615,1,1,1566,1221,-345
35616,1,0,16,0,-16
35617,1,0,25,0,-25
35618,0,0,9,0,-9
35619,1,0,23,0,-23
35620,1,1,952,1238,286
35621,0,0,27,0,-27
35622,1,0,6,0,-6
35623,1,0,65,0,-65
35624,1,0,131,0,-131
35625,1,1,377,1258,881
35626,1,0,57,0,-57
35627,1,1,222,1386,1164
35628,0,0,135,0,-135
35629,0,0,17,0,-17
35630,1,1,1622,1749,127
35631,1,0,17,0,-17
35632,1,1,673,1224,551
35633,1,0,49,0,-49
35634,0,0,8,0,-8
35635,0,0,18,0,-18
35636,0,0,95,0,-95
35637,1,1,272,1745,1473
35638,1,1,139,1214,1075
35639,0,0,67,0,-67
35640,1,1,308,1448,1140
35641,0,0,20,0,-20
35642,1,1,457,1231,774
35643,0,0,5,0,-5
35644,0,0,21,0,-21
35645,0,0,135,0,-135
35646,1,1,966,1925,959
35647,1,0,6,0,-6
35648,1,0,1,0,-1
35649,1,1,316,1275,959
35650,1,1,689,1536,847
35651,1,0,136,0,-136
35652,0,0,26,0,-26
35653,1,0,94,0,-94
35654,0,0,57,0,-57
35655,1,1,1024,1262,238
35656,0,0,27,0,-27
35657,1,0,118,0,-118
35658,1,0,117,0,-117
35659,1,1,457,1315,858
35660,1,0,45,0,-45
35661,1,1,119,1237,1118
35662,1,0,32,0,-32
35663,1,1,77,1389,1312
35664,1,1,555,1912,1357
35665,1,1,439,1872,1433
35666,0,0,58,0,-58
35667,1,0,21,0,-21
35668,0,0,7,0,-7
35669,1,0,115,0,-115
35670,1,1,341,2103,1762
35671,1,0,1,0,-1
35672,0,0,195,0,-195
35673,1,1,128,1504,1376
35674,1,0,0,0,0
35675,1,1,470,1208,738
35676,1,0,54,0,-54
35677,1,0,21,0,-21
35678,1,1,116,1740,1624
35679,0,0,238,0,-238
35680,0,0,169,0,-169
35681,1,1,468,1241,773
35682,0,0,59,0,-59
35683,1,1,897,1267,370
35684,1,0,66,0,-66
35685,1,1,265,1733,1468
35686,1,0,59,0,-59
35687,1,1,594,1319,725
35688,0,0,160,0,-160
35689,0,0,0,0,0
35690,0,0,8,0,-8
35691,1,0,33,0,-33
35692,0,0,20,0,-20
35693,0,0,25,0,-25
35694,1,0,5,0,-5
35695,0,0,72,0,-72
35696,0,0,68,0,-68
35697,0,0,40,0,-40
35698,0,0,2,0,-2
35699,0,0,5,0,-5
35700,1,1,705,1562,857
35701,0,0,11,0,-11
35702,0,0,7,0,-7
35703,0,0,289,0,-289
35704,0,0,108,0,-108
35705,1,0,7,0,-7
35706,0,0,31,0,-31
35707,1,0,20,0,-20
35708,1,0,24,0,-24
35709,0,0,22,0,-22
35710,0,0,25,0,-25
35711,0,0,11,0,-11
35712,1,1,323,1342,1019
35713,1,0,84,0,-84
35714,1,1,442,1475,1033
35715,1,0,0,0,0
35716,0,0,42,0,-42
35717,1,1,780,2053,1273
35718,0,0,42,0,-42
35719,1,0,24,0,-24
35720,1,1,558,1405,847
35721,1,1,115,3219,3104
35722,0,0,11,0,-11
35723,1,0,0,0,0
35724,1,0,55,0,-55
35725,1,1,80,1538,1458
35726,1,0,18,0,-18
35727,0,0,17,0,-17
35728,1,0,31,0,-31
35729,0,0,56,0,-56
35730,1,0,37,0,-37
35731,1,0,6,0,-6
35732,0,0,35,0,-35
35733,0,0,30,0,-30
35734,0,0,12,0,-12
35735,1,0,51,0,-51
35736,1,1,912,1524,612
35737,0,0,13,0,-13
35738,1,0,93,0,-93
35739,1,0,20,0,-20
35740,1,0,86,0,-86
35741,1,1,378,2045,1667
35742,0,0,37,0,-37
35743,1,1,411,1459,1048
35744,1,0,60,0,-60
35745,0,0,1,0,-1
35746,1,0,152,0,-152
35747,0,0,27,0,-27
35748,0,0,9,0,-9
35749,1,0,48,0,-48
35750,0,0,42,0,-42
35751,1,1,344,2933,2589
35752,0,0,272,0,-272
35753,0,0,187,0,-187
35754,0,0,29,0,-29
35755,1,1,743,6615,5872
35756,1,0,9,0,-9
35757,0,0,21,0,-21
35758,0,0,14,0,-14
35759,0,0,80,0,-80
35760,0,0,15,0,-15
35761,1,1,492,1829,1337
35762,1,1,242,1512,1270
35763,0,0,3,0,-3
35764,1,1,1532,1521,-11
35765,1,0,32,0,-32
35766,1,1,852,1859,1007
35767,0,0,28,0,-28
35768,1,0,35,0,-35
35769,0,0,4,0,-4
35770,0,0,0,0,0
35771,1,1,169,1460,1291
35772,0,0,16,0,-16
35773,1,0,138,0,-138
35774,0,0,41,0,-41
35775,0,0,47,0,-47
35776,0,0,37,0,-37
35777,1,0,25,0,-25
35778,1,1,189,1208,1019
35779,1,1,1027,1890,863
35780,1,1,2242,2860,618
35781,1,1,206,1322,1116
35782,1,0,149,0,-149
35783,0,0,1,0,-1
35784,1,1,94,2475,2381
35785,1,1,363,1449,1086
35786,1,1,248,1358,1110
35787,1,1,29,1326,1297
35788,1,1,82,3397,3315
35789,0,0,47,0,-47
35790,0,0,15,0,-15
35791,1,0,29,0,-29
35792,1,1,95,1542,1447
35793,0,0,0,0,0
35794,1,0,16,0,-16
35795,1,1,315,1525,1210
35796,0,0,54,0,-54
35797,1,1,167,1224,1057
35798,0,0,76,0,-76
35799,1,1,312,1211,899
35800,0,0,19,0,-19
35801,1,1,246,1244,998
35802,1,1,212,2829,2617
35803,0,0,42,0,-42
35804,0,0,8,0,-8
35805,0,0,25,0,-25
35806,0,0,5,0,-5
35807,0,0,43,0,-43
35808,1,0,70,0,-70
35809,0,0,146,0,-146
35810,0,0,10,0,-10
35811,0,0,39,0,-39
35812,1,1,1128,1414,286
35813,0,0,13,0,-13
35814,1,0,0,0,0
35815,1,1,46,1423,1377
35816,0,0,27,0,-27
35817,0,0,38,0,-38
35818,0,0,27,0,-27
35819,1,1,334,1207,873
35820,0,0,15,0,-15
35821,1,0,42,0,-42
35822,1,1,1734,1726,-8
35823,1,0,169,0,-169
35824,1,1,318,1252,934
35825,1,1,242,1238,996
35826,0,0,0,0,0
35827,0,0,32,0,-32
35828,1,1,615,1644,1029
35829,1,0,47,0,-47
35830,0,0,4,0,-4
35831,1,0,0,0,0
35832,1,1,162,1341,1179
35833,0,0,113,0,-113
35834,1,1,540,1882,1342
35835,1,1,561,1884,1323
35836,1,0,4,0,-4
35837,1,0,192,0,-192
35838,1,1,236,1984,1748
35839,1,1,207,1298,1091
35840,1,0,4,0,-4
35841,0,0,55,0,-55
35842,1,0,66,0,-66
35843,1,1,401,1642,1241
35844,1,1,120,1316,1196
35845,0,0,75,0,-75
35846,1,0,23,0,-23
35847,1,0,5,0,-5
35848,0,0,161,0,-161
35849,1,0,23,0,-23
35850,0,0,34,0,-34
35851,1,0,11,0,-11
35852,0,0,6,0,-6
35853,1,0,66,0,-66
35854,1,0,61,0,-61
35855,1,0,39,0,-39
35856,1,1,895,1574,679
35857,0,0,28,0,-28
35858,1,1,1925,1215,-710
35859,1,0,21,0,-21
35860,0,0,6,0,-6
35861,1,1,87,1393,1306
35862,1,1,846,1523,677
35863,0,0,46,0,-46
35864,1,1,729,1477,748
35865,0,0,31,0,-31
35866,1,1,265,1440,1175
35867,0,0,3,0,-3
35868,0,0,101,0,-101
35869,0,0,36,0,-36
35870,0,0,38,0,-38
35871,1,1,1422,1991,569
35872,0,0,33,0,-33
35873,0,0,3,0,-3
35874,1,0,88,0,-88
35875,0,0,70,0,-70
35876,0,0,49,0,-49
35877,1,0,7,0,-7
35878,0,0,107,0,-107
35879,0,0,17,0,-17
35880,1,0,9,0,-9
35881,0,0,130,0,-130
35882,0,0,136,0,-136
35883,1,1,122,1916,1794
35884,0,0,100,0,-100
35885,0,0,99,0,-99
35886,0,0,170,0,-170
35887,0,0,7,0,-7
35888,1,0,53,0,-53
35889,1,1,928,1812,884
35890,0,0,3,0,-3
35891,0,0,17,0,-17
35892,1,0,5,0,-5
35893,1,1,310,1825,1515
35894,0,0,209,0,-209
35895,1,0,26,0,-26
35896,0,0,8,0,-8
35897,1,1,1096,1407,311
35898,1,1,1099,1362,263
35899,1,0,34,0,-34
35900,1,1,670,1350,680
35901,1,0,95,0,-95
35902,1,1,303,1467,1164
35903,1,1,1438,2383,945
35904,1,0,38,0,-38
35905,0,0,0,0,0
35906,1,0,36,0,-36
35907,1,1,138,1565,1427
35908,0,0,32,0,-32
35909,0,0,80,0,-80
35910,0,0,50,0,-50
35911,1,1,29,1792,1763
35912,0,0,45,0,-45
35913,0,0,9,0,-9
35914,1,0,10,0,-10
35915,1,0,7,0,-7
35916,1,0,21,0,-21
35917,1,1,328,3590,3262
35918,1,1,1747,1204,-543
35919,1,0,38,0,-38
35920,0,0,11,0,-11
35921,1,0,22,0,-22
35922,1,0,74,0,-74
35923,1,1,70,1201,1131
35924,1,0,151,0,-151
35925,0,0,153,0,-153
35926,0,0,10,0,-10
35927,1,0,33,0,-33
35928,1,1,184,1529,1345
35929,1,0,143,0,-143
35930,1,0,139,0,-139
35931,1,1,393,1289,896
35932,0,0,33,0,-33
35933,1,1,903,1216,313
35934,0,0,114,0,-114
35935,0,0,16,0,-16
35936,0,0,20,0,-20
35937,0,0,130,0,-130
35938,1,1,52,1556,1504
35939,1,1,257,1226,969
35940,1,1,61,1868,1807
35941,1,1,49,1480,1431
35942,1,1,302,1598,1296
35943,0,0,37,0,-37
35944,0,0,55,0,-55
35945,1,0,140,0,-140
35946,1,1,923,1377,454
35947,0,0,32,0,-32
35948,1,0,4,0,-4
35949,1,0,12,0,-12
35950,1,1,373,1422,1049
35951,0,0,39,0,-39
35952,1,1,652,1695,1043
35953,1,0,3,0,-3
35954,1,0,1,0,-1
35955,0,0,5,0,-5
35956,1,0,94,0,-94
35957,1,1,559,1473,914
35958,1,0,75,0,-75
35959,1,1,860,1999,1139
35960,1,0,123,0,-123
35961,1,1,1127,3265,2138
35962,0,0,41,0,-41
35963,1,0,21,0,-21
35964,0,0,95,0,-95
35965,1,1,591,1792,1201
35966,1,0,8,0,-8
35967,0,0,104,0,-104
35968,1,1,353,1581,1228
35969,1,1,394,1407,1013
35970,1,1,177,3622,3445
35971,0,0,133,0,-133
35972,1,1,577,1380,803
35973,1,0,20,0,-20
35974,0,0,70,0,-70
35975,0,0,45,0,-45
35976,0,0,16,0,-16
35977,1,0,13,0,-13
35978,1,1,302,2391,2089
35979,0,0,6,0,-6
35980,1,0,96,0,-96
35981,0,0,58,0,-58
35982,0,0,6,0,-6
35983,1,1,400,1422,1022
35984,0,0,8,0,-8
35985,1,1,1284,1281,-3
35986,1,0,66,0,-66
35987,1,1,69,1275,1206
35988,1,1,405,1267,862
35989,0,0,47,0,-47
35990,1,1,627,1493,866
35991,1,1,382,1354,972
35992,1,0,60,0,-60
35993,0,0,65,0,-65
35994,1,1,1096,1273,177
35995,1,0,258,0,-258
35996,1,0,12,0,-12
35997,1,0,29,0,-29
35998,0,0,18,0,-18
35999,1,0,51,0,-51
36000,1,1,599,1219,620
36001,1,1,1298,1214,-84
36002,0,0,108,0,-108
36003,0,0,119,0,-119
36004,1,0,229,0,-229
36005,1,1,391,1387,996
36006,1,1,510,1631,1121
36007,0,0,18,0,-18
36008,1,1,115,1245,1130
36009,1,0,41,0,-41
36010,0,0,207,0,-207
36011,1,0,2,0,-2
36012,1,0,11,0,-11
36013,0,0,85,0,-85
36014,1,1,149,1990,1841
36015,0,0,248,0,-248
36016,1,0,22,0,-22
36017,1,0,39,0,-39
36018,1,0,7,0,-7
36019,1,0,26,0,-26
36020,1,0,65,0,-65
36021,1,1,450,1462,1012
36022,0,0,10,0,-10
36023,0,0,90,0,-90
36024,1,1,189,1244,1055
36025,0,0,22,0,-22
36026,1,1,54,1264,1210
36027,1,0,38,0,-38
36028,1,1,819,1281,462
36029,1,1,871,3689,2818
36030,0,0,3,0,-3
36031,1,1,543,1965,1422
36032,1,1,1360,3214,1854
36033,1,0,1,0,-1
36034,1,1,137,1294,1157
36035,1,0,3,0,-3
36036,0,0,92,0,-92
36037,0,0,32,0,-32
36038,0,0,18,0,-18
36039,1,0,29,0,-29
36040,1,1,463,1442,979
36041,1,0,0,0,0
36042,1,1,865,1321,456
36043,0,0,144,0,-144
36044,1,0,13,0,-13
36045,1,0,138,0,-138
36046,1,1,278,1594,1316
36047,0,0,3,0,-3
36048,0,0,12,0,-12
36049,0,0,49,0,-49
36050,0,0,13,0,-13
36051,0,0,13,0,-13
36052,0,0,4,0,-4
36053,1,1,228,2046,1818
36054,1,0,66,0,-66
36055,1,1,242,1231,989
36056,1,0,110,0,-110
36057,1,0,17,0,-17
36058,0,0,29,0,-29
36059,1,1,636,2047,1411
36060,1,1,434,2323,1889
36061,1,0,35,0,-35
36062,1,0,4,0,-4
36063,1,0,23,0,-23
36064,0,0,17,0,-17
36065,1,0,23,0,-23
36066,0,0,27,0,-27
36067,1,1,325,1742,1417
36068,1,1,125,2060,1935
36069,1,0,26,0,-26
36070,0,0,16,0,-16
36071,0,0,36,0,-36
36072,1,1,413,1488,1075
36073,1,1,55,1809,1754
36074,0,0,66,0,-66
36075,1,0,0,0,0
36076,1,0,167,0,-167
36077,0,0,26,0,-26
36078,0,0,34,0,-34
36079,0,0,20,0,-20
36080,0,0,1,0,-1
36081,1,1,1732,1392,-340
36082,0,0,87,0,-87
36083,0,0,3,0,-3
36084,1,1,26,1331,1305
36085,1,0,133,0,-133
36086,1,0,58,0,-58
36087,1,0,50,0,-50
36088,0,0,83,0,-83
36089,1,1,933,1435,502
36090,1,0,12,0,-12
36091,1,1,57,1221,1164
36092,0,0,65,0,-65
36093,1,0,11,0,-11
36094,0,0,87,0,-87
36095,0,0,17,0,-17
36096,0,0,80,0,-80
36097,0,0,113,0,-113
36098,1,1,249,2187,1938
36099,1,0,144,0,-144
36100,1,0,80,0,-80
36101,0,0,95,0,-95
36102,1,0,53,0,-53
36103,1,0,72,0,-72
36104,1,0,157,0,-157
36105,1,0,0,0,0
36106,1,0,7,0,-7
36107,1,1,630,1383,753
36108,0,0,67,0,-67
36109,1,1,100,3314,3214
36110,1,0,124,0,-124
36111,1,1,319,2194,1875
36112,1,1,330,1539,1209
36113,0,0,294,0,-294
36114,0,0,10,0,-10
36115,1,1,1815,1502,-313
36116,1,0,51,0,-51
36117,0,0,16,0,-16
36118,0,0,52,0,-52
36119,0,0,112,0,-112
36120,1,0,3,0,-3
36121,0,0,23,0,-23
36122,1,0,37,0,-37
36123,0,0,125,0,-125
36124,0,0,50,0,-50
36125,1,0,8,0,-8
36126,0,0,55,0,-55
36127,0,0,3,0,-3
36128,0,0,6,0,-6
36129,0,0,37,0,-37
36130,1,1,799,1313,514
36131,0,0,119,0,-119
36132,0,0,180,0,-180
36133,1,0,63,0,-63
36134,0,0,6,0,-6
36135,0,0,83,0,-83
36136,1,0,184,0,-184
36137,1,1,449,1226,777
36138,0,0,44,0,-44
36139,1,1,507,1203,696
36140,1,1,573,2118,1545
36141,0,0,7,0,-7
36142,0,0,3,0,-3
36143,0,0,19,0,-19
36144,0,0,109,0,-109
36145,1,1,1314,1400,86
36146,1,0,72,0,-72
36147,1,1,369,2257,1888
36148,1,0,10,0,-10
36149,1,0,47,0,-47
36150,1,1,1251,1713,462
36151,0,0,52,0,-52
36152,1,0,32,0,-32
36153,1,1,508,1764,1256
36154,0,0,21,0,-21
36155,0,0,68,0,-68
36156,0,0,37,0,-37
36157,1,1,1487,1415,-72
36158,1,1,57,1569,1512
36159,1,0,9,0,-9
36160,0,0,170,0,-170
36161,1,1,1007,1240,233
36162,1,0,0,0,0
36163,0,0,74,0,-74
36164,1,0,62,0,-62
36165,1,0,19,0,-19
36166,1,1,164,1212,1048
36167,1,0,193,0,-193
36168,0,0,8,0,-8
36169,0,0,4,0,-4
36170,1,1,424,1468,1044
36171,1,1,18,1738,1720
36172,1,1,606,1415,809
36173,0,0,13,0,-13
36174,1,0,9,0,-9
36175,1,0,183,0,-183
36176,0,0,57,0,-57
36177,1,0,4,0,-4
36178,0,0,66,0,-66
36179,1,0,103,0,-103
36180,1,0,105,0,-105
36181,0,0,1,0,-1
36182,0,0,2,0,-2
36183,1,1,15,1481,1466
36184,1,1,238,1866,1628
36185,1,0,0,0,0
36186,0,0,27,0,-27
36187,1,1,178,1297,1119
36188,1,0,106,0,-106
36189,1,0,39,0,-39
36190,1,0,165,0,-165
36191,1,0,76,0,-76
36192,0,0,16,0,-16
36193,0,0,18,0,-18
36194,1,1,126,1335,1209
36195,0,0,28,0,-28
36196,1,0,13,0,-13
36197,1,0,33,0,-33
36198,1,0,17,0,-17
36199,1,0,12,0,-12
36200,0,0,108,0,-108
36201,0,0,4,0,-4
36202,1,1,497,2536,2039
36203,0,0,80,0,-80
36204,1,0,108,0,-108
36205,1,1,635,1591,956
36206,1,0,224,0,-224
36207,0,0,25,0,-25
36208,0,0,87,0,-87
36209,0,0,35,0,-35
36210,1,0,13,0,-13
36211,1,0,2,0,-2
36212,1,0,162,0,-162
36213,1,0,40,0,-40
36214,1,0,14,0,-14
36215,1,1,485,1320,835
36216,1,0,46,0,-46
36217,0,0,38,0,-38
36218,1,0,27,0,-27
36219,1,0,18,0,-18
36220,1,1,152,1847,1695
36221,1,0,51,0,-51
36222,1,0,83,0,-83
36223,1,0,10,0,-10
36224,0,0,69,0,-69
36225,0,0,18,0,-18
36226,0,0,31,0,-31
36227,0,0,0,0,0
36228,0,0,9,0,-9
36229,0,0,20,0,-20
36230,1,0,24,0,-24
36231,1,1,614,1535,921
36232,1,0,96,0,-96
36233,1,0,40,0,-40
36234,1,1,93,1228,1135
36235,1,1,702,2011,1309
36236,1,1,986,2197,1211
36237,1,0,12,0,-12
36238,1,0,172,0,-172
36239,0,0,9,0,-9
36240,0,0,163,0,-163
36241,1,0,16,0,-16
36242,1,1,191,1394,1203
36243,1,1,884,1453,569
36244,1,0,11,0,-11
36245,0,0,40,0,-40
36246,0,0,12,0,-12
36247,1,0,130,0,-130
36248,0,0,51,0,-51
36249,1,0,8,0,-8
36250,1,1,321,1208,887
36251,1,1,144,1325,1181
36252,1,0,82,0,-82
36253,0,0,86,0,-86
36254,1,1,188,1217,1029
36255,1,1,392,1403,1011
36256,1,0,280,0,-280
36257,0,0,9,0,-9
36258,0,0,4,0,-4
36259,0,0,55,0,-55
36260,1,0,100,0,-100
36261,1,1,930,1375,445
36262,0,0,36,0,-36
36263,1,1,249,1843,1594
36264,1,0,66,0,-66
36265,1,1,21,1344,1323
36266,0,0,16,0,-16
36267,1,1,433,1335,902
36268,1,1,183,1248,1065
36269,1,0,4,0,-4
36270,1,0,7,0,-7
36271,1,0,12,0,-12
36272,0,0,49,0,-49
36273,0,0,76,0,-76
36274,1,1,214,1753,1539
36275,0,0,18,0,-18
36276,0,0,56,0,-56
36277,1,1,455,1507,1052
36278,1,1,123,1329,1206
36279,1,0,5,0,-5
36280,1,1,37,1419,1382
36281,1,1,111,1653,1542
36282,0,0,32,0,-32
36283,0,0,142,0,-142
36284,0,0,20,0,-20
36285,1,0,51,0,-51
36286,0,0,35,0,-35
36287,1,1,7,1360,1353
36288,1,1,168,1328,1160
36289,1,0,2,0,-2
36290,1,0,65,0,-65
36291,1,1,267,1216,949
36292,1,1,561,2061,1500
36293,1,1,1001,1469,468
36294,0,0,48,0,-48
36295,1,1,607,1227,620
36296,1,0,73,0,-73
36297,0,0,17,0,-17
36298,0,0,111,0,-111
36299,1,1,67,1575,1508
36300,1,0,101,0,-101
36301,0,0,35,0,-35
36302,1,1,475,1201,726
36303,0,0,90,0,-90
36304,0,0,59,0,-59
36305,1,1,47,1528,1481
36306,0,0,49,0,-49
36307,0,0,128,0,-128
36308,1,1,169,2411,2242
36309,0,0,63,0,-63
36310,1,1,1134,1770,636
36311,1,1,1384,1307,-77
36312,1,1,380,1502,1122
36313,0,0,25,0,-25
36314,0,0,106,0,-106
36315,1,1,240,1581,1341
36316,0,0,127,0,-127
36317,0,0,31,0,-31
36318,0,0,41,0,-41
36319,1,0,38,0,-38
36320,1,1,104,1267,1163
36321,1,0,23,0,-23
36322,0,0,5,0,-5
36323,1,0,2,0,-2
36324,1,1,278,1260,982
36325,0,0,88,0,-88
36326,0,0,24,0,-24
36327,1,0,98,0,-98
36328,0,0,11,0,-11
36329,1,1,2019,1375,-644
36330,1,0,1,0,-1
36331,1,1,1352,1465,113
36332,0,0,21,0,-21
36333,0,0,10,0,-10
36334,0,0,72,0,-72
36335,1,0,40,0,-40
36336,0,0,28,0,-28
36337,1,1,672,1478,806
36338,0,0,33,0,-33
36339,1,0,165,0,-165
36340,1,0,55,0,-55
36341,1,0,36,0,-36
36342,1,0,90,0,-90
36343,0,0,30,0,-30
36344,1,1,443,1797,1354
36345,1,1,600,1249,649
36346,1,1,205,1563,1358
36347,1,0,50,0,-50
36348,1,1,341,1739,1398
36349,1,1,369,1237,868
36350,0,0,85,0,-85
36351,1,0,15,0,-15
36352,1,1,216,1855,1639
36353,0,0,52,0,-52
36354,1,1,330,3138,2808
36355,0,0,22,0,-22
36356,0,0,39,0,-39
36357,0,0,19,0,-19
36358,0,0,24,0,-24
36359,0,0,34,0,-34
36360,1,1,827,1840,1013
36361,0,0,84,0,-84
36362,0,0,16,0,-16
36363,1,0,7,0,-7
36364,1,1,204,1590,1386
36365,1,1,519,1559,1040
36366,1,0,33,0,-33
36367,1,0,49,0,-49
36368,1,1,162,1283,1121
36369,1,1,832,1920,1088
36370,1,0,8,0,-8
36371,0,0,19,0,-19
36372,1,0,73,0,-73
36373,1,0,85,0,-85
36374,0,0,80,0,-80
36375,1,0,18,0,-18
36376,1,1,553,1508,955
36377,1,0,4,0,-4
36378,1,1,784,2014,1230
36379,0,0,14,0,-14
36380,1,1,1230,1613,383
36381,1,1,276,1437,1161
36382,0,0,24,0,-24
36383,1,1,364,1491,1127
36384,1,1,31,1330,1299
36385,0,0,33,0,-33
36386,0,0,11,0,-11
36387,0,0,20,0,-20
36388,1,0,76,0,-76
36389,0,0,55,0,-55
36390,1,0,108,0,-108
36391,1,0,38,0,-38
36392,1,0,116,0,-116
36393,1,1,594,2515,1921
36394,0,0,36,0,-36
36395,1,1,31,1549,1518
36396,0,0,37,0,-37
36397,1,0,12,0,-12
36398,1,1,85,1727,1642
36399,1,0,162,0,-162
36400,1,0,11,0,-11
36401,1,1,1022,1501,479
36402,0,0,3,0,-3
36403,1,0,13,0,-13
36404,1,0,30,0,-30
36405,1,1,84,1475,1391
36406,1,0,9,0,-9
36407,0,0,50,0,-50
36408,1,1,8,2141,2133
36409,1,1,31,1293,1262
36410,1,0,40,0,-40
36411,1,1,266,2680,2414
36412,1,1,103,1912,1809
36413,1,0,134,0,-134
36414,1,1,1248,1431,183
36415,1,0,14,0,-14
36416,0,0,23,0,-23
36417,0,0,0,0,0
36418,1,1,584,1309,725
36419,0,0,47,0,-47
36420,0,0,49,0,-49
36421,0,0,98,0,-98
36422,0,0,118,0,-118
36423,0,0,2,0,-2
36424,1,1,394,1475,1081
36425,1,1,80,1484,1404
36426,1,0,10,0,-10
36427,1,1,132,3832,3700
36428,0,0,28,0,-28
36429,0,0,49,0,-49
36430,1,0,19,0,-19
36431,1,1,289,1559,1270
36432,0,0,17,0,-17
36433,0,0,31,0,-31
36434,0,0,26,0,-26
36435,1,1,331,1296,965
36436,0,0,28,0,-28
36437,1,1,359,1219,860
36438,1,1,1012,3096,2084
36439,0,0,39,0,-39
36440,1,1,108,1310,1202
36441,0,0,2,0,-2
36442,1,0,75,0,-75
36443,1,0,61,0,-61
36444,0,0,97,0,-97
36445,1,0,82,0,-82
36446,1,1,32,1585,1553
36447,1,1,604,1633,1029
36448,0,0,12,0,-12
36449,0,0,33,0,-33
36450,0,0,22,0,-22
36451,1,1,954,1521,567
36452,0,0,91,0,-91
36453,0,0,1,0,-1
36454,1,0,22,0,-22
36455,1,0,29,0,-29
36456,0,0,109,0,-109
36457,1,1,534,1253,719
36458,1,0,50,0,-50
36459,1,1,98,1230,1132
36460,0,0,8,0,-8
36461,1,1,1476,1289,-187
36462,0,0,20,0,-20
36463,1,0,37,0,-37
36464,0,0,50,0,-50
36465,1,1,59,1293,1234
36466,1,1,964,1487,523
36467,0,0,90,0,-90
36468,1,0,114,0,-114
36469,1,0,15,0,-15
36470,0,0,153,0,-153
36471,0,0,7,0,-7
36472,0,0,133,0,-133
36473,0,0,6,0,-6
36474,0,0,154,0,-154
36475,1,0,3,0,-3
36476,1,1,1129,1374,245
36477,1,0,40,0,-40
36478,0,0,58,0,-58
36479,1,0,33,0,-33
36480,1,1,167,1434,1267
36481,0,0,38,0,-38
36482,0,0,55,0,-55
36483,0,0,26,0,-26
36484,0,0,34,0,-34
36485,0,0,13,0,-13
36486,0,0,108,0,-108
36487,1,0,3,0,-3
36488,0,0,12,0,-12
36489,0,0,9,0,-9
36490,0,0,1,0,-1
36491,1,1,465,1355,890
36492,0,0,0,0,0
36493,0,0,11,0,-11
36494,1,0,49,0,-49
36495,1,0,151,0,-151
36496,0,0,64,0,-64
36497,0,0,68,0,-68
36498,1,0,63,0,-63
36499,1,1,191,2142,1951
36500,0,0,71,0,-71
36501,1,1,211,1201,990
36502,1,0,23,0,-23
36503,0,0,89,0,-89
36504,0,0,65,0,-65
36505,1,0,14,0,-14
36506,1,0,2,0,-2
36507,0,0,38,0,-38
36508,0,0,111,0,-111
36509,1,0,42,0,-42
36510,1,0,11,0,-11
36511,1,1,287,1202,915
36512,0,0,12,0,-12
36513,1,0,7,0,-7
36514,1,1,195,1498,1303
36515,0,0,66,0,-66
36516,0,0,71,0,-71
36517,1,0,18,0,-18
36518,1,1,235,1429,1194
36519,1,1,999,1293,294
36520,1,0,1,0,-1
36521,0,0,114,0,-114
36522,0,0,16,0,-16
36523,1,1,577,1318,741
36524,0,0,113,0,-113
36525,0,0,41,0,-41
36526,1,1,415,1221,806
36527,0,0,2,0,-2
36528,1,0,0,0,0
36529,0,0,9,0,-9
36530,0,0,7,0,-7
36531,0,0,212,0,-212
36532,0,0,9,0,-9
36533,1,1,639,1962,1323
36534,1,0,87,0,-87
36535,1,0,19,0,-19
36536,0,0,31,0,-31
36537,0,0,34,0,-34
36538,1,1,1206,3377,2171
36539,1,0,11,0,-11
36540,1,0,87,0,-87
36541,1,0,47,0,-47
36542,1,1,63,1414,1351
36543,1,1,780,1234,454
36544,0,0,158,0,-158
36545,1,0,30,0,-30
36546,1,0,9,0,-9
36547,1,0,37,0,-37
36548,0,0,13,0,-13
36549,0,0,128,0,-128
36550,0,0,48,0,-48
36551,1,0,16,0,-16
36552,0,0,76,0,-76
36553,0,0,41,0,-41
36554,0,0,32,0,-32
36555,1,0,11,0,-11
36556,0,0,51,0,-51
36557,0,0,27,0,-27
36558,1,1,127,2036,1909
36559,0,0,50,0,-50
36560,1,0,46,0,-46
36561,1,1,2348,1387,-961
36562,0,0,78,0,-78
36563,1,0,111,0,-111
36564,1,0,19,0,-19
36565,1,1,274,1227,953
36566,0,0,96,0,-96
36567,0,0,28,0,-28
36568,1,1,3334,1277,-2057
36569,1,0,69,0,-69
36570,0,0,21,0,-21
36571,1,1,555,1235,680
36572,1,1,984,1485,501
36573,0,0,63,0,-63
36574,1,1,1171,1207,36
36575,1,0,34,0,-34
36576,1,1,141,2276,2135
36577,1,1,300,1678,1378
36578,1,0,86,0,-86
36579,0,0,56,0,-56
36580,0,0,141,0,-141
36581,1,1,140,1453,1313
36582,0,0,14,0,-14
36583,1,1,23,1211,1188
36584,1,1,557,1399,842
36585,1,1,389,1457,1068
36586,0,0,53,0,-53
36587,0,0,27,0,-27
36588,1,1,630,1307,677
36589,0,0,19,0,-19
36590,1,1,635,1621,986
36591,1,0,96,0,-96
36592,1,1,583,1417,834
36593,1,1,1007,1317,310
36594,0,0,22,0,-22
36595,1,1,1302,1271,-31
36596,0,0,56,0,-56
36597,1,0,58,0,-58
36598,0,0,25,0,-25
36599,0,0,127,0,-127
36600,0,0,12,0,-12
36601,1,0,7,0,-7
36602,1,0,114,0,-114
36603,0,0,8,0,-8
36604,1,0,171,0,-171
36605,0,0,99,0,-99
36606,1,1,204,1236,1032
36607,1,0,56,0,-56
36608,0,0,43,0,-43
36609,0,0,7,0,-7
36610,1,0,52,0,-52
36611,1,1,339,1392,1053
36612,1,0,60,0,-60
36613,0,0,28,0,-28
36614,1,0,104,0,-104
36615,1,0,23,0,-23
36616,1,1,963,1333,370
36617,1,0,12,0,-12
36618,1,1,2622,1445,-1177
36619,1,0,2,0,-2
36620,0,0,133,0,-133
36621,1,0,11,0,-11
36622,1,0,30,0,-30
36623,1,1,392,2013,1621
36624,1,0,47,0,-47
36625,0,0,3,0,-3
36626,1,1,207,1456,1249
36627,1,0,10,0,-10
36628,1,1,455,1204,749
36629,0,0,61,0,-61
36630,1,0,76,0,-76
36631,0,0,29,0,-29
36632,1,0,186,0,-186
36633,0,0,2,0,-2
36634,1,0,48,0,-48
36635,0,0,19,0,-19
36636,0,0,8,0,-8
36637,1,1,308,1493,1185
36638,1,0,56,0,-56
36639,1,1,420,1642,1222
36640,1,1,569,1357,788
36641,0,0,18,0,-18
36642,1,0,15,0,-15
36643,0,0,70,0,-70
36644,1,1,1313,1678,365
36645,1,0,11,0,-11
36646,1,1,15,1372,1357
36647,1,0,18,0,-18
36648,1,1,212,1205,993
36649,0,0,1,0,-1
36650,1,0,24,0,-24
36651,0,0,12,0,-12
36652,0,0,33,0,-33
36653,0,0,17,0,-17
36654,0,0,172,0,-172
36655,1,1,164,1393,1229
36656,1,1,223,1390,1167
36657,1,1,1058,1606,548
36658,1,0,167,0,-167
36659,0,0,1,0,-1
36660,1,1,168,1358,1190
36661,1,1,1778,1481,-297
36662,0,0,14,0,-14
36663,1,0,79,0,-79
36664,1,0,66,0,-66
36665,0,0,86,0,-86
36666,1,1,309,2891,2582
36667,0,0,128,0,-128
36668,1,1,652,1200,548
36669,0,0,2,0,-2
36670,1,0,172,0,-172
36671,1,0,25,0,-25
36672,1,1,3631,1298,-2333
36673,1,1,1847,1443,-404
36674,0,0,78,0,-78
36675,0,0,41,0,-41
36676,1,1,531,1342,811
36677,0,0,26,0,-26
36678,1,1,130,1225,1095
36679,0,0,21,0,-21
36680,0,0,85,0,-85
36681,1,0,33,0,-33
36682,1,1,761,1369,608
36683,0,0,41,0,-41
36684,0,0,9,0,-9
36685,1,1,258,1530,1272
36686,0,0,102,0,-102
36687,1,0,63,0,-63
36688,0,0,13,0,-13
36689,1,0,21,0,-21
36690,0,0,5,0,-5
36691,0,0,1,0,-1
36692,1,1,269,1434,1165
36693,0,0,33,0,-33
36694,1,1,1098,2138,1040
36695,1,1,1048,1229,181
36696,1,1,535,1211,676
36697,0,0,61,0,-61
36698,1,0,80,0,-80
36699,1,1,636,1266,630
36700,1,0,38,0,-38
36701,1,0,1,0,-1
36702,0,0,42,0,-42
36703,0,0,34,0,-34
36704,0,0,54,0,-54
36705,0,0,20,0,-20
36706,1,0,91,0,-91
36707,0,0,48,0,-48
36708,0,0,19,0,-19
36709,1,0,66,0,-66
36710,1,0,61,0,-61
36711,1,0,0,0,0
36712,0,0,49,0,-49
36713,1,0,96,0,-96
36714,0,0,70,0,-70
36715,0,0,26,0,-26
36716,1,1,573,7151,6578
36717,1,1,1342,1326,-16
36718,1,1,431,1313,882
36719,0,0,61,0,-61
36720,1,1,115,1441,1326
36721,1,0,260,0,-260
36722,1,1,1072,1505,433
36723,0,0,157,0,-157
36724,1,1,469,1378,909
36725,0,0,29,0,-29
36726,1,0,15,0,-15
36727,0,0,7,0,-7
36728,1,0,21,0,-21
36729,0,0,6,0,-6
36730,0,0,5,0,-5
36731,1,1,233,1237,1004
36732,1,0,5,0,-5
36733,1,0,4,0,-4
36734,1,1,120,1202,1082
36735,1,0,46,0,-46
36736,1,0,0,0,0
36737,1,0,3,0,-3
36738,0,0,135,0,-135
36739,1,0,73,0,-73
36740,1,1,206,1256,1050
36741,0,0,110,0,-110
36742,1,1,254,1831,1577
36743,1,1,562,1467,905
36744,0,0,6,0,-6
36745,1,0,24,0,-24
36746,1,0,44,0,-44
36747,1,0,94,0,-94
36748,0,0,85,0,-85
36749,1,1,381,1762,1381
36750,1,0,173,0,-173
36751,0,0,40,0,-40
36752,0,0,40,0,-40
36753,1,0,75,0,-75
36754,0,0,110,0,-110
36755,0,0,6,0,-6
36756,1,0,81,0,-81
36757,0,0,15,0,-15
36758,0,0,89,0,-89
36759,0,0,97,0,-97
36760,0,0,24,0,-24
36761,1,0,28,0,-28
36762,0,0,130,0,-130
36763,1,0,14,0,-14
36764,0,0,28,0,-28
36765,0,0,26,0,-26
36766,1,0,112,0,-112
36767,0,0,19,0,-19
36768,1,0,185,0,-185
36769,0,0,19,0,-19
36770,1,0,30,0,-30
36771,0,0,2,0,-2
36772,1,0,25,0,-25
36773,1,0,6,0,-6
36774,0,0,5,0,-5
36775,0,0,136,0,-136
36776,0,0,36,0,-36
36777,1,0,71,0,-71
36778,0,0,50,0,-50
36779,1,0,11,0,-11
36780,1,0,62,0,-62
36781,0,0,96,0,-96
36782,1,1,644,1257,613
36783,1,1,106,1200,1094
36784,1,0,15,0,-15
36785,0,0,3,0,-3
36786,0,0,3,0,-3
36787,1,0,7,0,-7
36788,1,0,35,0,-35
36789,0,0,1,0,-1
36790,1,1,563,1647,1084
36791,0,0,87,0,-87
36792,1,0,34,0,-34
36793,1,1,725,2633,1908
36794,1,0,23,0,-23
36795,0,0,121,0,-121
36796,1,0,15,0,-15
36797,1,0,169,0,-169
36798,1,1,717,1348,631
36799,1,0,17,0,-17
36800,1,0,5,0,-5
36801,1,0,167,0,-167
36802,0,0,101,0,-101
36803,0,0,1,0,-1
36804,0,0,172,0,-172
36805,1,1,503,1232,729
36806,1,1,443,1488,1045
36807,1,1,581,1310,729
36808,0,0,5,0,-5
36809,0,0,49,0,-49
36810,0,0,45,0,-45
36811,1,1,148,1393,1245
36812,1,1,752,1719,967
36813,1,0,11,0,-11
36814,0,0,18,0,-18
36815,1,1,370,2495,2125
36816,1,0,56,0,-56
36817,1,1,385,1220,835
36818,1,1,173,1326,1153
36819,1,0,58,0,-58
36820,0,0,11,0,-11
36821,0,0,38,0,-38
36822,1,0,83,0,-83
36823,0,0,75,0,-75
36824,0,0,49,0,-49
36825,1,0,14,0,-14
36826,1,1,102,1210,1108
36827,0,0,82,0,-82
36828,1,1,109,1859,1750
36829,1,0,47,0,-47
36830,0,0,42,0,-42
36831,0,0,141,0,-141
36832,0,0,86,0,-86
36833,0,0,8,0,-8
36834,1,1,33,1237,1204
36835,0,0,40,0,-40
36836,0,0,75,0,-75
36837,1,1,111,3137,3026
36838,0,0,40,0,-40
36839,1,1,594,1717,1123
36840,1,1,192,3595,3403
36841,1,1,436,3070,2634
36842,0,0,14,0,-14
36843,1,1,168,2658,2490
36844,1,0,78,0,-78
36845,1,0,72,0,-72
36846,1,0,0,0,0
36847,1,1,927,1530,603
36848,0,0,63,0,-63
36849,1,1,125,2607,2482
36850,1,0,30,0,-30
36851,1,0,1,0,-1
36852,1,0,15,0,-15
36853,0,0,15,0,-15
36854,1,0,27,0,-27
36855,0,0,201,0,-201
36856,1,0,35,0,-35
36857,0,0,26,0,-26
36858,1,1,46,3121,3075
36859,1,1,103,1310,1207
36860,0,0,4,0,-4
36861,1,1,230,1595,1365
36862,1,0,118,0,-118
36863,0,0,3,0,-3
36864,1,0,2,0,-2
36865,0,0,32,0,-32
36866,1,0,26,0,-26
36867,1,1,1196,1659,463
36868,0,0,52,0,-52
36869,1,0,29,0,-29
36870,0,0,21,0,-21
36871,1,1,226,1287,1061
36872,0,0,45,0,-45
36873,1,1,862,1919,1057
36874,1,1,741,1595,854
36875,1,1,226,1302,1076
36876,1,0,21,0,-21
36877,1,0,158,0,-158
36878,1,0,139,0,-139
36879,0,0,17,0,-17
36880,0,0,141,0,-141
36881,1,0,34,0,-34
36882,0,0,66,0,-66
36883,1,1,572,1328,756
36884,1,0,4,0,-4
36885,1,1,157,1363,1206
36886,1,1,663,1579,916
36887,0,0,4,0,-4
36888,1,1,60,1316,1256
36889,0,0,18,0,-18
36890,1,0,76,0,-76
36891,1,0,118,0,-118
36892,1,1,354,1448,1094
36893,0,0,31,0,-31
36894,1,1,452,1563,1111
36895,0,0,94,0,-94
36896,1,0,211,0,-211
36897,1,0,175,0,-175
36898,1,1,576,2334,1758
36899,1,0,32,0,-32
36900,1,0,68,0,-68
36901,0,0,139,0,-139
36902,0,0,11,0,-11
36903,0,0,18,0,-18
36904,1,0,32,0,-32
36905,0,0,72,0,-72
36906,0,0,138,0,-138
36907,1,1,183,1281,1098
36908,1,1,151,1649,1498
36909,1,0,41,0,-41
36910,0,0,36,0,-36
36911,1,1,672,1572,900
36912,1,0,74,0,-74
36913,0,0,18,0,-18
36914,1,1,776,1235,459
36915,1,0,36,0,-36
36916,1,1,1538,1327,-211
36917,0,0,214,0,-214
36918,0,0,73,0,-73
36919,0,0,49,0,-49
36920,1,1,496,1325,829
36921,1,1,809,1417,608
36922,1,0,73,0,-73
36923,1,0,0,0,0
36924,0,0,22,0,-22
36925,1,1,521,2109,1588
36926,0,0,49,0,-49
36927,1,0,77,0,-77
36928,1,1,178,1381,1203
36929,1,0,53,0,-53
36930,1,1,766,1311,545
36931,1,1,172,1989,1817
36932,1,0,16,0,-16
36933,1,1,414,1394,980
36934,0,0,57,0,-57
36935,0,0,16,0,-16
36936,0,0,1,0,-1
36937,1,1,840,1243,403
36938,1,1,368,2735,2367
36939,0,0,110,0,-110
36940,1,1,680,1482,802
36941,1,0,164,0,-164
36942,0,0,154,0,-154
36943,0,0,30,0,-30
36944,1,0,16,0,-16
36945,1,1,452,1511,1059
36946,0,0,65,0,-65
36947,1,1,107,1610,1503
36948,1,1,655,1205,550
36949,1,0,8,0,-8
36950,0,0,118,0,-118
36951,1,0,65,0,-65
36952,0,0,63,0,-63
36953,1,0,52,0,-52
36954,1,1,1667,1265,-402
36955,0,0,24,0,-24
36956,1,0,2,0,-2
36957,1,1,121,1246,1125
36958,0,0,32,0,-32
36959,0,0,47,0,-47
36960,1,0,56,0,-56
36961,1,1,1974,1735,-239
36962,1,1,86,1583,1497
36963,1,0,43,0,-43
36964,0,0,13,0,-13
36965,1,0,14,0,-14
36966,0,0,10,0,-10
36967,0,0,23,0,-23
36968,1,0,41,0,-41
36969,1,0,19,0,-19
36970,1,0,62,0,-62
36971,0,0,0,0,0
36972,0,0,13,0,-13
36973,0,0,18,0,-18
36974,1,0,2,0,-2
36975,1,1,807,1485,678
36976,0,0,89,0,-89
36977,1,0,214,0,-214
36978,1,1,376,1638,1262
36979,0,0,151,0,-151
36980,1,0,92,0,-92
36981,0,0,3,0,-3
36982,1,1,91,3402,3311
36983,1,0,3,0,-3
36984,0,0,30,0,-30
36985,1,1,1685,1736,51
36986,0,0,96,0,-96
36987,1,1,152,1746,1594
36988,1,1,58,1286,1228
36989,0,0,77,0,-77
36990,0,0,26,0,-26
36991,1,1,399,1570,1171
36992,1,1,73,1271,1198
36993,1,1,123,1257,1134
36994,1,1,34,1555,1521
36995,1,1,1738,1377,-361
36996,0,0,77,0,-77
36997,0,0,40,0,-40
36998,0,0,14,0,-14
36999,0,0,1,0,-1
37000,0,0,98,0,-98
37001,1,0,72,0,-72
37002,0,0,12,0,-12
37003,0,0,14,0,-14
37004,1,1,977,1483,506
37005,1,1,710,1764,1054
37006,1,0,76,0,-76
37007,0,0,130,0,-130
37008,0,0,56,0,-56
37009,1,1,145,1275,1130
37010,1,1,909,1760,851
37011,1,1,19,1375,1356
37012,1,1,231,1642,1411
37013,0,0,40,0,-40
37014,0,0,40,0,-40
37015,0,0,30,0,-30
37016,1,1,1217,1500,283
37017,1,0,7,0,-7
37018,1,0,17,0,-17
37019,1,1,1125,1279,154
37020,0,0,14,0,-14
37021,1,1,885,1236,351
37022,1,1,63,1279,1216
37023,1,0,38,0,-38
37024,1,1,585,1971,1386
37025,1,1,304,1790,1486
37026,1,0,39,0,-39
37027,1,0,2,0,-2
37028,1,1,81,2289,2208
37029,0,0,41,0,-41
37030,1,1,633,1350,717
37031,0,0,88,0,-88
37032,1,0,10,0,-10
37033,1,0,14,0,-14
37034,1,0,62,0,-62
37035,1,1,1176,2604,1428
37036,1,0,31,0,-31
37037,0,0,6,0,-6
37038,1,1,271,1450,1179
37039,1,1,232,1735,1503
37040,0,0,111,0,-111
37041,1,1,402,1406,1004
37042,1,1,353,1349,996
37043,0,0,16,0,-16
37044,1,1,945,1257,312
37045,1,0,96,0,-96
37046,1,0,19,0,-19
37047,0,0,7,0,-7
37048,0,0,78,0,-78
37049,1,1,102,1400,1298
37050,0,0,41,0,-41
37051,0,0,43,0,-43
37052,0,0,39,0,-39
37053,1,0,77,0,-77
37054,1,0,14,0,-14
37055,1,0,6,0,-6
37056,0,0,107,0,-107
37057,0,0,1,0,-1
37058,1,0,12,0,-12
37059,0,0,68,0,-68
37060,0,0,12,0,-12
37061,0,0,56,0,-56
37062,1,0,3,0,-3
37063,1,0,45,0,-45
37064,1,1,285,1979,1694
37065,1,0,119,0,-119
37066,1,1,1354,1571,217
37067,0,0,8,0,-8
37068,0,0,21,0,-21
37069,0,0,24,0,-24
37070,1,1,122,1232,1110
37071,0,0,89,0,-89
37072,1,0,80,0,-80
37073,1,0,33,0,-33
37074,1,0,35,0,-35
37075,1,1,1005,1656,651
37076,1,0,0,0,0
37077,0,0,38,0,-38
37078,1,1,554,1250,696
37079,1,1,241,2177,1936
37080,0,0,29,0,-29
37081,1,0,1,0,-1
37082,1,0,88,0,-88
37083,1,0,52,0,-52
37084,1,0,163,0,-163
37085,1,1,11,1600,1589
37086,0,0,18,0,-18
37087,1,1,145,1277,1132
37088,1,0,94,0,-94
37089,1,1,1029,1511,482
37090,1,0,11,0,-11
37091,0,0,8,0,-8
37092,1,0,118,0,-118
37093,0,0,19,0,-19
37094,1,1,181,1950,1769
37095,1,1,1605,1204,-401
37096,0,0,74,0,-74
37097,1,1,185,1306,1121
37098,1,0,47,0,-47
37099,1,1,84,1421,1337
37100,1,0,22,0,-22
37101,1,1,631,1532,901
37102,0,0,0,0,0
37103,1,0,63,0,-63
37104,0,0,39,0,-39
37105,1,0,0,0,0
37106,0,0,162,0,-162
37107,1,1,146,1419,1273
37108,1,1,2622,1580,-1042
37109,1,1,1193,1422,229
37110,0,0,48,0,-48
37111,1,0,34,0,-34
37112,0,0,19,0,-19
37113,0,0,13,0,-13
37114,1,1,328,1432,1104
37115,1,1,597,1827,1230
37116,1,0,293,0,-293
37117,0,0,52,0,-52
37118,1,1,183,1382,1199
37119,1,1,292,1247,955
37120,0,0,25,0,-25
37121,0,0,62,0,-62
37122,1,0,23,0,-23
37123,1,1,410,1282,872
37124,0,0,61,0,-61
37125,1,1,495,1742,1247
37126,1,0,6,0,-6
37127,0,0,42,0,-42
37128,0,0,59,0,-59
37129,0,0,12,0,-12
37130,1,0,31,0,-31
37131,0,0,36,0,-36
37132,0,0,48,0,-48
37133,0,0,5,0,-5
37134,0,0,15,0,-15
37135,0,0,2,0,-2
37136,0,0,29,0,-29
37137,0,0,2,0,-2
37138,0,0,132,0,-132
37139,1,1,113,1291,1178
37140,1,1,1199,1404,205
37141,1,1,2088,1357,-731
37142,0,0,57,0,-57
37143,1,0,0,0,0
37144,0,0,26,0,-26
37145,0,0,1,0,-1
37146,1,1,193,1255,1062
37147,1,0,15,0,-15
37148,1,0,52,0,-52
37149,1,1,435,1323,888
37150,0,0,111,0,-111
37151,1,0,19,0,-19
37152,0,0,6,0,-6
37153,1,1,1910,2023,113
37154,1,1,408,3130,2722
37155,0,0,12,0,-12
37156,1,1,678,1314,636
37157,0,0,7,0,-7
37158,1,0,27,0,-27
37159,1,1,384,1724,1340
37160,1,0,247,0,-247
37161,1,0,63,0,-63
37162,0,0,232,0,-232
37163,0,0,75,0,-75
37164,1,1,67,1614,1547
37165,0,0,9,0,-9
37166,0,0,45,0,-45
37167,0,0,24,0,-24
37168,0,0,10,0,-10
37169,1,0,12,0,-12
37170,1,1,97,1602,1505
37171,1,1,261,1235,974
37172,1,0,10,0,-10
37173,1,0,395,0,-395
37174,0,0,19,0,-19
37175,1,0,49,0,-49
37176,1,1,209,1235,1026
37177,1,0,7,0,-7
37178,0,0,121,0,-121
37179,1,1,718,1300,582
37180,1,0,75,0,-75
37181,1,1,1046,1505,459
37182,0,0,50,0,-50
37183,1,0,96,0,-96
37184,1,0,11,0,-11
37185,1,0,33,0,-33
37186,1,1,2055,1263,-792
37187,0,0,37,0,-37
37188,1,0,6,0,-6
37189,0,0,91,0,-91
37190,1,0,19,0,-19
37191,1,0,69,0,-69
37192,1,1,1519,1200,-319
37193,0,0,174,0,-174
37194,0,0,18,0,-18
37195,0,0,17,0,-17
37196,1,0,10,0,-10
37197,1,1,154,1509,1355
37198,1,0,96,0,-96
37199,0,0,2,0,-2
37200,0,0,98,0,-98
37201,1,1,292,1493,1201
37202,1,0,14,0,-14
37203,1,0,90,0,-90
37204,1,0,289,0,-289
37205,0,0,10,0,-10
37206,1,1,1534,1779,245
37207,1,0,28,0,-28
37208,0,0,30,0,-30
37209,0,0,6,0,-6
37210,1,1,453,1723,1270
37211,0,0,51,0,-51
37212,1,1,835,2995,2160
37213,1,1,277,1451,1174
37214,1,0,130,0,-130
37215,1,0,18,0,-18
37216,1,0,0,0,0
37217,0,0,11,0,-11
37218,1,1,1234,1205,-29
37219,0,0,79,0,-79
37220,0,0,68,0,-68
37221,1,0,21,0,-21
37222,0,0,81,0,-81
37223,0,0,8,0,-8
37224,1,1,2074,1357,-717
37225,1,1,201,1402,1201
37226,0,0,78,0,-78
37227,0,0,56,0,-56
37228,0,0,7,0,-7
37229,0,0,0,0,0
37230,1,1,918,1354,436
37231,1,0,39,0,-39
37232,1,0,9,0,-9
37233,1,0,55,0,-55
37234,0,0,32,0,-32
37235,1,1,679,2070,1391
37236,0,0,3,0,-3
37237,1,0,20,0,-20
37238,1,1,277,1401,1124
37239,0,0,317,0,-317
37240,0,0,101,0,-101
37241,0,0,22,0,-22
37242,0,0,28,0,-28
37243,0,0,13,0,-13
37244,1,0,14,0,-14
37245,0,0,11,0,-11
37246,1,0,113,0,-113
37247,1,1,193,1228,1035
37248,0,0,48,0,-48
37249,1,0,154,0,-154
37250,0,0,13,0,-13
37251,1,0,10,0,-10
37252,1,1,1085,1428,343
37253,1,1,238,1284,1046
37254,1,1,280,1493,1213
37255,1,1,27,1775,1748
37256,1,0,116,0,-116
37257,1,0,162,0,-162
37258,0,0,2,0,-2
37259,1,1,760,1894,1134
37260,0,0,50,0,-50
37261,0,0,0,0,0
37262,1,0,80,0,-80
37263,0,0,15,0,-15
37264,1,0,57,0,-57
37265,1,0,12,0,-12
37266,1,0,163,0,-163
37267,1,1,290,2338,2048
37268,1,1,91,1619,1528
37269,0,0,18,0,-18
37270,1,1,608,1598,990
37271,1,1,604,1510,906
37272,0,0,20,0,-20
37273,1,0,96,0,-96
37274,0,0,81,0,-81
37275,0,0,17,0,-17
37276,1,0,11,0,-11
37277,0,0,67,0,-67
37278,0,0,311,0,-311
37279,0,0,19,0,-19
37280,1,1,314,1482,1168
37281,0,0,50,0,-50
37282,0,0,68,0,-68
37283,1,1,638,1298,660
37284,1,0,43,0,-43
37285,1,0,25,0,-25
37286,1,1,505,1783,1278
37287,1,0,52,0,-52
37288,0,0,8,0,-8
37289,0,0,75,0,-75
37290,1,0,22,0,-22
37291,0,0,43,0,-43
37292,0,0,50,0,-50
37293,0,0,27,0,-27
37294,1,0,1,0,-1
37295,1,1,156,1356,1200
37296,1,1,211,1289,1078
37297,1,1,748,1301,553
37298,1,1,597,1863,1266
37299,1,0,20,0,-20
37300,1,0,79,0,-79
37301,1,1,1320,1209,-111
37302,0,0,133,0,-133
37303,0,0,40,0,-40
37304,1,0,14,0,-14
37305,1,1,475,1455,980
37306,1,1,846,1434,588
37307,0,0,30,0,-30
37308,1,1,1373,1238,-135
37309,1,0,42,0,-42
37310,0,0,92,0,-92
37311,0,0,5,0,-5
37312,0,0,8,0,-8
37313,1,0,4,0,-4
37314,0,0,67,0,-67
37315,1,0,36,0,-36
37316,0,0,2,0,-2
37317,1,0,85,0,-85
37318,0,0,44,0,-44
37319,1,1,56,1775,1719
37320,1,0,7,0,-7
37321,0,0,4,0,-4
37322,0,0,60,0,-60
37323,1,0,37,0,-37
37324,1,0,10,0,-10
37325,1,1,190,1437,1247
37326,1,1,577,1348,771
37327,1,0,17,0,-17
37328,0,0,129,0,-129
37329,0,0,10,0,-10
37330,0,0,11,0,-11
37331,0,0,26,0,-26
37332,1,0,61,0,-61
37333,1,1,85,1411,1326
37334,0,0,297,0,-297
37335,1,0,58,0,-58
37336,1,1,249,1992,1743
37337,1,0,18,0,-18
37338,1,0,7,0,-7
37339,0,0,353,0,-353
37340,1,1,216,1466,1250
37341,1,0,37,0,-37
37342,1,1,1181,1856,675
37343,1,1,1290,1287,-3
37344,1,1,621,2152,1531
37345,0,0,44,0,-44
37346,0,0,12,0,-12
37347,1,1,146,4014,3868
37348,0,0,55,0,-55
37349,0,0,141,0,-141
37350,1,0,39,0,-39
37351,0,0,165,0,-165
37352,0,0,73,0,-73
37353,1,1,241,1249,1008
37354,1,0,22,0,-22
37355,0,0,14,0,-14
37356,1,0,1,0,-1
37357,0,0,31,0,-31
37358,1,1,2348,1862,-486
37359,1,0,3,0,-3
37360,1,0,2,0,-2
37361,0,0,8,0,-8
37362,1,1,156,1843,1687
37363,0,0,5,0,-5
37364,1,1,447,1230,783
37365,0,0,40,0,-40
37366,1,0,166,0,-166
37367,1,1,186,1702,1516
37368,0,0,68,0,-68
37369,0,0,102,0,-102
37370,1,0,58,0,-58
37371,0,0,86,0,-86
37372,1,1,379,1251,872
37373,1,1,830,1299,469
37374,0,0,23,0,-23
37375,0,0,30,0,-30
37376,1,0,2,0,-2
37377,1,1,200,1214,1014
37378,1,0,1,0,-1
37379,1,1,263,2000,1737
37380,0,0,44,0,-44
37381,0,0,28,0,-28
37382,0,0,162,0,-162
37383,1,1,283,1965,1682
37384,0,0,25,0,-25
37385,0,0,20,0,-20
37386,0,0,158,0,-158
37387,0,0,73,0,-73
37388,1,0,27,0,-27
37389,0,0,161,0,-161
37390,0,0,70,0,-70
37391,1,1,321,1926,1605
37392,1,0,1,0,-1
37393,1,1,146,1947,1801
37394,1,1,1344,1207,-137
37395,1,1,418,1352,934
37396,1,1,462,1714,1252
37397,0,0,24,0,-24
37398,1,0,25,0,-25
37399,1,1,346,1681,1335
37400,1,0,45,0,-45
37401,0,0,18,0,-18
37402,0,0,16,0,-16
37403,0,0,37,0,-37
37404,0,0,62,0,-62
37405,0,0,15,0,-15
37406,1,1,510,1389,879
37407,1,1,176,1377,1201
37408,0,0,8,0,-8
37409,1,0,66,0,-66
37410,1,0,34,0,-34
37411,0,0,1,0,-1
37412,0,0,60,0,-60
37413,1,0,45,0,-45
37414,1,0,60,0,-60
37415,0,0,17,0,-17
37416,1,1,337,1206,869
37417,0,0,23,0,-23
37418,0,0,19,0,-19
37419,1,1,517,2434,1917
37420,0,0,13,0,-13
37421,0,0,77,0,-77
37422,0,0,175,0,-175
37423,0,0,29,0,-29
37424,1,0,20,0,-20
37425,1,0,41,0,-41
37426,1,1,775,1724,949
37427,1,1,1218,1597,379
37428,1,0,204,0,-204
37429,1,1,142,1539,1397
37430,1,1,382,1744,1362
37431,1,0,58,0,-58
37432,1,1,337,1295,958
37433,1,1,250,1388,1138
37434,0,0,42,0,-42
37435,0,0,108,0,-108
37436,1,1,1517,1379,-138
37437,0,0,53,0,-53
37438,0,0,92,0,-92
37439,0,0,7,0,-7
37440,0,0,88,0,-88
37441,1,1,134,1609,1475
37442,0,0,125,0,-125
37443,0,0,37,0,-37
37444,1,0,89,0,-89
37445,1,0,43,0,-43
37446,0,0,53,0,-53
37447,0,0,43,0,-43
37448,1,1,183,1640,1457
37449,1,1,275,1369,1094
37450,1,1,337,2798,2461
37451,1,0,2,0,-2
37452,0,0,207,0,-207
37453,1,1,57,1598,1541
37454,1,1,459,1310,851
37455,1,0,81,0,-81
37456,1,0,39,0,-39
37457,0,0,6,0,-6
37458,0,0,5,0,-5
37459,1,0,49,0,-49
37460,1,0,4,0,-4
37461,1,1,366,1471,1105
37462,1,0,65,0,-65
37463,1,1,401,1325,924
37464,1,1,330,1293,963
37465,1,0,43,0,-43
37466,1,1,73,1210,1137
37467,1,0,2,0,-2
37468,1,0,83,0,-83
37469,0,0,165,0,-165
37470,1,1,304,1737,1433
37471,1,0,69,0,-69
37472,0,0,39,0,-39
37473,1,0,23,0,-23
37474,1,0,214,0,-214
37475,0,0,12,0,-12
37476,1,0,198,0,-198
37477,0,0,91,0,-91
37478,0,0,5,0,-5
37479,0,0,127,0,-127
37480,0,0,47,0,-47
37481,1,1,614,1213,599
37482,0,0,32,0,-32
37483,1,1,1119,1352,233
37484,0,0,49,0,-49
37485,0,0,108,0,-108
37486,1,1,356,1386,1030
37487,1,1,1465,1822,357
37488,1,1,426,1220,794
37489,1,0,154,0,-154
37490,1,0,97,0,-97
37491,1,0,76,0,-76
37492,1,1,147,1260,1113
37493,1,1,736,7816,7080
37494,0,0,5,0,-5
37495,1,1,393,1740,1347
37496,1,0,83,0,-83
37497,1,1,496,2649,2153
37498,1,1,830,1297,467
37499,1,0,70,0,-70
37500,1,0,141,0,-141
37501,1,1,361,1390,1029
37502,1,0,34,0,-34
37503,1,1,656,1336,680
37504,1,0,34,0,-34
37505,0,0,19,0,-19
37506,1,1,223,1367,1144
37507,0,0,15,0,-15
37508,1,0,33,0,-33
37509,1,1,150,1474,1324
37510,1,0,41,0,-41
37511,0,0,3,0,-3
37512,1,1,273,1377,1104
37513,0,0,34,0,-34
37514,1,1,1025,1348,323
37515,0,0,131,0,-131
37516,0,0,23,0,-23
37517,1,1,884,2113,1229
37518,1,0,2,0,-2
37519,1,0,7,0,-7
37520,0,0,66,0,-66
37521,1,0,17,0,-17
37522,1,0,146,0,-146
37523,0,0,4,0,-4
37524,0,0,26,0,-26
37525,1,0,73,0,-73
37526,1,1,890,3124,2234
37527,1,1,83,1214,1131
37528,0,0,0,0,0
37529,1,1,193,1485,1292
37530,1,1,153,1745,1592
37531,1,1,235,1267,1032
37532,0,0,16,0,-16
37533,1,0,145,0,-145
37534,0,0,68,0,-68
37535,1,1,1033,1261,228
37536,0,0,26,0,-26
37537,0,0,81,0,-81
37538,0,0,62,0,-62
37539,1,0,62,0,-62
37540,0,0,58,0,-58
37541,1,1,706,1204,498
37542,1,1,551,1377,826
37543,0,0,186,0,-186
37544,1,1,304,2307,2003
37545,1,1,236,1222,986
37546,1,0,8,0,-8
37547,0,0,8,0,-8
37548,0,0,25,0,-25
37549,0,0,110,0,-110
37550,1,1,172,1857,1685
37551,0,0,56,0,-56
37552,1,1,348,1846,1498
37553,0,0,34,0,-34
37554,0,0,40,0,-40
37555,1,1,2157,1230,-927
37556,1,1,311,1873,1562
37557,1,0,4,0,-4
37558,0,0,78,0,-78
37559,1,1,286,1941,1655
37560,1,1,432,1946,1514
37561,1,0,1,0,-1
37562,1,0,34,0,-34
37563,0,0,46,0,-46
37564,0,0,81,0,-81
37565,0,0,33,0,-33
37566,1,0,35,0,-35
37567,1,0,125,0,-125
37568,0,0,83,0,-83
37569,1,0,17,0,-17
37570,1,0,108,0,-108
37571,1,0,12,0,-12
37572,0,0,29,0,-29
37573,0,0,47,0,-47
37574,1,1,260,1626,1366
37575,1,1,519,1384,865
37576,1,1,522,1203,681
37577,1,1,554,1608,1054
37578,1,1,290,1355,1065
37579,0,0,96,0,-96
37580,1,0,29,0,-29
37581,1,0,11,0,-11
37582,0,0,18,0,-18
37583,1,0,22,0,-22
37584,0,0,220,0,-220
37585,0,0,92,0,-92
37586,0,0,11,0,-11
37587,0,0,19,0,-19
37588,1,1,707,1257,550
37589,1,0,58,0,-58
37590,1,0,25,0,-25
37591,1,0,3,0,-3
37592,0,0,72,0,-72
37593,1,1,506,1525,1019
37594,1,0,29,0,-29
37595,1,0,62,0,-62
37596,0,0,1,0,-1
37597,1,1,239,2071,1832
37598,0,0,6,0,-6
37599,0,0,88,0,-88
37600,0,0,53,0,-53
37601,0,0,4,0,-4
37602,0,0,9,0,-9
37603,0,0,24,0,-24
37604,1,1,550,1530,980
37605,1,0,125,0,-125
37606,1,1,339,1357,1018
37607,0,0,168,0,-168
37608,1,0,76,0,-76
37609,1,1,75,1831,1756
37610,1,0,4,0,-4
37611,1,1,171,1296,1125
37612,0,0,91,0,-91
37613,0,0,44,0,-44
37614,1,0,13,0,-13
37615,1,1,237,1229,992
37616,0,0,6,0,-6
37617,0,0,32,0,-32
37618,1,1,695,1307,612
37619,0,0,11,0,-11
37620,1,0,9,0,-9
37621,0,0,226,0,-226
37622,0,0,50,0,-50
37623,0,0,24,0,-24
37624,1,0,14,0,-14
37625,1,0,8,0,-8
37626,1,0,91,0,-91
37627,1,0,148,0,-148
37628,0,0,97,0,-97
37629,1,1,1146,1384,238
37630,0,0,38,0,-38
37631,1,0,32,0,-32
37632,1,0,2,0,-2
37633,1,0,134,0,-134
37634,1,1,1313,1607,294
37635,0,0,62,0,-62
37636,1,0,30,0,-30
37637,1,0,12,0,-12
37638,0,0,61,0,-61
37639,1,1,1267,1575,308
37640,0,0,25,0,-25
37641,0,0,11,0,-11
37642,1,1,368,1215,847
37643,1,0,62,0,-62
37644,1,0,23,0,-23
37645,1,1,178,1368,1190
37646,0,0,174,0,-174
37647,1,0,22,0,-22
37648,1,1,672,2243,1571
37649,1,1,339,1205,866
37650,1,0,1,0,-1
37651,0,0,8,0,-8
37652,0,0,40,0,-40
37653,0,0,31,0,-31
37654,1,1,1015,1277,262
37655,0,0,1,0,-1
37656,1,0,6,0,-6
37657,1,0,0,0,0
37658,1,1,1660,2712,1052
37659,1,0,0,0,0
37660,0,0,34,0,-34
37661,0,0,47,0,-47
37662,1,0,68,0,-68
37663,1,1,159,1209,1050
37664,0,0,89,0,-89
37665,0,0,22,0,-22
37666,0,0,0,0,0
37667,0,0,29,0,-29
37668,1,0,1,0,-1
37669,1,1,1769,1417,-352
37670,0,0,47,0,-47
37671,0,0,42,0,-42
37672,1,0,12,0,-12
37673,0,0,27,0,-27
37674,1,0,46,0,-46
37675,0,0,20,0,-20
37676,1,0,41,0,-41
37677,1,0,48,0,-48
37678,1,0,64,0,-64
37679,0,0,118,0,-118
37680,0,0,45,0,-45
37681,0,0,196,0,-196
37682,1,1,561,1513,952
37683,1,1,690,3017,2327
37684,1,0,1,0,-1
37685,0,0,93,0,-93
37686,1,0,13,0,-13
37687,1,1,1329,1338,9
37688,1,1,118,2699,2581
37689,1,0,101,0,-101
37690,1,0,68,0,-68
37691,1,0,18,0,-18
37692,1,0,38,0,-38
37693,0,0,15,0,-15
37694,0,0,0,0,0
37695,1,0,29,0,-29
37696,1,1,820,1513,693
37697,0,0,30,0,-30
37698,0,0,4,0,-4
37699,1,1,140,2030,1890
37700,0,0,26,0,-26
37701,0,0,207,0,-207
37702,0,0,12,0,-12
37703,1,1,142,2042,1900
37704,1,0,25,0,-25
37705,0,0,145,0,-145
37706,0,0,9,0,-9
37707,0,0,27,0,-27
37708,1,1,669,2329,1660
37709,1,0,138,0,-138
37710,0,0,58,0,-58
37711,1,1,141,1723,1582
37712,1,0,9,0,-9
37713,1,1,1256,1648,392
37714,0,0,20,0,-20
37715,0,0,90,0,-90
37716,0,0,38,0,-38
37717,0,0,135,0,-135
37718,0,0,26,0,-26
37719,1,1,251,1490,1239
37720,0,0,62,0,-62
37721,0,0,13,0,-13
37722,0,0,134,0,-134
37723,0,0,59,0,-59
37724,0,0,21,0,-21
37725,0,0,36,0,-36
37726,0,0,164,0,-164
37727,1,1,903,1398,495
37728,0,0,3,0,-3
37729,1,0,147,0,-147
37730,0,0,108,0,-108
37731,1,1,1119,1342,223
37732,1,0,116,0,-116
37733,0,0,34,0,-34
37734,1,1,346,1273,927
37735,0,0,65,0,-65
37736,1,0,15,0,-15
37737,1,1,21,1421,1400
37738,1,0,2,0,-2
37739,1,1,924,1205,281
37740,1,0,92,0,-92
37741,0,0,154,0,-154
37742,1,1,776,1229,453
37743,1,1,671,1202,531
37744,1,1,1411,1201,-210
37745,1,0,24,0,-24
37746,0,0,42,0,-42
37747,1,1,203,3210,3007
37748,1,1,271,1427,1156
37749,1,0,14,0,-14
37750,1,1,369,1350,981
37751,0,0,70,0,-70
37752,0,0,47,0,-47
37753,0,0,1,0,-1
37754,1,1,756,1238,482
37755,1,0,15,0,-15
37756,1,0,19,0,-19
37757,1,0,96,0,-96
37758,0,0,102,0,-102
37759,0,0,111,0,-111
37760,1,0,26,0,-26
37761,1,1,763,1304,541
37762,1,1,503,1770,1267
37763,1,1,802,1886,1084
37764,1,1,154,1703,1549
37765,1,1,233,1364,1131
37766,0,0,103,0,-103
37767,0,0,9,0,-9
37768,1,1,323,1623,1300
37769,0,0,71,0,-71
37770,1,1,443,1200,757
37771,0,0,145,0,-145
37772,0,0,33,0,-33
37773,1,0,19,0,-19
37774,0,0,54,0,-54
37775,1,0,61,0,-61
37776,1,0,33,0,-33
37777,1,1,236,1552,1316
37778,1,1,675,1726,1051
37779,0,0,57,0,-57
37780,1,0,51,0,-51
37781,1,0,49,0,-49
37782,1,0,46,0,-46
37783,1,1,499,1859,1360
37784,1,1,320,1873,1553
37785,1,0,44,0,-44
37786,1,1,686,1563,877
37787,1,1,340,1892,1552
37788,0,0,36,0,-36
37789,1,0,15,0,-15
37790,1,1,1513,1559,46
37791,0,0,2,0,-2
37792,0,0,27,0,-27
37793,0,0,8,0,-8
37794,1,0,79,0,-79
37795,1,0,254,0,-254
37796,0,0,0,0,0
37797,0,0,39,0,-39
37798,0,0,51,0,-51
37799,1,0,54,0,-54
37800,1,0,80,0,-80
37801,0,0,22,0,-22
37802,0,0,20,0,-20
37803,1,0,62,0,-62
37804,1,1,40,1281,1241
37805,1,1,873,1404,531
37806,1,0,21,0,-21
37807,1,1,596,1233,637
37808,1,0,14,0,-14
37809,0,0,4,0,-4
37810,1,0,244,0,-244
37811,1,1,757,1371,614
37812,1,1,252,1233,981
37813,0,0,53,0,-53
37814,1,1,454,1311,857
37815,0,0,39,0,-39
37816,1,0,85,0,-85
37817,0,0,65,0,-65
37818,1,1,186,1272,1086
37819,0,0,53,0,-53
37820,0,0,127,0,-127
37821,0,0,270,0,-270
37822,1,1,61,1297,1236
37823,1,0,41,0,-41
37824,0,0,21,0,-21
37825,0,0,161,0,-161
37826,1,1,1326,1709,383
37827,1,0,0,0,0
37828,0,0,18,0,-18
37829,1,1,278,1220,942
37830,0,0,5,0,-5
37831,0,0,45,0,-45
37832,0,0,27,0,-27
37833,0,0,24,0,-24
37834,0,0,14,0,-14
37835,1,1,504,1534,1030
37836,0,0,35,0,-35
37837,0,0,32,0,-32
37838,0,0,90,0,-90
37839,1,0,125,0,-125
37840,1,1,440,1399,959
37841,1,0,88,0,-88
37842,0,0,142,0,-142
37843,1,1,293,2672,2379
37844,1,0,43,0,-43
37845,0,0,129,0,-129
37846,1,1,60,1288,1228
37847,1,0,21,0,-21
37848,0,0,89,0,-89
37849,1,0,124,0,-124
37850,1,0,71,0,-71
37851,1,0,8,0,-8
37852,1,1,542,1348,806
37853,1,0,57,0,-57
37854,1,0,45,0,-45
37855,0,0,3,0,-3
37856,1,0,2,0,-2
37857,1,1,599,1401,802
37858,0,0,12,0,-12
37859,1,1,166,1213,1047
37860,0,0,19,0,-19
37861,1,0,0,0,0
37862,1,1,1174,4021,2847
37863,1,1,548,1377,829
37864,1,1,257,1436,1179
37865,0,0,44,0,-44
37866,1,1,308,1615,1307
37867,0,0,55,0,-55
37868,0,0,36,0,-36
37869,0,0,73,0,-73
37870,1,1,153,1648,1495
37871,1,0,21,0,-21
37872,0,0,56,0,-56
37873,0,0,29,0,-29
37874,0,0,37,0,-37
37875,0,0,26,0,-26
37876,1,0,5,0,-5
37877,0,0,6,0,-6
37878,1,1,111,1789,1678
37879,1,0,30,0,-30
37880,1,0,54,0,-54
37881,0,0,161,0,-161
37882,1,1,785,2409,1624
37883,0,0,55,0,-55
37884,1,0,10,0,-10
37885,1,1,430,1444,1014
37886,0,0,31,0,-31
37887,1,0,53,0,-53
37888,1,1,89,1678,1589
37889,1,0,22,0,-22
37890,1,1,655,1538,883
37891,0,0,12,0,-12
37892,0,0,35,0,-35
37893,1,0,16,0,-16
37894,0,0,100,0,-100
37895,0,0,117,0,-117
37896,1,0,95,0,-95
37897,1,1,935,1238,303
37898,0,0,45,0,-45
37899,1,1,1090,1243,153
37900,0,0,17,0,-17
37901,1,0,0,0,0
37902,1,0,33,0,-33
37903,1,1,227,1469,1242
37904,1,0,0,0,0
37905,1,1,321,1600,1279
37906,1,1,59,1323,1264
37907,1,1,395,1525,1130
37908,0,0,52,0,-52
37909,1,1,36,2920,2884
37910,0,0,75,0,-75
37911,1,1,46,1232,1186
37912,0,0,15,0,-15
37913,1,0,5,0,-5
37914,1,1,778,1744,966
37915,1,0,40,0,-40
37916,1,1,222,1825,1603
37917,0,0,15,0,-15
37918,0,0,188,0,-188
37919,0,0,21,0,-21
37920,1,1,166,2423,2257
37921,1,1,214,1389,1175
37922,1,1,989,1741,752
37923,1,0,49,0,-49
37924,1,0,14,0,-14
37925,1,1,1660,1228,-432
37926,1,0,19,0,-19
37927,1,1,134,1240,1106
37928,1,0,73,0,-73
37929,0,0,46,0,-46
37930,0,0,65,0,-65
37931,0,0,34,0,-34
37932,0,0,52,0,-52
37933,0,0,58,0,-58
37934,0,0,9,0,-9
37935,0,0,43,0,-43
37936,0,0,5,0,-5
37937,1,0,12,0,-12
37938,1,0,39,0,-39
37939,0,0,20,0,-20
37940,0,0,10,0,-10
37941,1,1,734,1200,466
37942,1,1,390,5338,4948
37943,1,1,1046,1214,168
37944,1,0,1,0,-1
37945,0,0,10,0,-10
37946,1,1,427,1914,1487
37947,1,0,179,0,-179
37948,0,0,214,0,-214
37949,1,0,0,0,0
37950,0,0,9,0,-9
37951,1,0,51,0,-51
37952,0,0,128,0,-128
37953,0,0,57,0,-57
37954,0,0,13,0,-13
37955,1,1,1087,1469,382
37956,0,0,21,0,-21
37957,1,1,654,1589,935
37958,1,1,388,1459,1071
37959,1,1,129,1363,1234
37960,0,0,13,0,-13
37961,0,0,0,0,0
37962,1,0,27,0,-27
37963,0,0,6,0,-6
37964,1,0,42,0,-42
37965,1,0,4,0,-4
37966,0,0,47,0,-47
37967,1,1,978,1673,695
37968,1,0,18,0,-18
37969,1,0,10,0,-10
37970,1,0,8,0,-8
37971,1,1,869,1781,912
37972,0,0,13,0,-13
37973,1,0,15,0,-15
37974,1,1,434,1424,990
37975,1,0,9,0,-9
37976,1,0,4,0,-4
37977,1,0,28,0,-28
37978,0,0,65,0,-65
37979,1,0,19,0,-19
37980,1,0,6,0,-6
37981,0,0,55,0,-55
37982,0,0,89,0,-89
37983,1,0,1,0,-1
37984,1,1,185,1535,1350
37985,1,1,88,1807,1719
37986,0,0,1,0,-1
37987,1,1,119,1631,1512
37988,1,1,1077,1293,216
37989,1,0,7,0,-7
37990,1,0,120,0,-120
37991,1,0,48,0,-48
37992,0,0,22,0,-22
37993,0,0,3,0,-3
37994,1,0,22,0,-22
37995,0,0,84,0,-84
37996,0,0,12,0,-12
37997,0,0,16,0,-16
37998,1,0,33,0,-33
37999,1,0,213,0,-213
38000,1,1,376,1296,920
38001,1,1,645,1372,727
38002,1,0,26,0,-26
38003,1,1,153,1353,1200
38004,1,1,515,1315,800
38005,1,1,693,2097,1404
38006,0,0,38,0,-38
38007,1,0,16,0,-16
38008,1,1,399,1221,822
38009,0,0,15,0,-15
38010,1,1,192,1302,1110
38011,1,0,46,0,-46
38012,0,0,190,0,-190
38013,1,0,9,0,-9
38014,1,0,91,0,-91
38015,0,0,35,0,-35
38016,1,1,56,2017,1961
38017,1,1,475,2708,2233
38018,1,1,453,1290,837
38019,1,0,40,0,-40
38020,0,0,102,0,-102
38021,0,0,70,0,-70
38022,1,0,33,0,-33
38023,0,0,17,0,-17
38024,1,1,280,2313,2033
38025,1,1,796,2711,1915
38026,1,1,357,1219,862
38027,1,1,361,1396,1035
38028,0,0,10,0,-10
38029,0,0,19,0,-19
38030,1,0,97,0,-97
38031,1,1,914,2563,1649
38032,1,1,1324,1237,-87
38033,0,0,110,0,-110
38034,1,1,144,1365,1221
38035,0,0,9,0,-9
38036,0,0,8,0,-8
38037,0,0,80,0,-80
38038,0,0,6,0,-6
38039,0,0,29,0,-29
38040,0,0,110,0,-110
38041,1,0,2,0,-2
38042,0,0,33,0,-33
38043,0,0,44,0,-44
38044,1,1,251,2606,2355
38045,0,0,19,0,-19
38046,0,0,15,0,-15
38047,1,0,28,0,-28
38048,1,0,74,0,-74
38049,0,0,66,0,-66
38050,1,0,78,0,-78
38051,0,0,8,0,-8
38052,1,0,45,0,-45
38053,0,0,10,0,-10
38054,0,0,37,0,-37
38055,1,1,481,1315,834
38056,0,0,11,0,-11
38057,1,0,30,0,-30
38058,1,0,42,0,-42
38059,1,0,6,0,-6
38060,1,1,569,3819,3250
38061,0,0,49,0,-49
38062,0,0,0,0,0
38063,1,1,1236,1519,283
38064,1,0,97,0,-97
38065,1,1,1057,1294,237
38066,1,1,261,1473,1212
38067,1,1,650,1331,681
38068,0,0,8,0,-8
38069,0,0,101,0,-101
38070,1,1,1354,2369,1015
38071,0,0,30,0,-30
38072,0,0,17,0,-17
38073,1,1,722,1560,838
38074,0,0,33,0,-33
38075,0,0,2,0,-2
38076,1,0,153,0,-153
38077,0,0,73,0,-73
38078,1,0,16,0,-16
38079,1,0,39,0,-39
38080,1,1,290,1680,1390
38081,1,1,279,1833,1554
38082,0,0,100,0,-100
38083,1,1,93,1304,1211
38084,0,0,54,0,-54
38085,1,0,245,0,-245
38086,1,1,664,1404,740
38087,1,0,7,0,-7
38088,1,1,95,1331,1236
38089,1,1,264,1342,1078
38090,0,0,1,0,-1
38091,0,0,3,0,-3
38092,1,1,930,1304,374
38093,0,0,39,0,-39
38094,0,0,40,0,-40
38095,1,1,2675,1769,-906
38096,1,1,297,1772,1475
38097,0,0,2,0,-2
38098,0,0,105,0,-105
38099,1,0,17,0,-17
38100,0,0,66,0,-66
38101,1,0,106,0,-106
38102,0,0,12,0,-12
38103,1,1,236,2372,2136
38104,0,0,1,0,-1
38105,1,0,57,0,-57
38106,0,0,15,0,-15
38107,0,0,2,0,-2
38108,1,1,1501,1718,217
38109,1,1,188,1250,1062
38110,1,1,150,1305,1155
38111,1,0,19,0,-19
38112,1,0,0,0,0
38113,0,0,47,0,-47
38114,1,1,189,3037,2848
38115,0,0,7,0,-7
38116,1,0,94,0,-94
38117,0,0,24,0,-24
38118,1,1,476,1674,1198
38119,1,0,47,0,-47
38120,1,1,208,1403,1195
38121,1,0,74,0,-74
38122,0,0,6,0,-6
38123,1,1,301,1358,1057
38124,1,0,20,0,-20
38125,0,0,7,0,-7
38126,1,0,17,0,-17
38127,1,1,147,1251,1104
38128,0,0,43,0,-43
38129,1,0,37,0,-37
38130,1,0,58,0,-58
38131,1,0,145,0,-145
38132,1,0,74,0,-74
38133,0,0,176,0,-176
38134,1,1,96,1413,1317
38135,1,1,481,1316,835
38136,1,1,238,1601,1363
38137,1,0,0,0,0
38138,1,1,344,1490,1146
38139,1,1,58,1227,1169
38140,0,0,222,0,-222
38141,1,0,9,0,-9
38142,1,1,221,1311,1090
38143,0,0,62,0,-62
38144,0,0,72,0,-72
38145,0,0,15,0,-15
38146,1,0,15,0,-15
38147,0,0,45,0,-45
38148,0,0,128,0,-128
38149,1,1,461,1503,1042
38150,0,0,33,0,-33
38151,0,0,6,0,-6
38152,0,0,2,0,-2
38153,1,0,70,0,-70
38154,0,0,121,0,-121
38155,1,0,45,0,-45
38156,0,0,4,0,-4
38157,1,0,11,0,-11
38158,1,1,647,1453,806
38159,1,0,61,0,-61
38160,1,0,82,0,-82
38161,1,1,134,1286,1152
38162,1,1,803,1887,1084
38163,0,0,49,0,-49
38164,1,1,1391,1680,289
38165,0,0,123,0,-123
38166,1,0,23,0,-23
38167,0,0,108,0,-108
38168,1,1,98,1447,1349
38169,1,0,50,0,-50
38170,0,0,65,0,-65
38171,1,1,890,1312,422
38172,1,0,2,0,-2
38173,0,0,8,0,-8
38174,1,1,261,1481,1220
38175,1,0,6,0,-6
38176,0,0,31,0,-31
38177,1,0,1,0,-1
38178,1,0,28,0,-28
38179,1,0,11,0,-11
38180,0,0,3,0,-3
38181,1,0,134,0,-134
38182,1,1,1177,1686,509
38183,0,0,65,0,-65
38184,1,0,24,0,-24
38185,0,0,66,0,-66
38186,0,0,66,0,-66
38187,0,0,7,0,-7
38188,1,0,31,0,-31
38189,0,0,16,0,-16
38190,0,0,57,0,-57
38191,0,0,26,0,-26
38192,1,1,952,2200,1248
38193,1,0,110,0,-110
38194,1,0,9,0,-9
38195,1,0,12,0,-12
38196,1,1,1889,1290,-599
38197,1,0,19,0,-19
38198,1,0,106,0,-106
38199,0,0,18,0,-18
38200,1,0,5,0,-5
38201,0,0,21,0,-21
38202,1,1,196,1287,1091
38203,0,0,15,0,-15
38204,0,0,3,0,-3
38205,1,1,562,1436,874
38206,1,0,0,0,0
38207,0,0,48,0,-48
38208,0,0,13,0,-13
38209,1,0,55,0,-55
38210,1,1,390,4553,4163
38211,1,1,486,1412,926
38212,1,0,22,0,-22
38213,1,0,25,0,-25
38214,1,1,96,1377,1281
38215,1,1,182,1238,1056
38216,1,0,96,0,-96
38217,1,1,24,1826,1802
38218,0,0,61,0,-61
38219,0,0,96,0,-96
38220,1,0,7,0,-7
38221,0,0,22,0,-22
38222,0,0,73,0,-73
38223,1,0,33,0,-33
38224,0,0,34,0,-34
38225,1,0,2,0,-2
38226,1,1,488,1237,749
38227,1,1,994,1206,212
38228,0,0,22,0,-22
38229,0,0,38,0,-38
38230,1,0,53,0,-53
38231,1,1,1195,1674,479
38232,1,0,246,0,-246
38233,1,1,761,1264,503
38234,1,1,87,1221,1134
38235,1,0,8,0,-8
38236,1,1,740,1369,629
38237,1,1,671,2360,1689
38238,1,1,537,1417,880
38239,0,0,25,0,-25
38240,0,0,66,0,-66
38241,1,1,1222,4225,3003
38242,1,1,633,1786,1153
38243,0,0,21,0,-21
38244,1,0,24,0,-24
38245,1,0,63,0,-63
38246,1,1,34,2319,2285
38247,1,0,34,0,-34
38248,1,0,12,0,-12
38249,0,0,27,0,-27
38250,1,0,40,0,-40
38251,1,0,49,0,-49
38252,0,0,44,0,-44
38253,1,0,9,0,-9
38254,1,1,61,2304,2243
38255,1,0,74,0,-74
38256,1,0,227,0,-227
38257,0,0,10,0,-10
38258,1,0,197,0,-197
38259,0,0,15,0,-15
38260,1,0,48,0,-48
38261,1,0,44,0,-44
38262,0,0,19,0,-19
38263,1,1,355,1518,1163
38264,1,1,251,3080,2829
38265,1,1,428,1239,811
38266,1,0,30,0,-30
38267,1,0,17,0,-17
38268,1,1,419,1398,979
38269,0,0,89,0,-89
38270,0,0,179,0,-179
38271,0,0,0,0,0
38272,1,0,4,0,-4
38273,1,0,7,0,-7
38274,0,0,57,0,-57
38275,0,0,62,0,-62
38276,1,1,983,1444,461
38277,1,1,312,1904,1592
38278,1,0,138,0,-138
38279,0,0,32,0,-32
38280,1,1,497,1608,1111
38281,1,0,3,0,-3
38282,1,0,40,0,-40
38283,1,0,33,0,-33
38284,0,0,19,0,-19
38285,1,0,17,0,-17
38286,1,0,1,0,-1
38287,0,0,43,0,-43
38288,1,0,49,0,-49
38289,0,0,32,0,-32
38290,1,1,912,1310,398
38291,1,1,349,1473,1124
38292,1,1,285,1282,997
38293,1,1,117,1408,1291
38294,1,0,421,0,-421
38295,1,0,33,0,-33
38296,1,1,238,1416,1178
38297,1,0,42,0,-42
38298,0,0,83,0,-83
38299,0,0,26,0,-26
38300,1,1,656,1300,644
38301,1,0,26,0,-26
38302,1,1,625,1896,1271
38303,1,1,797,3130,2333
38304,1,0,5,0,-5
38305,0,0,23,0,-23
38306,1,1,124,1249,1125
38307,1,0,19,0,-19
38308,0,0,183,0,-183
38309,1,0,25,0,-25
38310,1,1,357,1316,959
38311,1,1,899,3012,2113
38312,1,0,13,0,-13
38313,1,0,48,0,-48
38314,1,1,373,1491,1118
38315,1,0,170,0,-170
38316,1,1,419,3064,2645
38317,0,0,91,0,-91
38318,0,0,217,0,-217
38319,1,1,1047,2218,1171
38320,1,1,1075,1870,795
38321,1,1,680,3467,2787
38322,1,0,74,0,-74
38323,0,0,37,0,-37
38324,1,0,83,0,-83
38325,0,0,58,0,-58
38326,1,0,87,0,-87
38327,1,0,129,0,-129
38328,1,1,195,1399,1204
38329,1,1,1598,1547,-51
38330,0,0,1,0,-1
38331,1,0,4,0,-4
38332,0,0,0,0,0
38333,1,1,551,1932,1381
38334,1,1,342,1252,910
38335,0,0,38,0,-38
38336,1,0,107,0,-107
38337,0,0,8,0,-8
38338,1,0,34,0,-34
38339,1,0,46,0,-46
38340,1,1,1145,2081,936
38341,1,1,566,1609,1043
38342,1,0,91,0,-91
38343,0,0,7,0,-7
38344,1,0,58,0,-58
38345,1,1,157,1213,1056
38346,1,1,426,1541,1115
38347,0,0,11,0,-11
38348,1,1,36,1515,1479
38349,1,1,472,1533,1061
38350,1,0,48,0,-48
38351,0,0,40,0,-40
38352,1,0,0,0,0
38353,0,0,63,0,-63
38354,1,1,229,2189,1960
38355,0,0,121,0,-121
38356,1,1,716,1613,897
38357,1,0,0,0,0
38358,0,0,241,0,-241
38359,0,0,112,0,-112
38360,1,1,110,1632,1522
38361,1,0,13,0,-13
38362,1,1,65,1326,1261
38363,1,1,358,1247,889
38364,0,0,3,0,-3
38365,1,0,19,0,-19
38366,0,0,18,0,-18
38367,1,0,16,0,-16
38368,1,0,6,0,-6
38369,0,0,35,0,-35
38370,1,1,819,1470,651
38371,1,1,389,1832,1443
38372,0,0,28,0,-28
38373,0,0,68,0,-68
38374,1,0,2,0,-2
38375,1,1,1045,5797,4752
38376,1,1,1908,1819,-89
38377,1,0,139,0,-139
38378,0,0,27,0,-27
38379,0,0,128,0,-128
38380,0,0,37,0,-37
38381,1,0,163,0,-163
38382,1,1,121,1408,1287
38383,0,0,2,0,-2
38384,1,0,64,0,-64
38385,0,0,54,0,-54
38386,0,0,61,0,-61
38387,0,0,7,0,-7
38388,0,0,7,0,-7
38389,1,0,126,0,-126
38390,0,0,18,0,-18
38391,1,1,2047,1337,-710
38392,1,1,196,1891,1695
38393,1,0,214,0,-214
38394,1,0,67,0,-67
38395,1,0,17,0,-17
38396,0,0,12,0,-12
38397,1,1,1249,1342,93
38398,1,1,1295,2603,1308
38399,0,0,154,0,-154
38400,1,1,34,1249,1215
38401,1,1,159,1918,1759
38402,1,1,121,1232,1111
38403,1,1,196,1398,1202
38404,0,0,11,0,-11
38405,1,1,609,1409,800
38406,0,0,15,0,-15
38407,0,0,26,0,-26
38408,1,1,935,2152,1217
38409,1,0,92,0,-92
38410,0,0,8,0,-8
38411,0,0,50,0,-50
38412,1,0,14,0,-14
38413,1,0,218,0,-218
38414,0,0,16,0,-16
38415,1,1,142,1391,1249
38416,1,0,8,0,-8
38417,1,0,46,0,-46
38418,0,0,61,0,-61
38419,1,1,2032,1429,-603
38420,1,1,161,1345,1184
38421,1,0,60,0,-60
38422,1,1,90,1914,1824
38423,1,0,159,0,-159
38424,0,0,5,0,-5
38425,1,0,9,0,-9
38426,1,1,957,1393,436
38427,1,1,1495,1436,-59
38428,1,1,403,1368,965
38429,0,0,0,0,0
38430,0,0,30,0,-30
38431,0,0,209,0,-209
38432,1,0,70,0,-70
38433,1,1,570,3113,2543
38434,1,0,5,0,-5
38435,0,0,0,0,0
38436,0,0,78,0,-78
38437,1,1,1577,1201,-376
38438,0,0,13,0,-13
38439,0,0,6,0,-6
38440,1,0,128,0,-128
38441,0,0,5,0,-5
38442,0,0,51,0,-51
38443,0,0,24,0,-24
38444,0,0,16,0,-16
38445,0,0,49,0,-49
38446,0,0,27,0,-27
38447,0,0,24,0,-24
38448,1,1,255,2836,2581
38449,1,0,31,0,-31
38450,1,0,16,0,-16
38451,1,0,26,0,-26
38452,1,0,66,0,-66
38453,0,0,31,0,-31
38454,0,0,147,0,-147
38455,0,0,26,0,-26
38456,0,0,37,0,-37
38457,1,0,32,0,-32
38458,0,0,23,0,-23
38459,0,0,47,0,-47
38460,1,1,777,1474,697
38461,0,0,43,0,-43
38462,1,0,27,0,-27
38463,1,0,21,0,-21
38464,0,0,8,0,-8
38465,0,0,249,0,-249
38466,1,1,1117,2787,1670
38467,1,1,83,1413,1330
38468,1,1,890,1426,536
38469,1,1,561,1909,1348
38470,0,0,10,0,-10
38471,1,0,3,0,-3
38472,1,1,9,1366,1357
38473,1,1,307,1625,1318
38474,1,0,7,0,-7
38475,1,0,69,0,-69
38476,1,0,41,0,-41
38477,1,0,74,0,-74
38478,1,1,2305,1842,-463
38479,1,1,188,1770,1582
38480,1,1,95,1698,1603
38481,1,1,258,1493,1235
38482,0,0,58,0,-58
38483,1,0,60,0,-60
38484,1,1,1197,1610,413
38485,1,1,109,1226,1117
38486,0,0,0,0,0
38487,1,1,362,1631,1269
38488,1,0,61,0,-61
38489,1,1,334,1284,950
38490,1,1,295,1204,909
38491,1,0,8,0,-8
38492,0,0,15,0,-15
38493,0,0,69,0,-69
38494,1,1,1155,1219,64
38495,1,1,86,1335,1249
38496,1,0,162,0,-162
38497,1,0,109,0,-109
38498,1,1,3061,2623,-438
38499,1,1,1454,1310,-144
38500,0,0,17,0,-17
38501,0,0,2,0,-2
38502,1,0,14,0,-14
38503,0,0,23,0,-23
38504,0,0,105,0,-105
38505,1,1,816,1906,1090
38506,0,0,21,0,-21
38507,1,1,631,1257,626
38508,0,0,15,0,-15
38509,1,1,23,1395,1372
38510,1,0,153,0,-153
38511,1,1,173,1399,1226
38512,1,0,46,0,-46
38513,1,0,8,0,-8
38514,1,1,187,1749,1562
38515,0,0,37,0,-37
38516,1,1,1208,1532,324
38517,1,0,7,0,-7
38518,1,0,72,0,-72
38519,1,1,470,1782,1312
38520,0,0,58,0,-58
38521,0,0,60,0,-60
38522,1,0,40,0,-40
38523,1,0,6,0,-6
38524,1,0,62,0,-62
38525,1,1,1369,1282,-87
38526,1,0,3,0,-3
38527,1,0,147,0,-147
38528,1,1,267,1876,1609
38529,0,0,20,0,-20
38530,0,0,80,0,-80
38531,0,0,63,0,-63
38532,0,0,16,0,-16
38533,0,0,10,0,-10
38534,1,1,485,1357,872
38535,1,1,703,2680,1977
38536,1,1,1053,1454,401
38537,0,0,24,0,-24
38538,1,0,87,0,-87
38539,0,0,45,0,-45
38540,1,1,2081,2219,138
38541,0,0,8,0,-8
38542,1,1,862,1324,462
38543,1,0,7,0,-7
38544,1,1,391,1642,1251
38545,1,0,115,0,-115
38546,1,1,155,1383,1228
38547,0,0,168,0,-168
38548,0,0,13,0,-13
38549,1,0,25,0,-25
38550,1,1,1158,1299,141
38551,1,1,243,1339,1096
38552,0,0,24,0,-24
38553,1,1,54,1383,1329
38554,0,0,229,0,-229
38555,1,0,64,0,-64
38556,0,0,41,0,-41
38557,1,0,183,0,-183
38558,0,0,1,0,-1
38559,1,0,76,0,-76
38560,1,1,549,3813,3264
38561,1,0,60,0,-60
38562,0,0,98,0,-98
38563,1,1,1130,2060,930
38564,0,0,37,0,-37
38565,1,0,6,0,-6
38566,0,0,41,0,-41
38567,1,1,536,2045,1509
38568,0,0,9,0,-9
38569,0,0,174,0,-174
38570,1,0,8,0,-8
38571,1,0,13,0,-13
38572,1,1,198,1257,1059
38573,0,0,74,0,-74
38574,1,0,41,0,-41
38575,1,0,24,0,-24
38576,1,0,6,0,-6
38577,0,0,10,0,-10
38578,1,0,13,0,-13
38579,1,1,148,1990,1842
38580,0,0,75,0,-75
38581,1,1,212,1259,1047
38582,1,1,208,1597,1389
38583,0,0,12,0,-12
38584,0,0,22,0,-22
38585,1,0,14,0,-14
38586,1,1,383,1467,1084
38587,1,0,29,0,-29
38588,1,0,12,0,-12
38589,1,1,870,1501,631
38590,0,0,27,0,-27
38591,1,0,78,0,-78
38592,1,1,58,1281,1223
38593,1,0,98,0,-98
38594,1,0,21,0,-21
38595,1,0,53,0,-53
38596,1,0,99,0,-99
38597,0,0,44,0,-44
38598,0,0,4,0,-4
38599,1,0,15,0,-15
38600,0,0,4,0,-4
38601,1,1,489,1496,1007
38602,1,0,7,0,-7
38603,0,0,13,0,-13
38604,1,1,470,3632,3162
38605,1,1,164,1275,1111
38606,1,1,195,1567,1372
38607,0,0,108,0,-108
38608,1,1,656,1569,913
38609,0,0,29,0,-29
38610,1,0,22,0,-22
38611,1,0,14,0,-14
38612,1,0,182,0,-182
38613,0,0,13,0,-13
38614,1,0,115,0,-115
38615,1,0,95,0,-95
38616,0,0,81,0,-81
38617,1,0,42,0,-42
38618,0,0,120,0,-120
38619,0,0,10,0,-10
38620,1,0,100,0,-100
38621,1,0,8,0,-8
38622,1,0,53,0,-53
38623,1,1,172,1399,1227
38624,1,0,175,0,-175
38625,1,0,33,0,-33
38626,1,0,15,0,-15
38627,1,0,39,0,-39
38628,1,1,294,1734,1440
38629,0,0,19,0,-19
38630,1,1,1017,1272,255
38631,1,0,165,0,-165
38632,1,1,129,1257,1128
38633,1,0,30,0,-30
38634,0,0,17,0,-17
38635,1,0,124,0,-124
38636,0,0,22,0,-22
38637,0,0,40,0,-40
38638,0,0,125,0,-125
38639,1,0,13,0,-13
38640,0,0,30,0,-30
38641,0,0,83,0,-83
38642,1,0,43,0,-43
38643,1,1,411,1523,1112
38644,0,0,16,0,-16
38645,1,1,629,1222,593
38646,0,0,99,0,-99
38647,0,0,55,0,-55
38648,0,0,6,0,-6
38649,1,0,5,0,-5
38650,1,1,490,1577,1087
38651,1,0,49,0,-49
38652,1,0,68,0,-68
38653,0,0,17,0,-17
38654,1,0,71,0,-71
38655,0,0,24,0,-24
38656,0,0,59,0,-59
38657,0,0,4,0,-4
38658,0,0,35,0,-35
38659,1,1,1095,1220,125
38660,0,0,83,0,-83
38661,0,0,30,0,-30
38662,1,1,735,1743,1008
38663,1,0,1,0,-1
38664,1,0,6,0,-6
38665,1,0,87,0,-87
38666,1,1,832,1344,512
38667,0,0,0,0,0
38668,0,0,33,0,-33
38669,0,0,96,0,-96
38670,1,1,250,1343,1093
38671,1,0,33,0,-33
38672,0,0,39,0,-39
38673,1,0,3,0,-3
38674,1,0,52,0,-52
38675,0,0,5,0,-5
38676,1,0,93,0,-93
38677,1,1,616,1729,1113
38678,1,1,228,1449,1221
38679,1,0,11,0,-11
38680,1,0,1,0,-1
38681,0,0,188,0,-188
38682,0,0,50,0,-50
38683,1,1,593,1235,642
38684,1,1,661,1666,1005
38685,1,1,56,2478,2422
38686,1,0,114,0,-114
38687,1,1,1328,2339,1011
38688,0,0,105,0,-105
38689,1,1,244,1857,1613
38690,1,1,201,1287,1086
38691,0,0,18,0,-18
38692,1,0,78,0,-78
38693,1,1,223,1298,1075
38694,1,1,371,1255,884
38695,0,0,10,0,-10
38696,0,0,7,0,-7
38697,0,0,70,0,-70
38698,1,1,94,1347,1253
38699,0,0,9,0,-9
38700,1,1,254,1216,962
38701,1,0,82,0,-82
38702,1,0,24,0,-24
38703,1,0,60,0,-60
38704,1,1,514,1689,1175
38705,0,0,26,0,-26
38706,1,0,68,0,-68
38707,0,0,2,0,-2
38708,1,0,8,0,-8
38709,1,0,73,0,-73
38710,1,1,178,1316,1138
38711,1,1,18,1323,1305
38712,0,0,9,0,-9
38713,1,0,1,0,-1
38714,0,0,49,0,-49
38715,1,0,37,0,-37
38716,1,1,401,1223,822
38717,1,0,32,0,-32
38718,0,0,19,0,-19
38719,1,1,792,1211,419
38720,1,1,621,1765,1144
38721,1,0,21,0,-21
38722,1,1,474,1290,816
38723,1,1,135,1240,1105
38724,1,1,60,1216,1156
38725,1,1,831,3041,2210
38726,0,0,32,0,-32
38727,0,0,109,0,-109
38728,0,0,91,0,-91
38729,0,0,46,0,-46
38730,1,1,153,1448,1295
38731,1,0,64,0,-64
38732,1,0,93,0,-93
38733,1,0,36,0,-36
38734,1,0,29,0,-29
38735,1,0,23,0,-23
38736,1,0,14,0,-14
38737,0,0,1,0,-1
38738,1,0,35,0,-35
38739,0,0,10,0,-10
38740,1,1,335,1258,923
38741,1,1,235,1966,1731
38742,1,1,407,3078,2671
38743,0,0,3,0,-3
38744,0,0,81,0,-81
38745,0,0,28,0,-28
38746,1,0,22,0,-22
38747,0,0,98,0,-98
38748,1,1,78,1303,1225
38749,0,0,0,0,0
38750,1,0,24,0,-24
38751,1,0,145,0,-145
38752,1,1,1270,1436,166
38753,0,0,19,0,-19
38754,1,1,589,1465,876
38755,1,1,421,2377,1956
38756,1,0,20,0,-20
38757,0,0,9,0,-9
38758,1,1,736,1505,769
38759,0,0,9,0,-9
38760,1,1,2439,1713,-726
38761,1,0,211,0,-211
38762,0,0,13,0,-13
38763,1,0,33,0,-33
38764,0,0,5,0,-5
38765,1,0,5,0,-5
38766,0,0,35,0,-35
38767,1,0,69,0,-69
38768,0,0,53,0,-53
38769,0,0,7,0,-7
38770,0,0,132,0,-132
38771,0,0,30,0,-30
38772,1,0,7,0,-7
38773,0,0,52,0,-52
38774,1,0,4,0,-4
38775,0,0,70,0,-70
38776,1,1,221,2217,1996
38777,0,0,84,0,-84
38778,1,0,117,0,-117
38779,1,1,428,1957,1529
38780,0,0,76,0,-76
38781,0,0,76,0,-76
38782,1,0,152,0,-152
38783,1,1,126,1336,1210
38784,0,0,77,0,-77
38785,1,0,3,0,-3
38786,1,1,493,1823,1330
38787,1,0,20,0,-20
38788,1,0,30,0,-30
38789,1,0,64,0,-64
38790,0,0,78,0,-78
38791,0,0,13,0,-13
38792,0,0,63,0,-63
38793,0,0,9,0,-9
38794,1,1,1044,1316,272
38795,1,1,67,1240,1173
38796,1,0,23,0,-23
38797,0,0,21,0,-21
38798,0,0,10,0,-10
38799,0,0,16,0,-16
38800,1,1,1407,1447,40
38801,0,0,27,0,-27
38802,0,0,0,0,0
38803,1,1,613,1556,943
38804,1,1,107,1489,1382
38805,1,0,31,0,-31
38806,1,0,21,0,-21
38807,1,1,147,1481,1334
38808,1,0,5,0,-5
38809,1,0,32,0,-32
38810,1,1,299,5562,5263
38811,1,1,93,1409,1316
38812,0,0,11,0,-11
38813,0,0,16,0,-16
38814,1,1,692,1347,655
38815,1,1,311,1216,905
38816,0,0,7,0,-7
38817,0,0,46,0,-46
38818,1,1,91,1918,1827
38819,1,1,342,1937,1595
38820,1,1,226,1719,1493
38821,1,1,188,3380,3192
38822,0,0,24,0,-24
38823,1,1,1538,1635,97
38824,1,0,27,0,-27
38825,1,1,125,1407,1282
38826,1,0,18,0,-18
38827,0,0,21,0,-21
38828,1,1,665,1560,895
38829,0,0,0,0,0
38830,1,0,129,0,-129
38831,1,0,2,0,-2
38832,0,0,12,0,-12
38833,0,0,17,0,-17
38834,1,0,21,0,-21
38835,1,1,259,1233,974
38836,1,0,9,0,-9
38837,1,0,5,0,-5
38838,0,0,0,0,0
38839,1,1,673,1229,556
38840,0,0,6,0,-6
38841,1,1,22,1338,1316
38842,1,0,10,0,-10
38843,1,1,533,1888,1355
38844,1,1,353,1200,847
38845,0,0,16,0,-16
38846,1,0,52,0,-52
38847,1,1,804,1274,470
38848,1,0,23,0,-23
38849,0,0,0,0,0
38850,0,0,23,0,-23
38851,1,0,6,0,-6
38852,0,0,58,0,-58
38853,1,1,89,1327,1238
38854,1,0,217,0,-217
38855,0,0,87,0,-87
38856,1,0,28,0,-28
38857,1,1,774,1447,673
38858,0,0,12,0,-12
38859,0,0,52,0,-52
38860,1,0,87,0,-87
38861,0,0,69,0,-69
38862,0,0,145,0,-145
38863,0,0,51,0,-51
38864,0,0,23,0,-23
38865,1,1,237,1242,1005
38866,0,0,20,0,-20
38867,1,1,606,1293,687
38868,1,0,16,0,-16
38869,0,0,38,0,-38
38870,0,0,99,0,-99
38871,1,1,1007,1253,246
38872,1,1,504,1471,967
38873,1,0,24,0,-24
38874,0,0,156,0,-156
38875,0,0,11,0,-11
38876,0,0,36,0,-36
38877,0,0,139,0,-139
38878,0,0,233,0,-233
38879,0,0,4,0,-4
38880,1,1,323,1377,1054
38881,0,0,78,0,-78
38882,0,0,71,0,-71
38883,0,0,39,0,-39
38884,1,0,41,0,-41
38885,1,0,3,0,-3
38886,0,0,27,0,-27
38887,0,0,164,0,-164
38888,1,1,504,1264,760
38889,1,0,34,0,-34
38890,1,0,37,0,-37
38891,1,1,142,2199,2057
38892,1,1,544,1220,676
38893,0,0,1,0,-1
38894,0,0,47,0,-47
38895,1,1,702,2026,1324
38896,1,1,258,1357,1099
38897,1,1,1350,2221,871
38898,1,1,204,1204,1000
38899,1,0,22,0,-22
38900,0,0,91,0,-91
38901,0,0,9,0,-9
38902,0,0,4,0,-4
38903,1,1,181,1384,1203
38904,0,0,111,0,-111
38905,0,0,19,0,-19
38906,1,0,60,0,-60
38907,1,1,189,1230,1041
38908,0,0,194,0,-194
38909,1,0,5,0,-5
38910,1,0,30,0,-30
38911,0,0,16,0,-16
38912,0,0,36,0,-36
38913,0,0,34,0,-34
38914,0,0,62,0,-62
38915,0,0,0,0,0
38916,0,0,55,0,-55
38917,1,1,116,2039,1923
38918,1,0,4,0,-4
38919,1,1,25,1330,1305
38920,1,0,17,0,-17
38921,0,0,4,0,-4
38922,1,1,362,2445,2083
38923,0,0,52,0,-52
38924,1,0,7,0,-7
38925,1,1,936,1434,498
38926,0,0,9,0,-9
38927,1,1,107,1367,1260
38928,0,0,84,0,-84
38929,1,1,263,1365,1102
38930,1,0,5,0,-5
38931,0,0,33,0,-33
38932,0,0,2,0,-2
38933,1,1,75,1345,1270
38934,1,0,38,0,-38
38935,0,0,45,0,-45
38936,0,0,37,0,-37
38937,0,0,21,0,-21
38938,1,0,34,0,-34
38939,0,0,31,0,-31
38940,1,0,0,0,0
38941,1,1,446,1207,761
38942,1,0,32,0,-32
38943,0,0,3,0,-3
38944,0,0,20,0,-20
38945,1,0,42,0,-42
38946,1,0,57,0,-57
38947,1,1,507,1939,1432
38948,0,0,67,0,-67
38949,1,1,90,1284,1194
38950,1,1,506,1342,836
38951,1,1,418,1338,920
38952,0,0,1,0,-1
38953,1,0,33,0,-33
38954,1,0,290,0,-290
38955,0,0,3,0,-3
38956,1,1,618,1784,1166
38957,0,0,38,0,-38
38958,0,0,12,0,-12
38959,0,0,132,0,-132
38960,0,0,148,0,-148
38961,1,0,21,0,-21
38962,0,0,15,0,-15
38963,1,1,1577,1900,323
38964,1,1,280,1308,1028
38965,1,1,629,2136,1507
38966,1,1,209,1505,1296
38967,1,1,238,1687,1449
38968,1,0,22,0,-22
38969,1,1,505,1494,989
38970,0,0,43,0,-43
38971,0,0,63,0,-63
38972,0,0,264,0,-264
38973,1,1,350,1386,1036
38974,1,0,43,0,-43
38975,1,0,31,0,-31
38976,0,0,191,0,-191
38977,0,0,26,0,-26
38978,1,1,368,1310,942
38979,1,1,189,1453,1264
38980,1,0,10,0,-10
38981,1,0,45,0,-45
38982,1,1,90,1395,1305
38983,0,0,12,0,-12
38984,0,0,37,0,-37
38985,0,0,29,0,-29
38986,1,1,266,2724,2458
38987,1,0,17,0,-17
38988,1,0,26,0,-26
38989,1,0,3,0,-3
38990,0,0,33,0,-33
38991,0,0,16,0,-16
38992,0,0,18,0,-18
38993,1,0,71,0,-71
38994,1,0,16,0,-16
38995,1,0,126,0,-126
38996,1,0,158,0,-158
38997,1,1,1704,1291,-413
38998,1,1,108,1480,1372
38999,1,0,44,0,-44
39000,0,0,92,0,-92
39001,1,0,5,0,-5
39002,0,0,136,0,-136
39003,0,0,45,0,-45
39004,1,0,2,0,-2
39005,0,0,2,0,-2
39006,0,0,68,0,-68
39007,0,0,1,0,-1
39008,1,0,16,0,-16
39009,1,1,145,1615,1470
39010,1,0,3,0,-3
39011,0,0,10,0,-10
39012,1,1,1836,1391,-445
39013,1,0,1,0,-1
39014,0,0,55,0,-55
39015,1,1,549,1710,1161
39016,0,0,36,0,-36
39017,1,0,24,0,-24
39018,0,0,9,0,-9
39019,1,1,60,2622,2562
39020,1,1,582,1607,1025
39021,0,0,0,0,0
39022,0,0,87,0,-87
39023,0,0,15,0,-15
39024,0,0,13,0,-13
39025,1,0,27,0,-27
39026,0,0,46,0,-46
39027,1,0,58,0,-58
39028,0,0,107,0,-107
39029,0,0,26,0,-26
39030,1,0,3,0,-3
39031,1,0,39,0,-39
39032,1,0,75,0,-75
39033,0,0,61,0,-61
39034,1,1,179,1210,1031
39035,0,0,40,0,-40
39036,0,0,49,0,-49
39037,0,0,65,0,-65
39038,0,0,34,0,-34
39039,0,0,81,0,-81
39040,0,0,101,0,-101
39041,1,0,132,0,-132
39042,0,0,12,0,-12
39043,1,0,4,0,-4
39044,0,0,36,0,-36
39045,1,1,235,1221,986
39046,1,1,481,1310,829
39047,0,0,55,0,-55
39048,1,1,564,1518,954
39049,0,0,110,0,-110
39050,0,0,63,0,-63
39051,1,0,4,0,-4
39052,1,1,1333,2975,1642
39053,1,1,750,2428,1678
39054,1,0,1,0,-1
39055,1,0,58,0,-58
39056,1,1,1425,1442,17
39057,0,0,109,0,-109
39058,1,0,28,0,-28
39059,0,0,68,0,-68
39060,0,0,62,0,-62
39061,1,0,112,0,-112
39062,0,0,16,0,-16
39063,1,1,471,1205,734
39064,1,1,146,1219,1073
39065,0,0,7,0,-7
39066,1,0,6,0,-6
39067,1,1,954,1388,434
39068,0,0,64,0,-64
39069,1,1,267,1534,1267
39070,1,0,12,0,-12
39071,1,1,512,1288,776
39072,0,0,18,0,-18
39073,1,1,254,1575,1321
39074,1,1,187,1700,1513
39075,1,1,1030,1302,272
39076,0,0,44,0,-44
39077,1,0,28,0,-28
39078,1,0,9,0,-9
39079,0,0,25,0,-25
39080,0,0,27,0,-27
39081,1,0,13,0,-13
39082,0,0,9,0,-9
39083,1,0,5,0,-5
39084,1,0,12,0,-12
39085,1,0,10,0,-10
39086,1,1,238,1667,1429
39087,1,1,331,1306,975
39088,1,1,393,1543,1150
39089,1,1,638,1315,677
39090,1,0,10,0,-10
39091,1,0,71,0,-71
39092,1,1,287,1409,1122
39093,0,0,3,0,-3
39094,1,0,44,0,-44
39095,1,0,2,0,-2
39096,1,0,5,0,-5
39097,1,1,390,1273,883
39098,1,1,1179,1233,54
39099,0,0,38,0,-38
39100,1,1,274,1368,1094
39101,1,1,452,1910,1458
39102,1,0,41,0,-41
39103,0,0,105,0,-105
39104,1,0,8,0,-8
39105,1,1,129,1690,1561
39106,1,1,28,1499,1471
39107,1,1,471,2130,1659
39108,1,1,337,1328,991
39109,1,0,28,0,-28
39110,0,0,39,0,-39
39111,0,0,70,0,-70
39112,1,1,1233,1328,95
39113,1,0,59,0,-59
39114,0,0,6,0,-6
39115,1,1,589,1381,792
39116,1,1,115,1257,1142
39117,1,0,14,0,-14
39118,1,1,813,1471,658
39119,1,1,135,1209,1074
39120,1,0,19,0,-19
39121,1,0,149,0,-149
39122,1,0,19,0,-19
39123,0,0,37,0,-37
39124,1,1,793,1295,502
39125,0,0,73,0,-73
39126,1,1,115,2283,2168
39127,1,1,744,1794,1050
39128,1,1,461,1236,775
39129,0,0,13,0,-13
39130,1,1,1638,1953,315
39131,1,0,57,0,-57
39132,0,0,51,0,-51
39133,0,0,65,0,-65
39134,0,0,0,0,0
39135,0,0,284,0,-284
39136,1,1,1222,2175,953
39137,0,0,9,0,-9
39138,1,0,33,0,-33
39139,1,1,52,1809,1757
39140,0,0,85,0,-85
39141,1,1,415,1271,856
39142,1,1,161,1256,1095
39143,0,0,62,0,-62
39144,0,0,25,0,-25
39145,1,0,27,0,-27
39146,0,0,51,0,-51
39147,0,0,30,0,-30
39148,0,0,37,0,-37
39149,1,0,67,0,-67
39150,1,1,218,1659,1441
39151,1,1,1496,4626,3130
39152,0,0,47,0,-47
39153,1,0,134,0,-134
39154,1,1,2371,1464,-907
39155,1,0,71,0,-71
39156,1,0,158,0,-158
39157,1,1,2796,1235,-1561
39158,1,0,12,0,-12
39159,1,1,323,1225,902
39160,1,1,709,1295,586
39161,0,0,43,0,-43
39162,1,0,10,0,-10
39163,1,1,1907,1592,-315
39164,1,0,8,0,-8
39165,0,0,2,0,-2
39166,1,1,830,1318,488
39167,0,0,13,0,-13
39168,1,0,95,0,-95
39169,1,1,256,1528,1272
39170,1,1,161,1658,1497
39171,0,0,50,0,-50
39172,1,1,1462,1374,-88
39173,1,1,1058,1666,608
39174,0,0,40,0,-40
39175,1,1,833,1777,944
39176,1,0,25,0,-25
39177,0,0,8,0,-8
39178,1,1,412,1343,931
39179,0,0,217,0,-217
39180,0,0,91,0,-91
39181,0,0,47,0,-47
39182,1,0,109,0,-109
39183,1,0,4,0,-4
39184,1,0,7,0,-7
39185,1,1,287,1337,1050
39186,1,1,883,1546,663
39187,1,0,62,0,-62
39188,1,1,1382,1253,-129
39189,0,0,5,0,-5
39190,1,1,113,1754,1641
39191,0,0,19,0,-19
39192,1,1,612,1576,964
39193,1,1,442,1647,1205
39194,1,1,592,1438,846
39195,1,0,75,0,-75
39196,1,0,17,0,-17
39197,1,0,42,0,-42
39198,1,1,909,1785,876
39199,1,1,311,1294,983
39200,1,1,392,2356,1964
39201,0,0,132,0,-132
39202,1,0,24,0,-24
39203,1,1,1046,1230,184
39204,1,0,39,0,-39
39205,1,0,15,0,-15
39206,0,0,47,0,-47
39207,0,0,15,0,-15
39208,1,1,154,1477,1323
39209,0,0,36,0,-36
39210,0,0,2,0,-2
39211,0,0,9,0,-9
39212,0,0,14,0,-14
39213,0,0,13,0,-13
39214,0,0,9,0,-9
39215,0,0,3,0,-3
39216,1,1,371,1417,1046
39217,1,1,794,1436,642
39218,0,0,5,0,-5
39219,1,0,17,0,-17
39220,0,0,35,0,-35
39221,0,0,25,0,-25
39222,1,0,134,0,-134
39223,0,0,0,0,0
39224,0,0,13,0,-13
39225,1,1,217,1406,1189
39226,1,1,75,16554,16479
39227,1,0,86,0,-86
39228,0,0,29,0,-29
39229,0,0,129,0,-129
39230,0,0,71,0,-71
39231,1,1,134,1868,1734
39232,1,1,147,1203,1056
39233,1,0,4,0,-4
39234,0,0,79,0,-79
39235,0,0,130,0,-130
39236,0,0,129,0,-129
39237,0,0,11,0,-11
39238,0,0,151,0,-151
39239,0,0,7,0,-7
39240,1,1,423,1206,783
39241,1,1,411,1453,1042
39242,0,0,72,0,-72
39243,1,0,6,0,-6
39244,1,0,50,0,-50
39245,1,1,278,1560,1282
39246,0,0,77,0,-77
39247,0,0,18,0,-18
39248,1,0,89,0,-89
39249,1,0,2,0,-2
39250,1,0,12,0,-12
39251,0,0,115,0,-115
39252,1,0,20,0,-20
39253,1,0,45,0,-45
39254,1,0,20,0,-20
39255,1,0,31,0,-31
39256,0,0,99,0,-99
39257,1,0,31,0,-31
39258,1,1,74,1246,1172
39259,0,0,19,0,-19
39260,1,1,308,1555,1247
39261,1,0,38,0,-38
39262,0,0,22,0,-22
39263,1,0,13,0,-13
39264,0,0,56,0,-56
39265,0,0,39,0,-39
39266,1,1,1531,1213,-318
39267,1,1,1079,1307,228
39268,1,1,232,2438,2206
39269,1,1,149,2829,2680
39270,1,0,109,0,-109
39271,1,0,9,0,-9
39272,0,0,76,0,-76
39273,0,0,51,0,-51
39274,1,1,1082,1366,284
39275,1,1,374,1446,1072
39276,1,0,27,0,-27
39277,1,0,36,0,-36
39278,0,0,102,0,-102
39279,0,0,36,0,-36
39280,0,0,23,0,-23
39281,0,0,21,0,-21
39282,1,0,5,0,-5
39283,1,1,249,1470,1221
39284,1,0,6,0,-6
39285,0,0,36,0,-36
39286,0,0,0,0,0
39287,1,1,327,2851,2524
39288,0,0,12,0,-12
39289,1,0,38,0,-38
39290,1,0,39,0,-39
39291,1,0,43,0,-43
39292,1,0,9,0,-9
39293,1,1,190,1291,1101
39294,1,1,38,1744,1706
39295,0,0,73,0,-73
39296,1,1,113,1360,1247
39297,0,0,35,0,-35
39298,0,0,34,0,-34
39299,1,1,2987,1414,-1573
39300,1,1,200,1618,1418
39301,1,1,432,1211,779
39302,0,0,20,0,-20
39303,1,1,372,1223,851
39304,0,0,9,0,-9
39305,0,0,25,0,-25
39306,1,0,24,0,-24
39307,1,1,1193,1217,24
39308,1,0,11,0,-11
39309,1,1,130,1220,1090
39310,1,0,37,0,-37
39311,1,0,44,0,-44
39312,1,0,124,0,-124
39313,1,1,1192,1536,344
39314,0,0,53,0,-53
39315,0,0,13,0,-13
39316,1,1,379,1569,1190
39317,1,1,413,1320,907
39318,1,0,56,0,-56
39319,1,1,539,1274,735
39320,1,1,186,1214,1028
39321,1,1,112,2744,2632
39322,1,1,261,1256,995
39323,0,0,27,0,-27
39324,1,0,15,0,-15
39325,0,0,8,0,-8
39326,1,0,165,0,-165
39327,1,1,906,1361,455
39328,0,0,9,0,-9
39329,1,0,11,0,-11
39330,0,0,17,0,-17
39331,1,1,1003,1963,960
39332,0,0,0,0,0
39333,1,1,1334,1299,-35
39334,0,0,66,0,-66
39335,0,0,56,0,-56
39336,1,0,70,0,-70
39337,0,0,19,0,-19
39338,1,0,89,0,-89
39339,0,0,21,0,-21
39340,0,0,21,0,-21
39341,0,0,78,0,-78
39342,1,1,348,1654,1306
39343,0,0,21,0,-21
39344,0,0,42,0,-42
39345,0,0,157,0,-157
39346,1,1,137,1214,1077
39347,0,0,2,0,-2
39348,1,1,119,1755,1636
39349,1,1,789,1420,631
39350,0,0,41,0,-41
39351,1,0,24,0,-24
39352,1,0,9,0,-9
39353,0,0,27,0,-27
39354,0,0,11,0,-11
39355,0,0,81,0,-81
39356,0,0,164,0,-164
39357,0,0,86,0,-86
39358,0,0,13,0,-13
39359,1,0,133,0,-133
39360,1,1,153,1227,1074
39361,0,0,64,0,-64
39362,0,0,31,0,-31
39363,1,0,86,0,-86
39364,0,0,31,0,-31
39365,1,0,97,0,-97
39366,1,1,339,1225,886
39367,0,0,25,0,-25
39368,0,0,4,0,-4
39369,0,0,92,0,-92
39370,0,0,12,0,-12
39371,1,0,15,0,-15
39372,1,0,48,0,-48
39373,1,0,106,0,-106
39374,1,0,23,0,-23
39375,1,1,111,1524,1413
39376,1,0,60,0,-60
39377,1,1,114,1227,1113
39378,1,0,29,0,-29
39379,1,1,761,1591,830
39380,1,1,956,1641,685
39381,0,0,13,0,-13
39382,1,1,482,1658,1176
39383,1,1,760,1578,818
39384,1,1,1150,1474,324
39385,1,1,119,1698,1579
39386,1,0,46,0,-46
39387,1,1,158,1201,1043
39388,1,0,5,0,-5
39389,1,1,1886,1299,-587
39390,0,0,148,0,-148
39391,0,0,6,0,-6
39392,1,0,71,0,-71
39393,1,0,34,0,-34
39394,1,0,0,0,0
39395,1,0,26,0,-26
39396,1,0,121,0,-121
39397,1,1,141,1496,1355
39398,0,0,66,0,-66
39399,1,1,776,1989,1213
39400,1,0,11,0,-11
39401,0,0,21,0,-21
39402,1,0,57,0,-57
39403,1,0,214,0,-214
39404,1,1,767,1494,727
39405,1,0,22,0,-22
39406,0,0,82,0,-82
39407,0,0,251,0,-251
39408,0,0,27,0,-27
39409,0,0,17,0,-17
39410,0,0,55,0,-55
39411,1,1,42,1564,1522
39412,0,0,17,0,-17
39413,1,1,2190,1224,-966
39414,0,0,1,0,-1
39415,1,0,46,0,-46
39416,0,0,27,0,-27
39417,0,0,45,0,-45
39418,1,1,161,1225,1064
39419,0,0,30,0,-30
39420,1,1,14,1204,1190
39421,1,0,6,0,-6
39422,0,0,15,0,-15
39423,0,0,43,0,-43
39424,0,0,98,0,-98
39425,0,0,174,0,-174
39426,0,0,95,0,-95
39427,0,0,16,0,-16
39428,1,1,166,1608,1442
39429,0,0,29,0,-29
39430,1,0,60,0,-60
39431,0,0,249,0,-249
39432,1,1,458,1507,1049
39433,1,0,32,0,-32
39434,0,0,39,0,-39
39435,1,0,6,0,-6
39436,1,1,802,1254,452
39437,0,0,63,0,-63
39438,1,0,1,0,-1
39439,1,0,7,0,-7
39440,0,0,4,0,-4
39441,1,1,206,1204,998
39442,1,1,176,1558,1382
39443,0,0,25,0,-25
39444,0,0,27,0,-27
39445,1,0,117,0,-117
39446,1,1,1715,1305,-410
39447,1,0,89,0,-89
39448,0,0,71,0,-71
39449,0,0,54,0,-54
39450,1,0,55,0,-55
39451,1,0,4,0,-4
39452,0,0,39,0,-39
39453,0,0,52,0,-52
39454,0,0,14,0,-14
39455,0,0,1,0,-1
39456,1,0,3,0,-3
39457,1,1,304,1247,943
39458,1,1,37,1308,1271
39459,1,0,13,0,-13
39460,1,1,848,1567,719
39461,1,0,126,0,-126
39462,1,1,950,1680,730
39463,1,1,308,1277,969
39464,0,0,95,0,-95
39465,1,0,37,0,-37
39466,1,0,3,0,-3
39467,1,0,45,0,-45
39468,0,0,68,0,-68
39469,1,1,939,1222,283
39470,0,0,12,0,-12
39471,0,0,90,0,-90
39472,1,1,616,1829,1213
39473,1,1,566,1591,1025
39474,1,1,407,1344,937
39475,0,0,46,0,-46
39476,1,1,201,1389,1188
39477,1,0,72,0,-72
39478,0,0,109,0,-109
39479,1,0,97,0,-97
39480,0,0,2,0,-2
39481,0,0,8,0,-8
39482,0,0,4,0,-4
39483,1,1,627,1413,786
39484,1,0,65,0,-65
39485,1,1,538,1458,920
39486,0,0,0,0,0
39487,0,0,6,0,-6
39488,1,0,6,0,-6
39489,0,0,80,0,-80
39490,0,0,28,0,-28
39491,1,0,10,0,-10
39492,1,0,6,0,-6
39493,0,0,5,0,-5
39494,0,0,74,0,-74
39495,1,0,58,0,-58
39496,1,1,176,1218,1042
39497,1,0,0,0,0
39498,1,0,42,0,-42
39499,0,0,9,0,-9
39500,0,0,77,0,-77
39501,1,1,216,1214,998
39502,1,0,4,0,-4
39503,1,1,1151,2146,995
39504,0,0,81,0,-81
39505,1,1,911,1781,870
39506,1,0,40,0,-40
39507,0,0,40,0,-40
39508,0,0,62,0,-62
39509,1,1,198,1383,1185
39510,1,0,24,0,-24
39511,1,0,28,0,-28
39512,0,0,36,0,-36
39513,0,0,46,0,-46
39514,1,1,500,1827,1327
39515,1,0,77,0,-77
39516,0,0,4,0,-4
39517,0,0,27,0,-27
39518,0,0,259,0,-259
39519,0,0,16,0,-16
39520,1,1,257,1610,1353
39521,0,0,0,0,0
39522,1,1,993,1660,667
39523,0,0,13,0,-13
39524,0,0,45,0,-45
39525,1,0,40,0,-40
39526,1,0,26,0,-26
39527,0,0,47,0,-47
39528,0,0,251,0,-251
39529,0,0,31,0,-31
39530,0,0,64,0,-64
39531,1,1,1772,1538,-234
39532,1,0,5,0,-5
39533,1,1,205,1577,1372
39534,0,0,6,0,-6
39535,1,0,58,0,-58
39536,1,0,204,0,-204
39537,1,0,187,0,-187
39538,1,1,107,1256,1149
39539,0,0,41,0,-41
39540,0,0,204,0,-204
39541,0,0,207,0,-207
39542,0,0,99,0,-99
39543,1,1,247,1300,1053
39544,1,1,553,1447,894
39545,0,0,86,0,-86
39546,1,0,218,0,-218
39547,1,1,64,2152,2088
39548,1,0,53,0,-53
39549,1,0,9,0,-9
39550,0,0,32,0,-32
39551,0,0,43,0,-43
39552,1,0,126,0,-126
39553,1,1,362,2178,1816
39554,1,1,534,1439,905
39555,1,1,807,1425,618
39556,1,0,100,0,-100
39557,0,0,28,0,-28
39558,0,0,117,0,-117
39559,1,1,1979,1748,-231
39560,1,0,1,0,-1
39561,1,1,480,1382,902
39562,0,0,21,0,-21
39563,1,0,48,0,-48
39564,1,0,13,0,-13
39565,1,1,257,3339,3082
39566,0,0,29,0,-29
39567,0,0,46,0,-46
39568,0,0,8,0,-8
39569,1,0,42,0,-42
39570,1,0,2,0,-2
39571,0,0,29,0,-29
39572,1,1,90,1715,1625
39573,0,0,4,0,-4
39574,1,0,90,0,-90
39575,0,0,115,0,-115
39576,1,1,1530,1229,-301
39577,0,0,76,0,-76
39578,0,0,7,0,-7
39579,0,0,6,0,-6
39580,1,1,1344,1508,164
39581,1,0,24,0,-24
39582,1,0,180,0,-180
39583,0,0,17,0,-17
39584,0,0,82,0,-82
39585,1,0,41,0,-41
39586,0,0,98,0,-98
39587,1,0,24,0,-24
39588,1,1,325,1302,977
39589,1,0,3,0,-3
39590,1,0,13,0,-13
39591,1,1,2136,2801,665
39592,0,0,75,0,-75
39593,1,0,7,0,-7
39594,1,1,171,1361,1190
39595,0,0,40,0,-40
39596,1,0,47,0,-47
39597,0,0,12,0,-12
39598,0,0,7,0,-7
39599,1,0,34,0,-34
39600,1,0,175,0,-175
39601,1,0,107,0,-107
39602,0,0,11,0,-11
39603,1,1,563,1813,1250
39604,0,0,14,0,-14
39605,1,1,814,1394,580
39606,0,0,79,0,-79
39607,1,1,462,1744,1282
39608,0,0,21,0,-21
39609,0,0,31,0,-31
39610,1,1,347,1279,932
39611,1,0,53,0,-53
39612,0,0,27,0,-27
39613,0,0,139,0,-139
39614,0,0,113,0,-113
39615,0,0,35,0,-35
39616,0,0,34,0,-34
39617,1,1,50,1208,1158
39618,1,0,20,0,-20
39619,1,0,58,0,-58
39620,1,1,433,2537,2104
39621,0,0,1,0,-1
39622,1,1,583,1892,1309
39623,1,0,60,0,-60
39624,0,0,12,0,-12
39625,1,0,85,0,-85
39626,1,1,81,1411,1330
39627,0,0,10,0,-10
39628,1,1,252,1236,984
39629,0,0,87,0,-87
39630,1,1,286,1440,1154
39631,1,1,1508,1230,-278
39632,0,0,91,0,-91
39633,0,0,114,0,-114
39634,0,0,17,0,-17
39635,0,0,10,0,-10
39636,1,1,366,1264,898
39637,1,1,1680,1841,161
39638,1,1,959,1222,263
39639,0,0,42,0,-42
39640,0,0,115,0,-115
39641,1,1,404,1652,1248
39642,1,0,85,0,-85
39643,1,1,539,3746,3207
39644,1,0,35,0,-35
39645,0,0,1,0,-1
39646,0,0,17,0,-17
39647,0,0,70,0,-70
39648,0,0,33,0,-33
39649,1,0,29,0,-29
39650,0,0,52,0,-52
39651,0,0,7,0,-7
39652,0,0,16,0,-16
39653,1,0,43,0,-43
39654,1,1,383,1781,1398
39655,1,0,15,0,-15
39656,0,0,84,0,-84
39657,0,0,90,0,-90
39658,1,0,15,0,-15
39659,1,0,4,0,-4
39660,1,0,1,0,-1
39661,1,1,226,2117,1891
39662,1,1,188,1591,1403
39663,1,1,835,2814,1979
39664,1,0,41,0,-41
39665,1,1,1438,1251,-187
39666,1,1,1695,1647,-48
39667,1,1,695,1716,1021
39668,0,0,42,0,-42
39669,1,0,304,0,-304
39670,0,0,22,0,-22
39671,1,1,30,2325,2295
39672,0,0,68,0,-68
39673,0,0,90,0,-90
39674,1,1,508,1463,955
39675,0,0,56,0,-56
39676,0,0,93,0,-93
39677,1,1,73,1210,1137
39678,0,0,89,0,-89
39679,1,0,51,0,-51
39680,1,1,1218,1688,470
39681,0,0,13,0,-13
39682,0,0,40,0,-40
39683,1,1,167,1210,1043
39684,0,0,13,0,-13
39685,0,0,36,0,-36
39686,1,0,69,0,-69
39687,1,0,69,0,-69
39688,1,0,122,0,-122
39689,1,0,13,0,-13
39690,0,0,32,0,-32
39691,0,0,22,0,-22
39692,0,0,49,0,-49
39693,0,0,19,0,-19
39694,0,0,1,0,-1
39695,0,0,4,0,-4
39696,1,0,5,0,-5
39697,0,0,45,0,-45
39698,1,0,1,0,-1
39699,1,0,49,0,-49
39700,0,0,57,0,-57
39701,1,1,131,1414,1283
39702,0,0,12,0,-12
39703,0,0,46,0,-46
39704,1,1,230,1232,1002
39705,0,0,68,0,-68
39706,1,0,19,0,-19
39707,1,1,289,1546,1257
39708,0,0,24,0,-24
39709,0,0,19,0,-19
39710,0,0,43,0,-43
39711,1,0,25,0,-25
39712,1,0,17,0,-17
39713,1,0,25,0,-25
39714,0,0,15,0,-15
39715,0,0,22,0,-22
39716,0,0,47,0,-47
39717,0,0,103,0,-103
39718,1,1,575,1445,870
39719,1,1,1036,2065,1029
39720,1,1,820,1283,463
39721,0,0,111,0,-111
39722,1,1,233,1941,1708
39723,1,0,64,0,-64
39724,1,1,368,4087,3719
39725,0,0,83,0,-83
39726,1,0,22,0,-22
39727,1,0,46,0,-46
39728,1,1,775,1812,1037
39729,0,0,66,0,-66
39730,0,0,6,0,-6
39731,1,1,573,1810,1237
39732,0,0,2,0,-2
39733,1,1,422,1406,984
39734,1,0,6,0,-6
39735,1,0,34,0,-34
39736,1,1,433,1553,1120
39737,1,1,104,1613,1509
39738,1,1,625,1223,598
39739,1,1,585,1588,1003
39740,0,0,20,0,-20
39741,1,0,11,0,-11
39742,1,0,131,0,-131
39743,0,0,17,0,-17
39744,0,0,62,0,-62
39745,1,1,501,1838,1337
39746,0,0,69,0,-69
39747,1,1,339,1318,979
39748,0,0,56,0,-56
39749,1,1,1141,1514,373
39750,1,1,130,1557,1427
39751,1,1,101,1642,1541
39752,1,1,1173,2443,1270
39753,1,0,54,0,-54
39754,0,0,175,0,-175
39755,1,0,30,0,-30
39756,1,1,112,1245,1133
39757,0,0,6,0,-6
39758,1,1,27,1203,1176
39759,1,0,163,0,-163
39760,0,0,178,0,-178
39761,1,1,93,1209,1116
39762,0,0,28,0,-28
39763,0,0,20,0,-20
39764,1,0,108,0,-108
39765,1,0,46,0,-46
39766,1,1,1178,1511,333
39767,0,0,2,0,-2
39768,0,0,184,0,-184
39769,1,0,96,0,-96
39770,0,0,5,0,-5
39771,0,0,13,0,-13
39772,1,0,4,0,-4
39773,1,1,1383,1319,-64
39774,1,1,318,1294,976
39775,1,0,46,0,-46
39776,0,0,122,0,-122
39777,0,0,293,0,-293
39778,1,0,62,0,-62
39779,1,0,5,0,-5
39780,0,0,162,0,-162
39781,1,0,99,0,-99
39782,1,1,268,1312,1044
39783,0,0,132,0,-132
39784,1,1,1322,1239,-83
39785,1,0,22,0,-22
39786,1,1,70,1444,1374
39787,1,1,458,1211,753
39788,0,0,206,0,-206
39789,1,1,351,1578,1227
39790,1,0,13,0,-13
39791,1,1,66,1455,1389
39792,1,1,1720,3247,1527
39793,1,0,111,0,-111
39794,1,1,101,1805,1704
39795,1,1,1005,1274,269
39796,0,0,4,0,-4
39797,1,1,868,2802,1934
39798,1,1,144,1584,1440
39799,0,0,24,0,-24
39800,1,0,43,0,-43
39801,0,0,52,0,-52
39802,1,0,41,0,-41
39803,0,0,5,0,-5
39804,0,0,50,0,-50
39805,0,0,6,0,-6
39806,1,1,246,1411,1165
39807,1,0,16,0,-16
39808,1,1,431,1638,1207
39809,1,1,1034,1750,716
39810,0,0,32,0,-32
39811,1,1,1195,1602,407
39812,0,0,52,0,-52
39813,0,0,32,0,-32
39814,1,1,506,1267,761
39815,1,1,632,1416,784
39816,1,1,191,1213,1022
39817,0,0,63,0,-63
39818,1,1,334,1575,1241
39819,0,0,6,0,-6
39820,0,0,11,0,-11
39821,1,0,6,0,-6
39822,1,1,116,2224,2108
39823,1,0,0,0,0
39824,1,1,309,1214,905
39825,1,1,165,1631,1466
39826,1,1,170,1311,1141
39827,1,0,134,0,-134
39828,0,0,201,0,-201
39829,1,1,73,1291,1218
39830,1,1,483,2097,1614
39831,1,0,100,0,-100
39832,0,0,58,0,-58
39833,1,1,50,1267,1217
39834,1,0,47,0,-47
39835,1,1,1942,1501,-441
39836,0,0,25,0,-25
39837,0,0,83,0,-83
39838,1,1,586,2948,2362
39839,0,0,57,0,-57
39840,0,0,33,0,-33
39841,1,0,26,0,-26
39842,0,0,42,0,-42
39843,0,0,107,0,-107
39844,1,0,133,0,-133
39845,0,0,30,0,-30
39846,1,0,37,0,-37
39847,0,0,190,0,-190
39848,1,0,72,0,-72
39849,1,1,637,1250,613
39850,0,0,3,0,-3
39851,1,0,31,0,-31
39852,1,1,761,3512,2751
39853,1,1,150,1274,1124
39854,1,0,65,0,-65
39855,1,0,7,0,-7
39856,1,1,296,1487,1191
39857,0,0,4,0,-4
39858,1,0,48,0,-48
39859,0,0,9,0,-9
39860,0,0,18,0,-18
39861,1,1,417,1380,963
39862,1,0,9,0,-9
39863,1,0,13,0,-13
39864,1,0,46,0,-46
39865,1,0,26,0,-26
39866,0,0,81,0,-81
39867,1,1,220,1243,1023
39868,0,0,103,0,-103
39869,0,0,94,0,-94
39870,0,0,97,0,-97
39871,1,0,7,0,-7
39872,0,0,4,0,-4
39873,1,0,16,0,-16
39874,1,0,5,0,-5
39875,0,0,33,0,-33
39876,0,0,10,0,-10
39877,1,1,316,1376,1060
39878,1,0,151,0,-151
39879,1,0,52,0,-52
39880,1,0,18,0,-18
39881,0,0,23,0,-23
39882,0,0,147,0,-147
39883,1,0,35,0,-35
39884,1,1,481,1289,808
39885,0,0,85,0,-85
39886,0,0,31,0,-31
39887,1,0,37,0,-37
39888,1,0,11,0,-11
39889,1,0,78,0,-78
39890,0,0,213,0,-213
39891,1,1,151,1206,1055
39892,1,1,205,1443,1238
39893,1,1,544,1310,766
39894,1,0,38,0,-38
39895,1,1,729,1262,533
39896,1,0,27,0,-27
39897,1,0,20,0,-20
39898,0,0,126,0,-126
39899,1,1,217,2937,2720
39900,1,0,104,0,-104
39901,1,1,1994,1733,-261
39902,0,0,31,0,-31
39903,0,0,3,0,-3
39904,1,1,537,1231,694
39905,0,0,338,0,-338
39906,0,0,82,0,-82
39907,1,1,97,1360,1263
39908,1,1,607,1233,626
39909,1,0,58,0,-58
39910,1,1,379,1294,915
39911,1,0,8,0,-8
39912,1,0,1,0,-1
39913,1,1,115,1239,1124
39914,1,1,520,1510,990
39915,0,0,23,0,-23
39916,1,1,697,1244,547
39917,1,1,260,1798,1538
39918,1,0,83,0,-83
39919,1,1,105,1563,1458
39920,1,1,10,1458,1448
39921,1,0,26,0,-26
39922,1,1,298,1292,994
39923,0,0,7,0,-7
39924,0,0,31,0,-31
39925,1,0,4,0,-4
39926,0,0,35,0,-35
39927,1,0,69,0,-69
39928,0,0,21,0,-21
39929,1,0,47,0,-47
39930,0,0,59,0,-59
39931,0,0,208,0,-208
39932,1,0,109,0,-109
39933,1,0,2,0,-2
39934,1,0,43,0,-43
39935,1,0,17,0,-17
39936,0,0,9,0,-9
39937,1,0,19,0,-19
39938,0,0,14,0,-14
39939,1,1,627,3239,2612
39940,0,0,17,0,-17
39941,1,1,1391,1681,290
39942,0,0,41,0,-41
39943,1,1,483,1497,1014
39944,1,1,436,1304,868
39945,1,1,1580,1275,-305
39946,1,0,0,0,0
39947,0,0,85,0,-85
39948,0,0,22,0,-22
39949,0,0,1,0,-1
39950,1,0,175,0,-175
39951,1,0,47,0,-47
39952,1,1,713,1623,910
39953,0,0,16,0,-16
39954,1,0,206,0,-206
39955,1,0,4,0,-4
39956,1,1,37,1304,1267
39957,1,1,56,1272,1216
39958,1,0,46,0,-46
39959,0,0,69,0,-69
39960,1,1,53,1235,1182
39961,1,0,19,0,-19
39962,1,0,1,0,-1
39963,0,0,92,0,-92
39964,1,0,55,0,-55
39965,0,0,141,0,-141
39966,0,0,86,0,-86
39967,0,0,43,0,-43
39968,0,0,25,0,-25
39969,1,0,112,0,-112
39970,0,0,84,0,-84
39971,1,1,856,1381,525
39972,1,0,13,0,-13
39973,1,0,39,0,-39
39974,0,0,30,0,-30
39975,1,1,128,1236,1108
39976,0,0,76,0,-76
39977,1,0,124,0,-124
39978,1,1,226,1396,1170
39979,1,0,50,0,-50
39980,1,0,209,0,-209
39981,1,1,338,1627,1289
39982,1,1,729,1815,1086
39983,1,0,167,0,-167
39984,1,1,120,3544,3424
39985,0,0,55,0,-55
39986,0,0,80,0,-80
39987,0,0,36,0,-36
39988,1,0,117,0,-117
39989,1,1,219,1258,1039
39990,1,1,176,1436,1260
39991,0,0,133,0,-133
39992,0,0,118,0,-118
39993,0,0,116,0,-116
39994,0,0,28,0,-28
39995,1,0,0,0,0
39996,0,0,120,0,-120
39997,1,1,339,1453,1114
39998,1,1,488,1653,1165
39999,0,0,47,0,-47
40000,0,0,101,0,-101
40001,1,1,17,1285,1268
40002,1,1,132,1205,1073
40003,0,0,55,0,-55
40004,0,0,98,0,-98
40005,1,0,26,0,-26
40006,1,1,683,1282,599
40007,0,0,100,0,-100
40008,1,0,3,0,-3
40009,1,1,241,1207,966
40010,0,0,135,0,-135
40011,1,0,53,0,-53
40012,1,0,117,0,-117
40013,1,0,17,0,-17
40014,1,1,475,1214,739
40015,0,0,119,0,-119
40016,0,0,1,0,-1
40017,1,0,63,0,-63
40018,0,0,29,0,-29
40019,1,1,895,1230,335
40020,0,0,51,0,-51
40021,1,1,324,2601,2277
40022,1,1,296,1641,1345
40023,0,0,43,0,-43
40024,0,0,24,0,-24
40025,1,1,144,1433,1289
40026,0,0,143,0,-143
40027,0,0,16,0,-16
40028,1,1,151,1275,1124
40029,1,0,2,0,-2
40030,0,0,25,0,-25
40031,0,0,7,0,-7
40032,0,0,19,0,-19
40033,1,1,90,1633,1543
40034,1,1,1408,1307,-101
40035,0,0,211,0,-211
40036,1,1,335,1685,1350
40037,1,1,344,1471,1127
40038,0,0,60,0,-60
40039,1,0,76,0,-76
40040,1,0,80,0,-80
40041,0,0,74,0,-74
40042,0,0,1,0,-1
40043,1,0,30,0,-30
40044,1,0,23,0,-23
40045,0,0,35,0,-35
40046,1,1,942,1224,282
40047,0,0,56,0,-56
40048,0,0,59,0,-59
40049,1,0,32,0,-32
40050,1,0,26,0,-26
40051,0,0,51,0,-51
40052,1,0,1,0,-1
40053,0,0,32,0,-32
40054,0,0,41,0,-41
40055,1,0,110,0,-110
40056,1,1,1092,1730,638
40057,1,1,1184,1376,192
40058,0,0,2,0,-2
40059,1,0,159,0,-159
40060,0,0,2,0,-2
40061,1,0,17,0,-17
40062,0,0,25,0,-25
40063,0,0,23,0,-23
40064,1,1,271,1352,1081
40065,1,0,79,0,-79
40066,0,0,9,0,-9
40067,1,0,43,0,-43
40068,0,0,8,0,-8
40069,1,0,45,0,-45
40070,1,0,20,0,-20
40071,1,0,88,0,-88
40072,1,1,281,1414,1133
40073,0,0,7,0,-7
40074,1,1,610,1525,915
40075,1,0,47,0,-47
40076,1,1,1388,1417,29
40077,0,0,4,0,-4
40078,1,1,158,2060,1902
40079,0,0,37,0,-37
40080,0,0,14,0,-14
40081,0,0,82,0,-82
40082,1,0,14,0,-14
40083,0,0,67,0,-67
40084,0,0,208,0,-208
40085,0,0,3,0,-3
40086,1,0,124,0,-124
40087,1,1,1090,1513,423
40088,0,0,79,0,-79
40089,1,0,78,0,-78
40090,1,1,172,1272,1100
40091,0,0,9,0,-9
40092,1,1,555,1333,778
40093,1,0,8,0,-8
40094,0,0,21,0,-21
40095,0,0,122,0,-122
40096,1,1,835,1418,583
40097,0,0,124,0,-124
40098,0,0,34,0,-34
40099,0,0,7,0,-7
40100,0,0,22,0,-22
40101,1,1,404,1960,1556
40102,1,1,61,2460,2399
40103,0,0,24,0,-24
40104,1,0,8,0,-8
40105,0,0,31,0,-31
40106,1,0,68,0,-68
40107,1,0,38,0,-38
40108,1,0,23,0,-23
40109,1,1,322,2111,1789
40110,1,0,30,0,-30
40111,1,0,16,0,-16
40112,0,0,64,0,-64
40113,0,0,47,0,-47
40114,0,0,37,0,-37
40115,1,1,500,1573,1073
40116,0,0,55,0,-55
40117,1,1,693,1359,666
40118,0,0,6,0,-6
40119,0,0,51,0,-51
40120,1,0,154,0,-154
40121,0,0,2,0,-2
40122,1,0,39,0,-39
40123,1,1,249,1909,1660
40124,1,1,1414,1360,-54
40125,1,0,121,0,-121
40126,1,0,53,0,-53
40127,1,0,4,0,-4
40128,1,1,34,2031,1997
40129,1,1,274,1890,1616
40130,1,0,26,0,-26
40131,1,0,25,0,-25
40132,1,0,18,0,-18
40133,1,0,25,0,-25
40134,1,1,812,1726,914
40135,0,0,69,0,-69
40136,0,0,84,0,-84
40137,0,0,71,0,-71
40138,1,0,10,0,-10
40139,0,0,43,0,-43
40140,1,0,58,0,-58
40141,1,0,23,0,-23
40142,1,1,82,1245,1163
40143,1,0,37,0,-37
40144,1,0,127,0,-127
40145,1,1,806,1374,568
40146,0,0,137,0,-137
40147,1,1,1503,1421,-82
40148,1,1,100,1351,1251
40149,1,1,214,2232,2018
40150,0,0,74,0,-74
40151,0,0,43,0,-43
40152,1,0,1,0,-1
40153,1,0,1,0,-1
40154,1,1,1044,1226,182
40155,0,0,39,0,-39
40156,1,0,14,0,-14
40157,0,0,22,0,-22
40158,1,1,838,1316,478
40159,0,0,82,0,-82
40160,1,1,516,1676,1160
40161,1,0,42,0,-42
40162,0,0,38,0,-38
40163,1,1,248,1446,1198
40164,1,0,125,0,-125
40165,0,0,146,0,-146
40166,1,1,158,2214,2056
40167,1,1,512,1343,831
40168,0,0,43,0,-43
40169,1,1,1136,1465,329
40170,0,0,12,0,-12
40171,1,0,93,0,-93
40172,1,1,130,1582,1452
40173,0,0,17,0,-17
40174,1,1,508,1248,740
40175,1,1,347,1620,1273
40176,0,0,40,0,-40
40177,1,0,43,0,-43
40178,0,0,3,0,-3
40179,1,0,32,0,-32
40180,1,1,121,1652,1531
40181,0,0,140,0,-140
40182,0,0,2,0,-2
40183,1,1,2064,1229,-835
40184,0,0,0,0,0
40185,1,0,34,0,-34
40186,1,1,263,1404,1141
40187,1,1,210,3345,3135
40188,1,0,73,0,-73
40189,1,0,148,0,-148
40190,0,0,135,0,-135
40191,0,0,22,0,-22
40192,1,0,63,0,-63
40193,1,0,27,0,-27
40194,0,0,17,0,-17
40195,0,0,6,0,-6
40196,1,1,476,1423,947
40197,1,1,766,1209,443
40198,1,1,1376,1298,-78
40199,0,0,3,0,-3
40200,0,0,23,0,-23
40201,0,0,4,0,-4
40202,1,1,95,1443,1348
40203,0,0,7,0,-7
40204,0,0,25,0,-25
40205,0,0,82,0,-82
40206,0,0,48,0,-48
40207,0,0,50,0,-50
40208,0,0,99,0,-99
40209,1,0,11,0,-11
40210,0,0,29,0,-29
40211,0,0,5,0,-5
40212,1,1,91,1314,1223
40213,1,1,905,1631,726
40214,1,0,1,0,-1
40215,1,0,13,0,-13
40216,0,0,161,0,-161
40217,1,1,431,1263,832
40218,0,0,96,0,-96
40219,1,0,58,0,-58
40220,1,1,1068,1270,202
40221,1,1,11,2192,2181
40222,0,0,20,0,-20
40223,1,1,3175,2591,-584
40224,1,1,1307,1358,51
40225,0,0,73,0,-73
40226,0,0,6,0,-6
40227,1,0,50,0,-50
40228,0,0,10,0,-10
40229,0,0,93,0,-93
40230,1,0,22,0,-22
40231,1,1,10,1804,1794
40232,1,0,191,0,-191
40233,1,1,671,1266,595
40234,0,0,87,0,-87
40235,1,1,658,1207,549
40236,1,1,86,1860,1774
40237,1,0,82,0,-82
40238,1,0,70,0,-70
40239,0,0,12,0,-12
40240,1,1,1142,1369,227
40241,1,1,414,1333,919
40242,0,0,74,0,-74
40243,0,0,25,0,-25
40244,1,1,496,1869,1373
40245,0,0,50,0,-50
40246,1,1,128,1284,1156
40247,0,0,33,0,-33
40248,0,0,43,0,-43
40249,0,0,41,0,-41
40250,0,0,6,0,-6
40251,0,0,18,0,-18
40252,1,0,72,0,-72
40253,1,1,1567,4438,2871
40254,1,0,147,0,-147
40255,0,0,44,0,-44
40256,0,0,4,0,-4
40257,1,0,29,0,-29
40258,1,1,582,1458,876
40259,0,0,23,0,-23
40260,1,0,184,0,-184
40261,1,0,142,0,-142
40262,1,1,710,1476,766
40263,1,1,1032,1216,184
40264,0,0,46,0,-46
40265,1,0,2,0,-2
40266,1,1,404,1217,813
40267,1,0,45,0,-45
40268,1,0,172,0,-172
40269,1,0,42,0,-42
40270,1,0,19,0,-19
40271,1,1,1196,3111,1915
40272,0,0,164,0,-164
40273,0,0,8,0,-8
40274,1,1,457,1317,860
40275,0,0,22,0,-22
40276,1,0,6,0,-6
40277,0,0,45,0,-45
40278,0,0,81,0,-81
40279,1,1,2360,1658,-702
40280,0,0,232,0,-232
40281,1,0,82,0,-82
40282,0,0,175,0,-175
40283,1,0,90,0,-90
40284,1,0,34,0,-34
40285,1,0,133,0,-133
40286,1,0,35,0,-35
40287,0,0,116,0,-116
40288,0,0,114,0,-114
40289,1,1,2120,1392,-728
40290,0,0,22,0,-22
40291,1,1,294,2377,2083
40292,1,0,123,0,-123
40293,1,0,12,0,-12
40294,1,0,37,0,-37
40295,0,0,32,0,-32
40296,0,0,57,0,-57
40297,0,0,65,0,-65
40298,1,1,369,1526,1157
40299,1,0,18,0,-18
40300,0,0,27,0,-27
40301,1,0,57,0,-57
40302,1,0,1,0,-1
40303,0,0,16,0,-16
40304,0,0,10,0,-10
40305,0,0,90,0,-90
40306,1,0,6,0,-6
40307,1,1,129,1233,1104
40308,1,0,29,0,-29
40309,1,0,37,0,-37
40310,1,0,29,0,-29
40311,0,0,12,0,-12
40312,1,1,734,1285,551
40313,1,1,820,1250,430
40314,1,0,14,0,-14
40315,1,1,980,2673,1693
40316,1,0,18,0,-18
40317,0,0,46,0,-46
40318,1,1,341,1329,988
40319,1,1,627,1769,1142
40320,0,0,2,0,-2
40321,1,0,2,0,-2
40322,1,0,22,0,-22
40323,0,0,58,0,-58
40324,1,1,53,1444,1391
40325,0,0,15,0,-15
40326,0,0,77,0,-77
40327,0,0,5,0,-5
40328,0,0,46,0,-46
40329,1,0,109,0,-109
40330,0,0,11,0,-11
40331,0,0,11,0,-11
40332,0,0,45,0,-45
40333,1,1,642,1206,564
40334,1,1,319,1245,926
40335,0,0,227,0,-227
40336,1,1,1664,1365,-299
40337,1,0,38,0,-38
40338,1,0,27,0,-27
40339,0,0,153,0,-153
40340,1,0,8,0,-8
40341,1,0,76,0,-76
40342,0,0,94,0,-94
40343,1,1,553,1265,712
40344,1,0,12,0,-12
40345,0,0,5,0,-5
40346,1,1,421,1249,828
40347,0,0,47,0,-47
40348,0,0,90,0,-90
40349,1,0,16,0,-16
40350,1,0,17,0,-17
40351,1,1,312,1313,1001
40352,0,0,66,0,-66
40353,1,1,884,1271,387
40354,0,0,9,0,-9
40355,1,0,13,0,-13
40356,0,0,36,0,-36
40357,0,0,96,0,-96
40358,1,1,1159,2077,918
40359,0,0,14,0,-14
40360,1,1,844,1231,387
40361,1,0,31,0,-31
40362,1,0,12,0,-12
40363,1,0,26,0,-26
40364,1,0,14,0,-14
40365,1,1,595,1628,1033
40366,1,1,1150,1357,207
40367,0,0,30,0,-30
40368,1,0,94,0,-94
40369,1,1,228,1264,1036
40370,0,0,25,0,-25
40371,0,0,54,0,-54
40372,1,1,137,2193,2056
40373,1,1,291,1367,1076
40374,1,1,59,1349,1290
40375,1,0,6,0,-6
40376,1,1,210,1221,1011
40377,1,0,97,0,-97
40378,0,0,63,0,-63
40379,1,0,21,0,-21
40380,1,0,3,0,-3
40381,1,1,609,1359,750
40382,1,1,208,1481,1273
40383,0,0,25,0,-25
40384,0,0,9,0,-9
40385,0,0,13,0,-13
40386,0,0,41,0,-41
40387,1,0,95,0,-95
40388,1,1,955,2488,1533
40389,1,1,538,1549,1011
40390,0,0,64,0,-64
40391,1,1,134,1352,1218
40392,1,0,110,0,-110
40393,1,1,1161,1622,461
40394,1,0,28,0,-28
40395,1,1,62,1289,1227
40396,1,1,145,1302,1157
40397,1,0,18,0,-18
40398,1,1,990,1321,331
40399,1,0,8,0,-8
40400,1,1,403,1394,991
40401,1,0,57,0,-57
40402,0,0,46,0,-46
40403,0,0,95,0,-95
40404,1,1,61,1307,1246
40405,1,1,793,1226,433
40406,1,1,414,1702,1288
40407,0,0,7,0,-7
40408,0,0,15,0,-15
40409,1,1,94,1347,1253
40410,0,0,18,0,-18
40411,0,0,37,0,-37
40412,0,0,19,0,-19
40413,1,0,6,0,-6
40414,0,0,81,0,-81
40415,1,0,52,0,-52
40416,1,1,129,1648,1519
40417,1,0,2,0,-2
40418,0,0,4,0,-4
40419,0,0,41,0,-41
40420,1,0,54,0,-54
40421,1,1,819,1496,677
40422,1,0,0,0,0
40423,0,0,36,0,-36
40424,0,0,15,0,-15
40425,1,1,569,1309,740
40426,0,0,8,0,-8
40427,0,0,52,0,-52
40428,1,0,29,0,-29
40429,1,1,789,1871,1082
40430,1,0,52,0,-52
40431,1,0,36,0,-36
40432,0,0,7,0,-7
40433,0,0,74,0,-74
40434,1,1,91,1246,1155
40435,0,0,6,0,-6
40436,1,0,0,0,0
40437,1,1,675,1707,1032
40438,0,0,79,0,-79
40439,0,0,34,0,-34
40440,0,0,133,0,-133
40441,1,1,1409,1309,-100
40442,1,1,2062,1445,-617
40443,0,0,39,0,-39
40444,1,1,218,1489,1271
40445,0,0,57,0,-57
40446,0,0,106,0,-106
40447,1,1,1835,1481,-354
40448,1,0,65,0,-65
40449,1,1,836,1264,428
40450,0,0,137,0,-137
40451,1,1,500,1438,938
40452,0,0,29,0,-29
40453,1,1,111,1367,1256
40454,1,1,690,3062,2372
40455,1,0,7,0,-7
40456,1,0,35,0,-35
40457,0,0,53,0,-53
40458,0,0,0,0,0
40459,1,1,358,1485,1127
40460,0,0,37,0,-37
40461,1,0,66,0,-66
40462,0,0,6,0,-6
40463,1,1,142,1323,1181
40464,1,1,13,1920,1907
40465,0,0,12,0,-12
40466,0,0,60,0,-60
40467,1,1,429,1711,1282
40468,1,1,179,1501,1322
40469,0,0,86,0,-86
40470,1,1,270,1246,976
40471,1,0,43,0,-43
40472,1,1,456,2075,1619
40473,1,1,353,1310,957
40474,1,0,25,0,-25
40475,1,1,357,1735,1378
40476,0,0,0,0,0
40477,1,1,945,1230,285
40478,0,0,105,0,-105
40479,1,0,217,0,-217
40480,1,1,769,1394,625
40481,0,0,11,0,-11
40482,0,0,8,0,-8
40483,1,1,1118,2135,1017
40484,1,0,55,0,-55
40485,1,0,3,0,-3
40486,0,0,77,0,-77
40487,1,0,11,0,-11
40488,0,0,124,0,-124
40489,0,0,75,0,-75
40490,0,0,6,0,-6
40491,1,0,7,0,-7
40492,0,0,20,0,-20
40493,1,0,39,0,-39
40494,1,0,57,0,-57
40495,1,0,10,0,-10
40496,1,0,38,0,-38
40497,1,1,56,1245,1189
40498,0,0,1,0,-1
40499,1,1,590,2644,2054
40500,0,0,82,0,-82
40501,0,0,60,0,-60
40502,1,0,126,0,-126
40503,1,0,8,0,-8
40504,0,0,68,0,-68
40505,0,0,19,0,-19
40506,0,0,153,0,-153
40507,1,0,45,0,-45
40508,1,1,123,1200,1077
40509,0,0,90,0,-90
40510,1,1,1286,1482,196
40511,1,1,64,1238,1174
40512,1,0,15,0,-15
40513,1,1,208,1315,1107
40514,1,1,838,2458,1620
40515,1,0,13,0,-13
40516,0,0,13,0,-13
40517,1,0,60,0,-60
40518,1,1,59,2344,2285
40519,1,1,492,1324,832
40520,0,0,6,0,-6
40521,0,0,1,0,-1
40522,0,0,64,0,-64
40523,1,1,304,2036,1732
40524,0,0,139,0,-139
40525,1,0,28,0,-28
40526,1,0,5,0,-5
40527,0,0,79,0,-79
40528,1,0,55,0,-55
40529,1,0,25,0,-25
40530,0,0,98,0,-98
40531,1,1,638,1230,592
40532,1,0,1,0,-1
40533,0,0,68,0,-68
40534,1,0,70,0,-70
40535,0,0,6,0,-6
40536,1,1,314,1438,1124
40537,1,0,13,0,-13
40538,0,0,26,0,-26
40539,1,1,589,1507,918
40540,1,0,16,0,-16
40541,1,1,310,1306,996
40542,0,0,18,0,-18
40543,1,1,221,1203,982
40544,0,0,13,0,-13
40545,1,0,10,0,-10
40546,0,0,101,0,-101
40547,1,0,82,0,-82
40548,1,0,166,0,-166
40549,1,0,50,0,-50
40550,1,0,69,0,-69
40551,1,1,146,1296,1150
40552,1,1,255,1461,1206
40553,1,1,1129,1329,200
40554,1,0,37,0,-37
40555,1,1,994,1432,438
40556,1,1,563,1247,684
40557,1,0,129,0,-129
40558,1,0,78,0,-78
40559,0,0,47,0,-47
40560,0,0,32,0,-32
40561,1,0,22,0,-22
40562,1,1,222,1333,1111
40563,1,1,275,2623,2348
40564,1,1,72,1268,1196
40565,1,1,1627,1777,150
40566,0,0,54,0,-54
40567,0,0,74,0,-74
40568,0,0,16,0,-16
40569,1,1,371,2008,1637
40570,0,0,78,0,-78
40571,0,0,37,0,-37
40572,1,1,327,1242,915
40573,1,0,12,0,-12
40574,1,1,62,1457,1395
40575,0,0,21,0,-21
40576,0,0,34,0,-34
40577,1,0,59,0,-59
40578,0,0,17,0,-17
40579,1,0,59,0,-59
40580,1,1,193,2691,2498
40581,1,0,25,0,-25
40582,0,0,69,0,-69
40583,1,1,445,1406,961
40584,1,0,68,0,-68
40585,1,1,477,1284,807
40586,0,0,7,0,-7
40587,0,0,119,0,-119
40588,1,1,2605,1269,-1336
40589,1,0,37,0,-37
40590,1,0,11,0,-11
40591,0,0,7,0,-7
40592,0,0,166,0,-166
40593,1,0,20,0,-20
40594,0,0,57,0,-57
40595,1,1,984,1251,267
40596,1,1,245,1339,1094
40597,0,0,9,0,-9
40598,0,0,32,0,-32
40599,0,0,109,0,-109
40600,1,0,7,0,-7
40601,0,0,11,0,-11
40602,0,0,52,0,-52
40603,1,0,90,0,-90
40604,1,1,213,1881,1668
40605,0,0,9,0,-9
40606,0,0,127,0,-127
40607,1,0,13,0,-13
40608,0,0,97,0,-97
40609,0,0,4,0,-4
40610,1,0,49,0,-49
40611,1,1,109,1222,1113
40612,1,0,50,0,-50
40613,1,1,64,1210,1146
40614,1,0,27,0,-27
40615,1,0,49,0,-49
40616,0,0,80,0,-80
40617,1,0,8,0,-8
40618,1,0,10,0,-10
40619,1,0,79,0,-79
40620,0,0,26,0,-26
40621,1,0,25,0,-25
40622,1,1,158,1377,1219
40623,0,0,25,0,-25
40624,0,0,26,0,-26
40625,1,1,2129,1201,-928
40626,0,0,5,0,-5
40627,1,1,214,1351,1137
40628,1,0,32,0,-32
40629,0,0,19,0,-19
40630,0,0,9,0,-9
40631,0,0,7,0,-7
40632,0,0,83,0,-83
40633,1,1,51,1315,1264
40634,1,1,710,2824,2114
40635,0,0,74,0,-74
40636,0,0,4,0,-4
40637,0,0,100,0,-100
40638,1,0,56,0,-56
40639,0,0,22,0,-22
40640,1,1,1996,1469,-527
40641,1,0,62,0,-62
40642,1,0,90,0,-90
40643,1,0,13,0,-13
40644,1,0,102,0,-102
40645,1,0,117,0,-117
40646,1,0,9,0,-9
40647,1,0,41,0,-41
40648,1,1,476,1261,785
40649,0,0,39,0,-39
40650,1,0,80,0,-80
40651,0,0,16,0,-16
40652,0,0,392,0,-392
40653,0,0,25,0,-25
40654,1,0,6,0,-6
40655,1,1,873,1458,585
40656,0,0,18,0,-18
40657,1,1,220,2317,2097
40658,1,1,418,1263,845
40659,0,0,11,0,-11
40660,1,1,546,1804,1258
40661,0,0,3,0,-3
40662,0,0,30,0,-30
40663,1,0,13,0,-13
40664,0,0,53,0,-53
40665,1,1,402,1467,1065
40666,1,1,73,1211,1138
40667,0,0,47,0,-47
40668,1,1,249,1203,954
40669,1,0,37,0,-37
40670,0,0,29,0,-29
40671,1,0,39,0,-39
40672,0,0,8,0,-8
40673,0,0,9,0,-9
40674,1,0,163,0,-163
40675,1,0,66,0,-66
40676,0,0,39,0,-39
40677,1,0,9,0,-9
40678,0,0,35,0,-35
40679,1,1,403,1644,1241
40680,0,0,83,0,-83
40681,1,1,122,1285,1163
40682,0,0,44,0,-44
40683,1,0,8,0,-8
40684,1,1,152,2193,2041
40685,0,0,34,0,-34
40686,0,0,23,0,-23
40687,1,1,227,1424,1197
40688,1,0,47,0,-47
40689,0,0,27,0,-27
40690,0,0,162,0,-162
40691,1,0,64,0,-64
40692,0,0,82,0,-82
40693,0,0,210,0,-210
40694,1,1,654,1217,563
40695,1,0,81,0,-81
40696,0,0,81,0,-81
40697,1,1,383,1255,872
40698,1,0,17,0,-17
40699,0,0,30,0,-30
40700,1,1,696,1368,672
40701,0,0,6,0,-6
40702,1,0,52,0,-52
40703,0,0,4,0,-4
40704,0,0,63,0,-63
40705,1,0,71,0,-71
40706,1,1,93,1676,1583
40707,0,0,38,0,-38
40708,1,1,1016,1550,534
40709,1,1,420,1272,852
40710,1,1,189,2192,2003
40711,0,0,29,0,-29
40712,1,0,96,0,-96
40713,1,1,580,1291,711
40714,0,0,104,0,-104
40715,1,1,162,1615,1453
40716,0,0,14,0,-14
40717,1,1,346,1505,1159
40718,1,1,759,1218,459
40719,1,0,32,0,-32
40720,1,1,131,1233,1102
40721,1,0,2,0,-2
40722,1,1,582,1217,635
40723,0,0,101,0,-101
40724,1,1,274,1487,1213
40725,1,0,24,0,-24
40726,0,0,11,0,-11
40727,1,0,89,0,-89
40728,0,0,34,0,-34
40729,1,0,6,0,-6
40730,1,1,417,1241,824
40731,1,0,27,0,-27
40732,1,0,34,0,-34
40733,1,1,736,1208,472
40734,0,0,56,0,-56
40735,1,0,78,0,-78
40736,1,1,54,1393,1339
40737,1,0,146,0,-146
40738,1,1,653,1453,800
40739,0,0,1,0,-1
40740,1,1,139,1344,1205
40741,1,0,15,0,-15
40742,0,0,2,0,-2
40743,0,0,187,0,-187
40744,1,1,299,2326,2027
40745,1,0,65,0,-65
40746,1,0,63,0,-63
40747,0,0,47,0,-47
40748,0,0,16,0,-16
40749,1,1,548,1474,926
40750,1,0,63,0,-63
40751,0,0,56,0,-56
40752,0,0,36,0,-36
40753,1,1,373,1535,1162
40754,0,0,91,0,-91
40755,0,0,49,0,-49
40756,1,0,9,0,-9
40757,1,0,1,0,-1
40758,1,1,231,1307,1076
40759,1,0,148,0,-148
40760,1,1,177,1346,1169
40761,1,0,31,0,-31
40762,1,1,158,1403,1245
40763,1,0,36,0,-36
40764,1,0,47,0,-47
40765,0,0,7,0,-7
40766,1,1,41,1276,1235
40767,0,0,163,0,-163
40768,1,0,12,0,-12
40769,1,0,3,0,-3
40770,0,0,9,0,-9
40771,1,1,295,1229,934
40772,1,1,41,1227,1186
40773,0,0,28,0,-28
40774,1,0,16,0,-16
40775,0,0,36,0,-36
40776,1,1,910,1563,653
40777,1,0,65,0,-65
40778,0,0,64,0,-64
40779,0,0,11,0,-11
40780,1,1,647,1408,761
40781,1,0,249,0,-249
40782,1,1,789,1541,752
40783,1,0,40,0,-40
40784,1,0,32,0,-32
40785,1,1,209,1271,1062
40786,1,0,26,0,-26
40787,1,0,64,0,-64
40788,1,1,900,1294,394
40789,0,0,28,0,-28
40790,0,0,111,0,-111
40791,0,0,19,0,-19
40792,1,0,5,0,-5
40793,0,0,131,0,-131
40794,0,0,13,0,-13
40795,1,1,71,1520,1449
40796,1,1,95,1475,1380
40797,1,1,507,1361,854
40798,0,0,9,0,-9
40799,1,1,528,1242,714
40800,1,1,502,1285,783
40801,1,1,530,1594,1064
40802,1,1,75,1664,1589
40803,0,0,11,0,-11
40804,1,1,728,1312,584
40805,0,0,19,0,-19
40806,0,0,61,0,-61
40807,1,0,35,0,-35
40808,0,0,155,0,-155
40809,1,0,118,0,-118
40810,1,1,382,1467,1085
40811,0,0,84,0,-84
40812,0,0,23,0,-23
40813,1,0,52,0,-52
40814,0,0,42,0,-42
40815,1,0,38,0,-38
40816,1,0,13,0,-13
40817,0,0,68,0,-68
40818,0,0,70,0,-70
40819,1,1,254,1685,1431
40820,1,1,19,1555,1536
40821,1,0,2,0,-2
40822,1,1,1254,1310,56
40823,0,0,9,0,-9
40824,1,0,82,0,-82
40825,0,0,40,0,-40
40826,0,0,73,0,-73
40827,0,0,0,0,0
40828,1,0,66,0,-66
40829,1,0,50,0,-50
40830,1,1,252,1250,998
40831,0,0,89,0,-89
40832,0,0,85,0,-85
40833,1,1,8,1346,1338
40834,1,0,11,0,-11
40835,1,0,30,0,-30
40836,0,0,16,0,-16
40837,1,0,7,0,-7
40838,1,0,41,0,-41
40839,1,0,147,0,-147
40840,1,1,311,2544,2233
40841,0,0,19,0,-19
40842,1,0,43,0,-43
40843,1,0,95,0,-95
40844,1,1,57,1498,1441
40845,0,0,74,0,-74
40846,1,1,178,1228,1050
40847,1,1,192,1444,1252
40848,1,0,43,0,-43
40849,0,0,96,0,-96
40850,1,0,30,0,-30
40851,0,0,35,0,-35
40852,1,1,496,1427,931
40853,1,0,37,0,-37
40854,1,0,164,0,-164
40855,1,1,916,1477,561
40856,1,1,294,1476,1182
40857,1,0,0,0,0
40858,1,1,818,1401,583
40859,1,1,1549,1711,162
40860,0,0,9,0,-9
40861,1,0,5,0,-5
40862,0,0,91,0,-91
40863,0,0,12,0,-12
40864,1,0,143,0,-143
40865,1,1,637,1319,682
40866,1,1,172,1531,1359
40867,0,0,114,0,-114
40868,1,0,30,0,-30
40869,1,0,20,0,-20
40870,1,1,116,1856,1740
40871,0,0,67,0,-67
40872,0,0,13,0,-13
40873,0,0,18,0,-18
40874,0,0,19,0,-19
40875,1,1,795,1389,594
40876,1,0,52,0,-52
40877,0,0,55,0,-55
40878,0,0,17,0,-17
40879,0,0,37,0,-37
40880,1,0,58,0,-58
40881,0,0,20,0,-20
40882,1,1,750,2019,1269
40883,1,0,116,0,-116
40884,1,0,105,0,-105
40885,1,1,281,1313,1032
40886,1,1,125,1377,1252
40887,0,0,13,0,-13
40888,0,0,57,0,-57
40889,1,0,14,0,-14
40890,0,0,2,0,-2
40891,1,0,43,0,-43
40892,0,0,71,0,-71
40893,0,0,7,0,-7
40894,1,0,1,0,-1
40895,0,0,32,0,-32
40896,1,0,36,0,-36
40897,1,0,70,0,-70
40898,1,0,46,0,-46
40899,1,1,167,1235,1068
40900,0,0,35,0,-35
40901,1,1,84,1265,1181
40902,1,1,1224,1525,301
40903,0,0,50,0,-50
40904,1,1,845,1237,392
40905,0,0,34,0,-34
40906,0,0,8,0,-8
40907,1,1,225,1280,1055
40908,1,0,38,0,-38
40909,1,0,97,0,-97
40910,1,1,274,1919,1645
40911,1,1,132,1307,1175
40912,1,0,52,0,-52
40913,1,1,747,1238,491
40914,1,1,103,1839,1736
40915,0,0,147,0,-147
40916,1,1,211,1541,1330
40917,0,0,27,0,-27
40918,1,0,32,0,-32
40919,0,0,0,0,0
40920,1,1,19,1236,1217
40921,1,1,552,1473,921
40922,1,0,47,0,-47
40923,0,0,16,0,-16
40924,0,0,103,0,-103
40925,0,0,14,0,-14
40926,1,0,54,0,-54
40927,1,1,103,1223,1120
40928,0,0,10,0,-10
40929,0,0,11,0,-11
40930,0,0,26,0,-26
40931,1,0,74,0,-74
40932,1,1,50,1475,1425
40933,0,0,78,0,-78
40934,1,0,40,0,-40
40935,0,0,26,0,-26
40936,1,0,61,0,-61
40937,0,0,12,0,-12
40938,0,0,34,0,-34
40939,0,0,4,0,-4
40940,1,0,13,0,-13
40941,1,0,34,0,-34
40942,1,0,10,0,-10
40943,0,0,76,0,-76
40944,0,0,3,0,-3
40945,0,0,13,0,-13
40946,1,1,106,1742,1636
40947,0,0,114,0,-114
40948,1,1,1089,1658,569
40949,1,1,424,1276,852
40950,1,1,554,1519,965
40951,0,0,62,0,-62
40952,0,0,99,0,-99
40953,1,0,85,0,-85
40954,0,0,17,0,-17
40955,1,1,342,1679,1337
40956,0,0,84,0,-84
40957,0,0,28,0,-28
40958,0,0,19,0,-19
40959,1,1,231,2092,1861
40960,1,0,27,0,-27
40961,0,0,96,0,-96
40962,1,0,63,0,-63
40963,1,0,5,0,-5
40964,1,0,72,0,-72
40965,1,1,67,1798,1731
40966,0,0,44,0,-44
40967,0,0,231,0,-231
40968,1,0,152,0,-152
40969,1,0,42,0,-42
40970,0,0,45,0,-45
40971,1,0,0,0,0
40972,1,1,842,1563,721
40973,0,0,108,0,-108
40974,1,0,18,0,-18
40975,1,0,67,0,-67
40976,1,1,541,1247,706
40977,1,0,18,0,-18
40978,0,0,23,0,-23
40979,0,0,30,0,-30
40980,1,1,550,1345,795
40981,0,0,54,0,-54
40982,1,0,28,0,-28
40983,0,0,60,0,-60
40984,1,0,46,0,-46
40985,0,0,15,0,-15
40986,1,1,608,1349,741
40987,1,0,29,0,-29
40988,1,0,9,0,-9
40989,1,0,99,0,-99
40990,1,1,29,2191,2162
40991,1,0,10,0,-10
40992,1,0,36,0,-36
40993,1,1,213,1241,1028
40994,1,1,641,1379,738
40995,1,0,67,0,-67
40996,1,0,3,0,-3
40997,1,1,601,1242,641
40998,1,1,705,1206,501
40999,1,1,479,1352,873
41000,1,0,34,0,-34
41001,1,0,68,0,-68
41002,1,0,48,0,-48
41003,1,1,169,1267,1098
41004,0,0,75,0,-75
41005,1,0,50,0,-50
41006,0,0,13,0,-13
41007,1,0,8,0,-8
41008,0,0,58,0,-58
41009,0,0,8,0,-8
41010,0,0,1,0,-1
41011,0,0,53,0,-53
41012,1,0,448,0,-448
41013,1,0,66,0,-66
41014,0,0,2,0,-2
41015,0,0,75,0,-75
41016,1,0,34,0,-34
41017,0,0,69,0,-69
41018,0,0,43,0,-43
41019,1,1,367,1413,1046
41020,1,1,611,3412,2801
41021,1,1,208,1376,1168
41022,1,0,134,0,-134
41023,1,0,17,0,-17
41024,1,1,495,1538,1043
41025,1,0,3,0,-3
41026,1,0,94,0,-94
41027,0,0,205,0,-205
41028,1,1,264,1242,978
41029,1,1,356,1494,1138
41030,0,0,88,0,-88
41031,0,0,11,0,-11
41032,1,0,48,0,-48
41033,1,1,96,1576,1480
41034,1,1,2435,1426,-1009
41035,0,0,28,0,-28
41036,1,0,16,0,-16
41037,1,0,80,0,-80
41038,1,0,26,0,-26
41039,1,0,143,0,-143
41040,0,0,20,0,-20
41041,0,0,9,0,-9
41042,1,1,1105,1745,640
41043,1,0,39,0,-39
41044,0,0,23,0,-23
41045,1,1,865,3686,2821
41046,0,0,35,0,-35
41047,1,1,428,1406,978
41048,1,0,59,0,-59
41049,1,1,123,1450,1327
41050,1,1,96,1548,1452
41051,0,0,24,0,-24
41052,0,0,145,0,-145
41053,1,0,229,0,-229
41054,0,0,111,0,-111
41055,0,0,6,0,-6
41056,0,0,82,0,-82
41057,0,0,8,0,-8
41058,0,0,21,0,-21
41059,0,0,70,0,-70
41060,1,0,44,0,-44
41061,1,0,21,0,-21
41062,1,0,26,0,-26
41063,1,0,4,0,-4
41064,0,0,1,0,-1
41065,0,0,2,0,-2
41066,1,0,3,0,-3
41067,0,0,49,0,-49
41068,0,0,29,0,-29
41069,1,1,292,1224,932
41070,1,0,7,0,-7
41071,1,0,0,0,0
41072,1,1,195,4031,3836
41073,1,1,77,1543,1466
41074,1,1,182,1693,1511
41075,1,1,63,2929,2866
41076,1,1,1687,1316,-371
41077,1,0,24,0,-24
41078,1,1,596,1260,664
41079,1,1,233,1366,1133
41080,1,1,433,1628,1195
41081,1,1,372,2092,1720
41082,0,0,30,0,-30
41083,1,1,579,1396,817
41084,1,0,1,0,-1
41085,1,1,290,3252,2962
41086,0,0,59,0,-59
41087,1,1,353,1494,1141
41088,1,0,6,0,-6
41089,1,0,112,0,-112
41090,1,0,12,0,-12
41091,0,0,2,0,-2
41092,1,0,58,0,-58
41093,1,0,37,0,-37
41094,1,1,1139,1648,509
41095,1,0,90,0,-90
41096,1,0,94,0,-94
41097,1,1,223,1322,1099
41098,0,0,59,0,-59
41099,0,0,26,0,-26
41100,0,0,15,0,-15
41101,1,1,499,1355,856
41102,1,1,627,1291,664
41103,1,0,52,0,-52
41104,1,1,446,2179,1733
41105,1,1,462,1618,1156
41106,0,0,95,0,-95
41107,1,0,34,0,-34
41108,1,0,2,0,-2
41109,1,0,57,0,-57
41110,1,0,70,0,-70
41111,1,1,643,1425,782
41112,1,0,32,0,-32
41113,0,0,51,0,-51
41114,1,0,86,0,-86
41115,1,1,597,1475,878
41116,0,0,77,0,-77
41117,0,0,16,0,-16
41118,1,1,891,1969,1078
41119,0,0,128,0,-128
41120,0,0,52,0,-52
41121,0,0,115,0,-115
41122,1,0,28,0,-28
41123,0,0,57,0,-57
41124,0,0,18,0,-18
41125,1,0,36,0,-36
41126,0,0,54,0,-54
41127,0,0,13,0,-13
41128,0,0,57,0,-57
41129,0,0,157,0,-157
41130,1,1,219,1229,1010
41131,1,1,350,1375,1025
41132,1,1,305,1743,1438
41133,0,0,0,0,0
41134,0,0,10,0,-10
41135,0,0,4,0,-4
41136,0,0,79,0,-79
41137,1,1,388,1485,1097
41138,1,1,1536,1502,-34
41139,1,1,678,2401,1723
41140,0,0,7,0,-7
41141,0,0,3,0,-3
41142,1,1,226,2302,2076
41143,1,0,63,0,-63
41144,1,1,1200,1338,138
41145,1,1,234,1905,1671
41146,0,0,10,0,-10
41147,0,0,2,0,-2
41148,1,1,380,1446,1066
41149,0,0,36,0,-36
41150,0,0,8,0,-8
41151,1,1,249,1478,1229
41152,0,0,45,0,-45
41153,1,0,176,0,-176
41154,1,0,96,0,-96
41155,1,0,126,0,-126
41156,1,1,1273,1251,-22
41157,0,0,6,0,-6
41158,0,0,29,0,-29
41159,1,1,301,1233,932
41160,0,0,79,0,-79
41161,0,0,165,0,-165
41162,1,0,177,0,-177
41163,1,1,15,1670,1655
41164,1,1,337,1359,1022
41165,0,0,35,0,-35
41166,1,0,85,0,-85
41167,0,0,77,0,-77
41168,1,1,919,1381,462
41169,1,0,163,0,-163
41170,0,0,14,0,-14
41171,1,0,75,0,-75
41172,0,0,50,0,-50
41173,1,1,846,2801,1955
41174,1,0,22,0,-22
41175,1,1,151,1244,1093
41176,1,0,27,0,-27
41177,1,1,1279,1830,551
41178,0,0,29,0,-29
41179,0,0,15,0,-15
41180,1,1,110,1421,1311
41181,1,0,40,0,-40
41182,0,0,13,0,-13
41183,0,0,19,0,-19
41184,0,0,25,0,-25
41185,1,1,669,1338,669
41186,1,1,1050,1621,571
41187,0,0,28,0,-28
41188,0,0,47,0,-47
41189,1,0,17,0,-17
41190,0,0,69,0,-69
41191,0,0,1,0,-1
41192,1,1,657,1413,756
41193,1,1,965,1485,520
41194,1,0,142,0,-142
41195,1,1,602,1610,1008
41196,1,0,33,0,-33
41197,0,0,138,0,-138
41198,1,0,12,0,-12
41199,1,1,719,1325,606
41200,1,1,148,1302,1154
41201,0,0,18,0,-18
41202,1,1,216,1389,1173
41203,0,0,17,0,-17
41204,0,0,17,0,-17
41205,0,0,47,0,-47
41206,1,1,21,1323,1302
41207,0,0,192,0,-192
41208,1,1,53,1278,1225
41209,1,1,336,1269,933
41210,0,0,72,0,-72
41211,1,1,574,1666,1092
41212,0,0,61,0,-61
41213,0,0,7,0,-7
41214,0,0,4,0,-4
41215,0,0,78,0,-78
41216,1,1,146,3594,3448
41217,1,0,29,0,-29
41218,1,1,56,1222,1166
41219,1,1,110,1333,1223
41220,1,1,686,1718,1032
41221,0,0,36,0,-36
41222,0,0,7,0,-7
41223,0,0,11,0,-11
41224,0,0,93,0,-93
41225,1,1,92,2708,2616
41226,1,1,1138,1295,157
41227,1,0,3,0,-3
41228,0,0,5,0,-5
41229,1,1,248,1556,1308
41230,1,1,383,1354,971
41231,0,0,143,0,-143
41232,0,0,7,0,-7
41233,1,0,12,0,-12
41234,1,0,4,0,-4
41235,1,1,188,1256,1068
41236,1,1,302,1575,1273
41237,0,0,118,0,-118
41238,0,0,84,0,-84
41239,1,1,220,1703,1483
41240,0,0,128,0,-128
41241,1,0,38,0,-38
41242,0,0,44,0,-44
41243,1,1,1189,1545,356
41244,1,1,270,1439,1169
41245,1,0,45,0,-45
41246,0,0,4,0,-4
41247,1,0,1,0,-1
41248,1,1,973,1834,861
41249,1,0,3,0,-3
41250,0,0,48,0,-48
41251,1,0,7,0,-7
41252,0,0,87,0,-87
41253,1,1,670,1457,787
41254,1,1,615,1796,1181
41255,0,0,0,0,0
41256,1,1,80,1461,1381
41257,1,1,865,3933,3068
41258,1,0,114,0,-114
41259,1,1,295,1561,1266
41260,0,0,1,0,-1
41261,0,0,38,0,-38
41262,0,0,53,0,-53
41263,1,0,33,0,-33
41264,1,0,5,0,-5
41265,1,0,80,0,-80
41266,0,0,18,0,-18
41267,0,0,20,0,-20
41268,1,1,208,1207,999
41269,0,0,24,0,-24
41270,1,0,67,0,-67
41271,1,1,644,1763,1119
41272,0,0,11,0,-11
41273,1,0,25,0,-25
41274,1,0,9,0,-9
41275,0,0,20,0,-20
41276,1,1,70,1271,1201
41277,1,0,31,0,-31
41278,1,0,22,0,-22
41279,1,1,248,1317,1069
41280,0,0,54,0,-54
41281,0,0,6,0,-6
41282,0,0,153,0,-153
41283,0,0,3,0,-3
41284,0,0,76,0,-76
41285,1,1,804,1212,408
41286,0,0,177,0,-177
41287,1,1,865,1682,817
41288,0,0,109,0,-109
41289,0,0,14,0,-14
41290,1,1,436,1260,824
41291,1,0,114,0,-114
41292,0,0,16,0,-16
41293,0,0,115,0,-115
41294,1,1,263,1535,1272
41295,1,0,10,0,-10
41296,0,0,30,0,-30
41297,1,1,40,1254,1214
41298,0,0,7,0,-7
41299,1,1,151,1292,1141
41300,0,0,49,0,-49
41301,1,0,20,0,-20
41302,1,1,1645,1285,-360
41303,1,1,401,1389,988
41304,1,0,36,0,-36
41305,0,0,185,0,-185
41306,1,1,242,1232,990
41307,1,0,209,0,-209
41308,1,0,151,0,-151
41309,1,0,43,0,-43
41310,0,0,30,0,-30
41311,0,0,2,0,-2
41312,0,0,29,0,-29
41313,1,1,301,1377,1076
41314,0,0,2,0,-2
41315,1,0,105,0,-105
41316,1,1,60,1313,1253
41317,1,0,41,0,-41
41318,1,1,253,5063,4810
41319,0,0,148,0,-148
41320,0,0,2,0,-2
41321,1,0,24,0,-24
41322,1,0,81,0,-81
41323,1,0,2,0,-2
41324,0,0,47,0,-47
41325,1,0,11,0,-11
41326,1,1,561,1401,840
41327,1,1,388,1305,917
41328,1,0,17,0,-17
41329,1,0,21,0,-21
41330,1,1,1895,1247,-648
41331,1,1,266,1303,1037
41332,1,0,70,0,-70
41333,1,0,119,0,-119
41334,0,0,96,0,-96
41335,1,0,143,0,-143
41336,0,0,1,0,-1
41337,1,0,19,0,-19
41338,0,0,71,0,-71
41339,0,0,51,0,-51
41340,1,0,3,0,-3
41341,0,0,172,0,-172
41342,0,0,37,0,-37
41343,0,0,71,0,-71
41344,1,1,507,1457,950
41345,1,0,63,0,-63
41346,0,0,34,0,-34
41347,0,0,7,0,-7
41348,0,0,8,0,-8
41349,1,1,184,1402,1218
41350,1,0,9,0,-9
41351,1,0,6,0,-6
41352,1,0,5,0,-5
41353,1,1,118,1656,1538
41354,1,0,193,0,-193
41355,0,0,130,0,-130
41356,0,0,56,0,-56
41357,1,1,559,2424,1865
41358,1,0,27,0,-27
41359,0,0,18,0,-18
41360,0,0,16,0,-16
41361,0,0,141,0,-141
41362,1,0,100,0,-100
41363,1,1,92,1504,1412
41364,0,0,19,0,-19
41365,1,1,770,1455,685
41366,1,0,44,0,-44
41367,0,0,57,0,-57
41368,1,1,168,1433,1265
41369,1,0,18,0,-18
41370,1,1,629,1710,1081
41371,1,0,23,0,-23
41372,0,0,24,0,-24
41373,0,0,64,0,-64
41374,1,1,622,1275,653
41375,0,0,11,0,-11
41376,1,0,4,0,-4
41377,0,0,50,0,-50
41378,1,0,131,0,-131
41379,0,0,20,0,-20
41380,1,1,60,1383,1323
41381,1,1,207,2358,2151
41382,1,1,300,1534,1234
41383,0,0,130,0,-130
41384,1,1,1754,1225,-529
41385,0,0,9,0,-9
41386,1,1,355,1298,943
41387,0,0,66,0,-66
41388,0,0,20,0,-20
41389,0,0,57,0,-57
41390,1,0,42,0,-42
41391,0,0,44,0,-44
41392,0,0,109,0,-109
41393,1,0,62,0,-62
41394,1,0,67,0,-67
41395,0,0,136,0,-136
41396,1,0,16,0,-16
41397,0,0,11,0,-11
41398,1,0,13,0,-13
41399,1,0,8,0,-8
41400,1,0,25,0,-25
41401,0,0,16,0,-16
41402,1,1,612,1432,820
41403,1,1,890,1299,409
41404,1,1,467,1249,782
41405,1,1,473,1264,791
41406,0,0,10,0,-10
41407,1,1,874,1738,864
41408,1,0,32,0,-32
41409,1,1,1110,1233,123
41410,0,0,128,0,-128
41411,0,0,17,0,-17
41412,0,0,9,0,-9
41413,0,0,8,0,-8
41414,0,0,1,0,-1
41415,1,1,646,1205,559
41416,0,0,23,0,-23
41417,0,0,83,0,-83
41418,1,1,143,1470,1327
41419,1,0,111,0,-111
41420,0,0,37,0,-37
41421,1,1,1429,2313,884
41422,1,0,100,0,-100
41423,0,0,30,0,-30
41424,1,0,37,0,-37
41425,1,0,2,0,-2
41426,0,0,17,0,-17
41427,0,0,20,0,-20
41428,1,1,674,1717,1043
41429,1,0,120,0,-120
41430,0,0,2,0,-2
41431,1,1,369,1503,1134
41432,1,0,1,0,-1
41433,0,0,6,0,-6
41434,0,0,116,0,-116
41435,1,0,126,0,-126
41436,1,0,93,0,-93
41437,1,1,637,1312,675
41438,0,0,68,0,-68
41439,0,0,34,0,-34
41440,1,1,257,1647,1390
41441,0,0,76,0,-76
41442,0,0,10,0,-10
41443,1,0,93,0,-93
41444,0,0,85,0,-85
41445,0,0,56,0,-56
41446,1,1,420,2489,2069
41447,1,1,362,1200,838
41448,0,0,21,0,-21
41449,0,0,12,0,-12
41450,0,0,97,0,-97
41451,1,0,38,0,-38
41452,1,1,597,2170,1573
41453,1,0,35,0,-35
41454,1,1,663,1884,1221
41455,0,0,10,0,-10
41456,0,0,71,0,-71
41457,1,1,266,1857,1591
41458,1,0,1,0,-1
41459,0,0,19,0,-19
41460,1,0,6,0,-6
41461,0,0,69,0,-69
41462,1,1,417,1311,894
41463,1,1,1354,2672,1318
41464,0,0,127,0,-127
41465,0,0,21,0,-21
41466,0,0,71,0,-71
41467,1,1,896,1860,964
41468,0,0,5,0,-5
41469,1,1,281,5894,5613
41470,0,0,22,0,-22
41471,1,0,41,0,-41
41472,0,0,63,0,-63
41473,1,1,164,1561,1397
41474,1,1,324,1223,899
41475,1,1,308,1236,928
41476,1,1,643,1828,1185
41477,1,0,15,0,-15
41478,0,0,150,0,-150
41479,0,0,43,0,-43
41480,1,0,96,0,-96
41481,0,0,76,0,-76
41482,0,0,71,0,-71
41483,0,0,80,0,-80
41484,1,0,29,0,-29
41485,1,0,65,0,-65
41486,1,1,251,1247,996
41487,0,0,6,0,-6
41488,0,0,37,0,-37
41489,0,0,7,0,-7
41490,1,1,836,1255,419
41491,0,0,18,0,-18
41492,1,1,451,1248,797
41493,1,1,248,2870,2622
41494,1,0,35,0,-35
41495,0,0,177,0,-177
41496,0,0,16,0,-16
41497,0,0,64,0,-64
41498,1,1,1665,1498,-167
41499,0,0,53,0,-53
41500,1,0,54,0,-54
41501,0,0,95,0,-95
41502,0,0,26,0,-26
41503,0,0,22,0,-22
41504,0,0,7,0,-7
41505,1,1,69,1356,1287
41506,1,0,132,0,-132
41507,0,0,34,0,-34
41508,0,0,24,0,-24
41509,1,0,145,0,-145
41510,0,0,80,0,-80
41511,1,1,224,1791,1567
41512,0,0,51,0,-51
41513,0,0,73,0,-73
41514,1,1,710,1271,561
41515,1,1,837,1511,674
41516,1,1,377,1206,829
41517,0,0,116,0,-116
41518,0,0,1,0,-1
41519,0,0,33,0,-33
41520,0,0,21,0,-21
41521,1,0,106,0,-106
41522,0,0,48,0,-48
41523,1,0,97,0,-97
41524,1,0,38,0,-38
41525,1,1,416,1471,1055
41526,0,0,32,0,-32
41527,0,0,13,0,-13
41528,1,0,41,0,-41
41529,0,0,24,0,-24
41530,1,1,903,1836,933
41531,1,0,8,0,-8
41532,0,0,121,0,-121
41533,0,0,31,0,-31
41534,1,0,71,0,-71
41535,1,1,445,1346,901
41536,1,0,105,0,-105
41537,0,0,10,0,-10
41538,1,1,249,1544,1295
41539,0,0,70,0,-70
41540,1,0,37,0,-37
41541,0,0,60,0,-60
41542,1,0,18,0,-18
41543,1,1,675,1563,888
41544,1,1,1191,1394,203
41545,0,0,19,0,-19
41546,0,0,19,0,-19
41547,0,0,32,0,-32
41548,0,0,81,0,-81
41549,0,0,17,0,-17
41550,1,1,1129,1336,207
41551,0,0,15,0,-15
41552,0,0,134,0,-134
41553,1,0,18,0,-18
41554,1,0,21,0,-21
41555,1,1,268,1740,1472
41556,0,0,355,0,-355
41557,1,0,15,0,-15
41558,1,1,1065,2214,1149
41559,1,0,18,0,-18
41560,1,0,89,0,-89
41561,0,0,42,0,-42
41562,0,0,29,0,-29
41563,1,0,3,0,-3
41564,0,0,81,0,-81
41565,1,0,27,0,-27
41566,0,0,50,0,-50
41567,1,0,294,0,-294
41568,1,0,32,0,-32
41569,0,0,8,0,-8
41570,0,0,2,0,-2
41571,0,0,48,0,-48
41572,0,0,36,0,-36
41573,0,0,132,0,-132
41574,1,0,27,0,-27
41575,0,0,13,0,-13
41576,0,0,10,0,-10
41577,0,0,66,0,-66
41578,0,0,12,0,-12
41579,0,0,21,0,-21
41580,0,0,9,0,-9
41581,1,0,39,0,-39
41582,0,0,38,0,-38
41583,0,0,137,0,-137
41584,1,0,13,0,-13
41585,0,0,33,0,-33
41586,0,0,94,0,-94
41587,0,0,13,0,-13
41588,1,0,23,0,-23
41589,0,0,45,0,-45
41590,1,1,47,1466,1419
41591,0,0,81,0,-81
41592,1,0,60,0,-60
41593,1,0,46,0,-46
41594,1,0,57,0,-57
41595,0,0,23,0,-23
41596,0,0,4,0,-4
41597,0,0,4,0,-4
41598,1,1,625,1232,607
41599,1,0,39,0,-39
41600,1,1,1313,1597,284
41601,0,0,109,0,-109
41602,0,0,53,0,-53
41603,0,0,21,0,-21
41604,1,1,187,1314,1127
41605,1,1,506,1229,723
41606,0,0,8,0,-8
41607,0,0,47,0,-47
41608,1,1,780,1365,585
41609,1,0,36,0,-36
41610,0,0,33,0,-33
41611,0,0,34,0,-34
41612,0,0,37,0,-37
41613,1,1,1480,1298,-182
41614,0,0,24,0,-24
41615,1,0,85,0,-85
41616,0,0,89,0,-89
41617,1,0,34,0,-34
41618,1,0,8,0,-8
41619,0,0,31,0,-31
41620,0,0,15,0,-15
41621,0,0,60,0,-60
41622,1,1,720,1264,544
41623,1,1,23,1793,1770
41624,1,1,155,2932,2777
41625,0,0,90,0,-90
41626,1,1,253,3214,2961
41627,1,1,506,2321,1815
41628,1,0,124,0,-124
41629,0,0,71,0,-71
41630,0,0,4,0,-4
41631,0,0,54,0,-54
41632,1,0,27,0,-27
41633,1,1,800,1434,634
41634,0,0,16,0,-16
41635,1,0,142,0,-142
41636,1,0,30,0,-30
41637,0,0,17,0,-17
41638,1,0,30,0,-30
41639,0,0,7,0,-7
41640,0,0,35,0,-35
41641,0,0,22,0,-22
41642,1,0,32,0,-32
41643,1,1,141,1424,1283
41644,1,0,8,0,-8
41645,1,0,23,0,-23
41646,0,0,28,0,-28
41647,1,0,10,0,-10
41648,0,0,66,0,-66
41649,1,1,118,1420,1302
41650,0,0,13,0,-13
41651,0,0,64,0,-64
41652,1,1,388,1359,971
41653,1,1,254,2656,2402
41654,1,0,15,0,-15
41655,1,1,799,1488,689
41656,1,0,37,0,-37
41657,0,0,34,0,-34
41658,1,0,25,0,-25
41659,1,1,419,3533,3114
41660,1,0,6,0,-6
41661,1,0,20,0,-20
41662,1,0,6,0,-6
41663,0,0,13,0,-13
41664,0,0,48,0,-48
41665,1,1,907,1657,750
41666,1,0,29,0,-29
41667,1,1,405,1705,1300
41668,1,0,63,0,-63
41669,1,0,48,0,-48
41670,0,0,18,0,-18
41671,0,0,40,0,-40
41672,0,0,170,0,-170
41673,1,0,41,0,-41
41674,0,0,23,0,-23
41675,1,1,76,1203,1127
41676,0,0,62,0,-62
41677,1,0,36,0,-36
41678,1,0,7,0,-7
41679,1,0,80,0,-80
41680,0,0,22,0,-22
41681,0,0,55,0,-55
41682,1,1,643,1350,707
41683,1,1,1521,1258,-263
41684,1,1,480,1603,1123
41685,1,1,284,1962,1678
41686,1,1,1027,1590,563
41687,0,0,64,0,-64
41688,1,0,41,0,-41
41689,1,1,774,1480,706
41690,1,0,214,0,-214
41691,1,0,46,0,-46
41692,1,1,1264,1529,265
41693,0,0,5,0,-5
41694,1,1,221,1252,1031
41695,0,0,119,0,-119
41696,1,0,97,0,-97
41697,1,1,1208,1834,626
41698,0,0,4,0,-4
41699,0,0,22,0,-22
41700,1,1,260,1326,1066
41701,0,0,4,0,-4
41702,0,0,199,0,-199
41703,1,0,135,0,-135
41704,1,1,400,1391,991
41705,1,1,267,1971,1704
41706,1,1,1097,1621,524
41707,1,0,16,0,-16
41708,0,0,73,0,-73
41709,0,0,18,0,-18
41710,1,1,48,1758,1710
41711,0,0,166,0,-166
41712,0,0,1,0,-1
41713,1,0,32,0,-32
41714,0,0,62,0,-62
41715,0,0,29,0,-29
41716,1,0,47,0,-47
41717,1,0,61,0,-61
41718,0,0,18,0,-18
41719,1,0,37,0,-37
41720,1,1,359,1417,1058
41721,0,0,20,0,-20
41722,1,0,47,0,-47
41723,1,0,38,0,-38
41724,1,1,115,1203,1088
41725,1,1,303,1355,1052
41726,1,0,56,0,-56
41727,1,1,1175,1325,150
41728,1,1,843,1398,555
41729,1,1,322,1350,1028
41730,0,0,12,0,-12
41731,1,1,700,1336,636
41732,0,0,46,0,-46
41733,0,0,10,0,-10
41734,0,0,88,0,-88
41735,0,0,21,0,-21
41736,1,0,52,0,-52
41737,1,0,116,0,-116
41738,0,0,30,0,-30
41739,1,1,127,1334,1207
41740,1,0,128,0,-128
41741,1,1,1327,1427,100
41742,1,0,118,0,-118
41743,0,0,177,0,-177
41744,1,1,589,2457,1868
41745,0,0,48,0,-48
41746,1,0,23,0,-23
41747,1,1,238,1311,1073
41748,1,1,477,1674,1197
41749,0,0,7,0,-7
41750,1,0,129,0,-129
41751,1,1,79,1242,1163
41752,1,1,147,2105,1958
41753,0,0,27,0,-27
41754,1,0,114,0,-114
41755,0,0,3,0,-3
41756,1,1,2539,1302,-1237
41757,1,1,1932,1305,-627
41758,1,0,3,0,-3
41759,1,1,482,1333,851
41760,1,0,95,0,-95
41761,1,1,855,1641,786
41762,0,0,4,0,-4
41763,0,0,78,0,-78
41764,0,0,21,0,-21
41765,1,1,59,1419,1360
41766,0,0,49,0,-49
41767,0,0,15,0,-15
41768,1,0,49,0,-49
41769,1,0,24,0,-24
41770,1,0,11,0,-11
41771,1,1,408,1272,864
41772,0,0,33,0,-33
41773,1,0,33,0,-33
41774,0,0,45,0,-45
41775,0,0,8,0,-8
41776,1,1,284,1421,1137
41777,1,1,986,1683,697
41778,0,0,30,0,-30
41779,1,1,705,1442,737
41780,1,0,298,0,-298
41781,1,1,221,1225,1004
41782,0,0,77,0,-77
41783,0,0,11,0,-11
41784,0,0,67,0,-67
41785,0,0,11,0,-11
41786,1,0,25,0,-25
41787,1,1,70,1819,1749
41788,1,1,457,1576,1119
41789,1,0,72,0,-72
41790,1,0,2,0,-2
41791,1,1,201,1501,1300
41792,1,1,346,1652,1306
41793,0,0,30,0,-30
41794,1,1,1893,1969,76
41795,0,0,0,0,0
41796,1,1,92,4117,4025
41797,0,0,80,0,-80
41798,1,1,35,1312,1277
41799,0,0,174,0,-174
41800,0,0,85,0,-85
41801,1,1,443,1237,794
41802,0,0,25,0,-25
41803,0,0,80,0,-80
41804,1,1,515,5619,5104
41805,1,0,7,0,-7
41806,0,0,53,0,-53
41807,0,0,8,0,-8
41808,0,0,57,0,-57
41809,1,1,35,1656,1621
41810,0,0,9,0,-9
41811,0,0,39,0,-39
41812,1,0,4,0,-4
41813,1,0,49,0,-49
41814,0,0,3,0,-3
41815,0,0,15,0,-15
41816,1,0,29,0,-29
41817,0,0,46,0,-46
41818,1,1,29,1354,1325
41819,0,0,31,0,-31
41820,1,1,887,1540,653
41821,0,0,109,0,-109
41822,1,0,16,0,-16
41823,1,0,126,0,-126
41824,0,0,9,0,-9
41825,0,0,13,0,-13
41826,0,0,41,0,-41
41827,1,0,19,0,-19
41828,0,0,90,0,-90
41829,0,0,82,0,-82
41830,1,0,155,0,-155
41831,0,0,141,0,-141
41832,0,0,30,0,-30
41833,1,0,34,0,-34
41834,1,1,1628,1692,64
41835,1,0,154,0,-154
41836,1,0,61,0,-61
41837,1,1,8,2166,2158
41838,0,0,10,0,-10
41839,1,1,251,1440,1189
41840,0,0,25,0,-25
41841,0,0,44,0,-44
41842,0,0,81,0,-81
41843,0,0,64,0,-64
41844,1,1,723,1435,712
41845,0,0,10,0,-10
41846,0,0,56,0,-56
41847,1,0,24,0,-24
41848,1,0,16,0,-16
41849,0,0,25,0,-25
41850,1,0,47,0,-47
41851,1,0,20,0,-20
41852,1,0,6,0,-6
41853,0,0,116,0,-116
41854,1,0,27,0,-27
41855,0,0,60,0,-60
41856,1,1,526,1664,1138
41857,0,0,3,0,-3
41858,1,1,488,1529,1041
41859,0,0,10,0,-10
41860,1,0,6,0,-6
41861,1,0,66,0,-66
41862,0,0,1,0,-1
41863,1,1,1088,1755,667
41864,1,1,711,1354,643
41865,1,1,148,1389,1241
41866,0,0,38,0,-38
41867,1,0,84,0,-84
41868,0,0,14,0,-14
41869,1,1,267,1257,990
41870,0,0,132,0,-132
41871,1,1,238,1340,1102
41872,1,1,261,1452,1191
41873,1,0,69,0,-69
41874,0,0,8,0,-8
41875,1,1,680,2022,1342
41876,0,0,37,0,-37
41877,1,1,281,2943,2662
41878,0,0,27,0,-27
41879,1,1,1160,1319,159
41880,0,0,30,0,-30
41881,0,0,144,0,-144
41882,0,0,34,0,-34
41883,0,0,194,0,-194
41884,1,1,742,1215,473
41885,1,1,202,1902,1700
41886,0,0,31,0,-31
41887,0,0,14,0,-14
41888,0,0,33,0,-33
41889,0,0,102,0,-102
41890,0,0,28,0,-28
41891,0,0,125,0,-125
41892,1,0,10,0,-10
41893,0,0,83,0,-83
41894,0,0,30,0,-30
41895,0,0,7,0,-7
41896,0,0,9,0,-9
41897,1,0,104,0,-104
41898,1,1,209,2461,2252
41899,0,0,17,0,-17
41900,1,0,18,0,-18
41901,0,0,5,0,-5
41902,1,0,184,0,-184
41903,1,0,44,0,-44
41904,0,0,16,0,-16
41905,0,0,85,0,-85
41906,1,1,151,1294,1143
41907,1,1,254,1892,1638
41908,1,0,21,0,-21
41909,1,1,166,1365,1199
41910,1,0,6,0,-6
41911,0,0,21,0,-21
41912,0,0,31,0,-31
41913,1,0,114,0,-114
41914,1,1,1576,1902,326
41915,0,0,3,0,-3
41916,0,0,80,0,-80
41917,1,1,966,1246,280
41918,1,1,198,1236,1038
41919,1,1,92,1314,1222
41920,1,0,82,0,-82
41921,0,0,73,0,-73
41922,1,1,361,1383,1022
41923,1,1,272,2130,1858
41924,1,1,77,1233,1156
41925,1,1,482,1363,881
41926,0,0,16,0,-16
41927,0,0,51,0,-51
41928,1,0,70,0,-70
41929,1,0,12,0,-12
41930,0,0,56,0,-56
41931,0,0,74,0,-74
41932,0,0,102,0,-102
41933,1,0,178,0,-178
41934,1,0,32,0,-32
41935,1,1,819,1360,541
41936,0,0,191,0,-191
41937,0,0,45,0,-45
41938,0,0,69,0,-69
41939,1,0,32,0,-32
41940,0,0,97,0,-97
41941,1,0,12,0,-12
41942,1,1,403,1221,818
41943,0,0,53,0,-53
41944,0,0,88,0,-88
41945,1,0,2,0,-2
41946,1,1,699,2170,1471
41947,1,1,433,1216,783
41948,1,1,133,1385,1252
41949,0,0,46,0,-46
41950,0,0,43,0,-43
41951,1,1,286,1592,1306
41952,1,0,36,0,-36
41953,1,1,1558,1728,170
41954,1,0,23,0,-23
41955,0,0,134,0,-134
41956,0,0,10,0,-10
41957,0,0,50,0,-50
41958,0,0,72,0,-72
41959,1,0,16,0,-16
41960,0,0,6,0,-6
41961,1,1,62,1340,1278
41962,0,0,28,0,-28
41963,0,0,91,0,-91
41964,0,0,1,0,-1
41965,1,0,4,0,-4
41966,1,0,23,0,-23
41967,1,1,326,1475,1149
41968,0,0,4,0,-4
41969,0,0,38,0,-38
41970,0,0,0,0,0
41971,1,1,343,1924,1581
41972,0,0,64,0,-64
41973,0,0,120,0,-120
41974,1,0,53,0,-53
41975,1,1,341,1214,873
41976,1,1,111,1443,1332
41977,1,0,24,0,-24
41978,0,0,1,0,-1
41979,0,0,104,0,-104
41980,0,0,107,0,-107
41981,0,0,7,0,-7
41982,0,0,99,0,-99
41983,0,0,6,0,-6
41984,0,0,32,0,-32
41985,1,0,4,0,-4
41986,1,1,1031,1543,512
41987,1,0,31,0,-31
41988,1,0,7,0,-7
41989,0,0,31,0,-31
41990,1,0,87,0,-87
41991,1,0,6,0,-6
41992,0,0,31,0,-31
41993,0,0,21,0,-21
41994,1,0,1,0,-1
41995,1,0,73,0,-73
41996,0,0,29,0,-29
41997,0,0,88,0,-88
41998,0,0,51,0,-51
41999,0,0,16,0,-16
42000,0,0,27,0,-27
42001,0,0,23,0,-23
42002,1,0,74,0,-74
42003,1,1,729,1652,923
42004,1,0,55,0,-55
42005,1,0,11,0,-11
42006,1,0,18,0,-18
42007,0,0,5,0,-5
42008,0,0,30,0,-30
42009,1,1,388,1221,833
42010,1,1,385,1679,1294
42011,1,1,467,1533,1066
42012,0,0,27,0,-27
42013,1,0,14,0,-14
42014,0,0,267,0,-267
42015,1,1,578,1420,842
42016,0,0,17,0,-17
42017,0,0,85,0,-85
42018,1,1,248,3172,2924
42019,0,0,3,0,-3
42020,1,0,19,0,-19
42021,1,0,45,0,-45
42022,1,1,280,1361,1081
42023,0,0,37,0,-37
42024,0,0,16,0,-16
42025,1,0,18,0,-18
42026,0,0,37,0,-37
42027,1,1,315,1715,1400
42028,1,1,159,1483,1324
42029,0,0,47,0,-47
42030,1,1,1089,1419,330
42031,1,1,38,1894,1856
42032,1,0,75,0,-75
42033,0,0,8,0,-8
42034,0,0,73,0,-73
42035,1,0,5,0,-5
42036,1,1,84,1666,1582
42037,0,0,27,0,-27
42038,0,0,32,0,-32
42039,1,0,118,0,-118
42040,1,1,398,1671,1273
42041,1,0,16,0,-16
42042,1,1,74,2540,2466
42043,1,0,294,0,-294
42044,1,1,184,1606,1422
42045,0,0,1,0,-1
42046,1,1,118,1409,1291
42047,1,0,48,0,-48
42048,1,0,75,0,-75
42049,1,0,10,0,-10
42050,1,0,70,0,-70
42051,0,0,38,0,-38
42052,1,1,561,1375,814
42053,1,0,7,0,-7
42054,1,0,102,0,-102
42055,0,0,19,0,-19
42056,1,1,560,1389,829
42057,0,0,58,0,-58
42058,1,0,181,0,-181
42059,1,1,295,1418,1123
42060,1,1,611,1376,765
42061,1,0,18,0,-18
42062,1,0,24,0,-24
42063,1,1,119,1275,1156
42064,1,0,52,0,-52
42065,1,1,442,1232,790
42066,0,0,17,0,-17
42067,1,0,140,0,-140
42068,0,0,6,0,-6
42069,1,1,825,1479,654
42070,1,1,984,2217,1233
42071,1,1,212,2027,1815
42072,0,0,67,0,-67
42073,1,0,48,0,-48
42074,1,1,179,1214,1035
42075,0,0,39,0,-39
42076,1,0,260,0,-260
42077,1,0,51,0,-51
42078,1,0,4,0,-4
42079,1,1,765,1557,792
42080,1,0,47,0,-47
42081,1,0,38,0,-38
42082,1,1,729,1778,1049
42083,1,0,25,0,-25
42084,1,1,67,1304,1237
42085,1,1,469,1309,840
42086,1,1,409,1375,966
42087,1,1,651,1242,591
42088,1,1,521,1436,915
42089,0,0,3,0,-3
42090,1,1,685,1990,1305
42091,0,0,14,0,-14
42092,0,0,57,0,-57
42093,1,0,46,0,-46
42094,0,0,39,0,-39
42095,0,0,163,0,-163
42096,0,0,23,0,-23
42097,0,0,5,0,-5
42098,0,0,44,0,-44
42099,0,0,7,0,-7
42100,1,1,704,1211,507
42101,1,1,334,2264,1930
42102,0,0,90,0,-90
42103,1,0,3,0,-3
42104,0,0,111,0,-111
42105,0,0,142,0,-142
42106,1,0,66,0,-66
42107,1,1,2112,1696,-416
42108,0,0,19,0,-19
42109,0,0,9,0,-9
42110,0,0,2,0,-2
42111,1,0,12,0,-12
42112,1,0,75,0,-75
42113,1,0,90,0,-90
42114,1,0,75,0,-75
42115,1,0,49,0,-49
42116,1,1,520,1222,702
42117,1,0,19,0,-19
42118,0,0,19,0,-19
42119,0,0,23,0,-23
42120,1,0,36,0,-36
42121,0,0,27,0,-27
42122,1,1,296,1254,958
42123,0,0,39,0,-39
42124,1,1,159,2011,1852
42125,1,0,51,0,-51
42126,1,1,595,3303,2708
42127,0,0,21,0,-21
42128,1,1,200,1998,1798
42129,0,0,65,0,-65
42130,0,0,176,0,-176
42131,1,1,713,1213,500
42132,0,0,65,0,-65
42133,1,1,1406,1253,-153
42134,1,0,103,0,-103
42135,1,1,453,1458,1005
42136,0,0,54,0,-54
42137,1,0,50,0,-50
42138,0,0,81,0,-81
42139,0,0,62,0,-62
42140,1,0,88,0,-88
42141,1,1,230,1207,977
42142,1,1,278,1281,1003
42143,0,0,16,0,-16
42144,1,1,296,1373,1077
42145,1,0,75,0,-75
42146,1,0,22,0,-22
42147,0,0,12,0,-12
42148,1,1,209,2339,2130
42149,1,1,1943,1481,-462
42150,1,1,189,1405,1216
42151,0,0,6,0,-6
42152,0,0,2,0,-2
42153,0,0,115,0,-115
42154,1,1,231,1229,998
42155,1,1,241,1349,1108
42156,0,0,18,0,-18
42157,1,0,11,0,-11
42158,1,0,42,0,-42
42159,1,0,62,0,-62
42160,0,0,0,0,0
42161,1,1,723,2079,1356
42162,1,0,29,0,-29
42163,1,1,147,1212,1065
42164,0,0,57,0,-57
42165,1,0,5,0,-5
42166,1,0,47,0,-47
42167,1,0,8,0,-8
42168,0,0,19,0,-19
42169,1,1,187,1640,1453
42170,0,0,117,0,-117
42171,0,0,95,0,-95
42172,0,0,83,0,-83
42173,1,0,7,0,-7
42174,0,0,25,0,-25
42175,1,1,114,1317,1203
42176,1,1,1658,1451,-207
42177,1,0,124,0,-124
42178,1,0,123,0,-123
42179,0,0,11,0,-11
42180,1,1,891,2302,1411
42181,1,0,134,0,-134
42182,0,0,24,0,-24
42183,0,0,5,0,-5
42184,0,0,27,0,-27
42185,1,0,1,0,-1
42186,0,0,45,0,-45
42187,0,0,4,0,-4
42188,0,0,30,0,-30
42189,1,0,107,0,-107
42190,1,0,3,0,-3
42191,1,0,97,0,-97
42192,0,0,28,0,-28
42193,0,0,77,0,-77
42194,1,1,778,1533,755
42195,0,0,25,0,-25
42196,0,0,3,0,-3
42197,1,1,225,1237,1012
42198,1,1,743,1492,749
42199,1,1,1918,1623,-295
42200,1,0,50,0,-50
42201,1,0,54,0,-54
42202,0,0,203,0,-203
42203,1,1,641,2657,2016
42204,1,1,299,3843,3544
42205,1,0,165,0,-165
42206,0,0,0,0,0
42207,0,0,62,0,-62
42208,1,0,89,0,-89
42209,1,1,420,1592,1172
42210,1,0,46,0,-46
42211,1,1,1000,1258,258
42212,1,1,505,1497,992
42213,0,0,18,0,-18
42214,1,0,8,0,-8
42215,1,1,295,1395,1100
42216,0,0,69,0,-69
42217,0,0,9,0,-9
42218,0,0,22,0,-22
42219,1,0,3,0,-3
42220,1,1,734,1285,551
42221,1,1,184,1405,1221
42222,1,0,5,0,-5
42223,1,1,289,3351,3062
42224,1,0,30,0,-30
42225,1,1,1347,1248,-99
42226,1,0,44,0,-44
42227,0,0,23,0,-23
42228,1,1,171,1301,1130
42229,0,0,172,0,-172
42230,1,0,84,0,-84
42231,0,0,114,0,-114
42232,1,0,150,0,-150
42233,1,0,112,0,-112
42234,1,0,110,0,-110
42235,1,0,23,0,-23
42236,1,0,30,0,-30
42237,1,0,26,0,-26
42238,0,0,57,0,-57
42239,1,0,11,0,-11
42240,1,0,6,0,-6
42241,1,0,12,0,-12
42242,1,0,81,0,-81
42243,0,0,91,0,-91
42244,1,0,29,0,-29
42245,1,0,7,0,-7
42246,0,0,5,0,-5
42247,1,0,8,0,-8
42248,1,1,147,2096,1949
42249,0,0,45,0,-45
42250,0,0,158,0,-158
42251,0,0,65,0,-65
42252,1,0,5,0,-5
42253,0,0,95,0,-95
42254,1,1,91,2474,2383
42255,1,0,35,0,-35
42256,0,0,17,0,-17
42257,0,0,12,0,-12
42258,1,0,26,0,-26
42259,0,0,4,0,-4
42260,1,0,61,0,-61
42261,0,0,90,0,-90
42262,0,0,5,0,-5
42263,1,1,960,1341,381
42264,0,0,89,0,-89
42265,1,0,127,0,-127
42266,0,0,14,0,-14
42267,1,1,116,1320,1204
42268,0,0,104,0,-104
42269,1,1,1027,1497,470
42270,1,1,531,1365,834
42271,0,0,72,0,-72
42272,1,0,30,0,-30
42273,1,0,34,0,-34
42274,1,1,82,1457,1375
42275,0,0,121,0,-121
42276,1,1,578,2548,1970
42277,0,0,57,0,-57
42278,0,0,56,0,-56
42279,1,0,42,0,-42
42280,1,0,36,0,-36
42281,1,0,87,0,-87
42282,0,0,37,0,-37
42283,0,0,85,0,-85
42284,0,0,26,0,-26
42285,1,1,576,1288,712
42286,1,0,66,0,-66
42287,1,0,56,0,-56
42288,1,1,38,1220,1182
42289,1,0,3,0,-3
42290,1,0,8,0,-8
42291,0,0,114,0,-114
42292,1,0,45,0,-45
42293,1,0,105,0,-105
42294,1,0,14,0,-14
42295,1,1,744,1244,500
42296,1,1,42,1392,1350
42297,0,0,76,0,-76
42298,1,1,81,1389,1308
42299,0,0,43,0,-43
42300,0,0,20,0,-20
42301,0,0,97,0,-97
42302,0,0,29,0,-29
42303,0,0,38,0,-38
42304,1,1,1000,1495,495
42305,1,0,1,0,-1
42306,1,0,140,0,-140
42307,0,0,10,0,-10
42308,0,0,13,0,-13
42309,1,0,8,0,-8
42310,0,0,103,0,-103
42311,1,0,7,0,-7
42312,0,0,4,0,-4
42313,0,0,14,0,-14
42314,0,0,4,0,-4
42315,1,0,140,0,-140
42316,1,0,32,0,-32
42317,0,0,126,0,-126
42318,0,0,17,0,-17
42319,0,0,18,0,-18
42320,0,0,39,0,-39
42321,0,0,12,0,-12
42322,0,0,37,0,-37
42323,0,0,25,0,-25
42324,1,0,1,0,-1
42325,1,1,434,1581,1147
42326,1,1,296,2338,2042
42327,1,1,661,1275,614
42328,1,0,10,0,-10
42329,1,0,80,0,-80
42330,1,1,18,2775,2757
42331,0,0,34,0,-34
42332,0,0,28,0,-28
42333,1,1,115,1496,1381
42334,1,0,43,0,-43
42335,0,0,25,0,-25
42336,1,0,34,0,-34
42337,1,0,5,0,-5
42338,1,0,2,0,-2
42339,1,0,10,0,-10
42340,1,1,483,1319,836
42341,0,0,35,0,-35
42342,1,1,230,1313,1083
42343,1,0,124,0,-124
42344,1,0,274,0,-274
42345,0,0,23,0,-23
42346,0,0,24,0,-24
42347,1,0,13,0,-13
42348,0,0,6,0,-6
42349,0,0,25,0,-25
42350,1,0,74,0,-74
42351,0,0,64,0,-64
42352,1,0,38,0,-38
42353,0,0,19,0,-19
42354,1,0,13,0,-13
42355,1,0,33,0,-33
42356,1,1,704,1648,944
42357,1,1,587,1596,1009
42358,0,0,15,0,-15
42359,0,0,6,0,-6
42360,0,0,14,0,-14
42361,0,0,23,0,-23
42362,1,1,20,1377,1357
42363,1,1,250,1499,1249
42364,0,0,14,0,-14
42365,1,0,14,0,-14
42366,0,0,3,0,-3
42367,0,0,27,0,-27
42368,1,0,9,0,-9
42369,0,0,119,0,-119
42370,1,1,1479,1404,-75
42371,1,1,1008,1216,208
42372,1,0,41,0,-41
42373,1,1,356,1272,916
42374,0,0,7,0,-7
42375,1,1,731,1830,1099
42376,1,1,1094,1442,348
42377,0,0,22,0,-22
42378,0,0,5,0,-5
42379,1,0,149,0,-149
42380,1,1,380,1332,952
42381,0,0,7,0,-7
42382,1,1,50,2118,2068
42383,0,0,13,0,-13
42384,0,0,33,0,-33
42385,1,0,20,0,-20
42386,1,0,10,0,-10
42387,0,0,90,0,-90
42388,0,0,104,0,-104
42389,0,0,15,0,-15
42390,1,1,96,1355,1259
42391,1,0,200,0,-200
42392,1,0,2,0,-2
42393,0,0,84,0,-84
42394,1,0,1,0,-1
42395,1,1,332,5071,4739
42396,1,0,189,0,-189
42397,1,0,9,0,-9
42398,0,0,43,0,-43
42399,1,0,35,0,-35
42400,1,0,0,0,0
42401,0,0,114,0,-114
42402,1,0,53,0,-53
42403,0,0,46,0,-46
42404,1,1,1444,4615,3171
42405,1,0,44,0,-44
42406,1,1,90,1440,1350
42407,1,0,91,0,-91
42408,0,0,102,0,-102
42409,0,0,4,0,-4
42410,0,0,99,0,-99
42411,0,0,17,0,-17
42412,0,0,64,0,-64
42413,0,0,6,0,-6
42414,1,0,24,0,-24
42415,1,1,175,1423,1248
42416,0,0,32,0,-32
42417,1,1,938,4505,3567
42418,0,0,33,0,-33
42419,1,1,531,1522,991
42420,1,1,325,1343,1018
42421,0,0,14,0,-14
42422,1,1,86,1411,1325
42423,0,0,18,0,-18
42424,1,0,20,0,-20
42425,0,0,11,0,-11
42426,0,0,44,0,-44
42427,0,0,87,0,-87
42428,0,0,60,0,-60
42429,1,1,1213,1475,262
42430,0,0,88,0,-88
42431,1,0,13,0,-13
42432,1,1,286,1477,1191
42433,1,0,9,0,-9
42434,0,0,1,0,-1
42435,1,1,204,1468,1264
42436,1,1,1528,1386,-142
42437,1,1,259,1618,1359
42438,1,1,120,1310,1190
42439,0,0,32,0,-32
42440,1,0,57,0,-57
42441,1,1,157,1334,1177
42442,0,0,29,0,-29
42443,0,0,39,0,-39
42444,1,0,17,0,-17
42445,1,1,401,1267,866
42446,1,0,107,0,-107
42447,1,1,123,1209,1086
42448,1,0,5,0,-5
42449,0,0,15,0,-15
42450,1,0,14,0,-14
42451,1,0,12,0,-12
42452,1,0,54,0,-54
42453,0,0,48,0,-48
42454,0,0,160,0,-160
42455,1,1,432,1642,1210
42456,0,0,51,0,-51
42457,0,0,20,0,-20
42458,0,0,10,0,-10
42459,0,0,1,0,-1
42460,0,0,20,0,-20
42461,1,1,1103,1949,846
42462,0,0,6,0,-6
42463,1,1,150,1610,1460
42464,1,1,380,2525,2145
42465,1,1,747,1248,501
42466,0,0,18,0,-18
42467,1,1,101,1352,1251
42468,0,0,53,0,-53
42469,1,0,10,0,-10
42470,1,1,900,1617,717
42471,0,0,76,0,-76
42472,1,0,129,0,-129
42473,0,0,202,0,-202
42474,0,0,20,0,-20
42475,0,0,13,0,-13
42476,0,0,17,0,-17
42477,1,0,40,0,-40
42478,0,0,48,0,-48
42479,1,1,152,1211,1059
42480,1,0,71,0,-71
42481,0,0,93,0,-93
42482,1,0,15,0,-15
42483,0,0,12,0,-12
42484,0,0,22,0,-22
42485,1,1,48,1401,1353
42486,1,1,60,1234,1174
42487,1,0,15,0,-15
42488,0,0,17,0,-17
42489,0,0,107,0,-107
42490,1,1,583,1314,731
42491,0,0,86,0,-86
42492,1,1,979,1695,716
42493,1,0,61,0,-61
42494,0,0,7,0,-7
42495,0,0,142,0,-142
42496,1,0,49,0,-49
42497,0,0,103,0,-103
42498,1,1,269,1477,1208
42499,1,0,84,0,-84
42500,0,0,0,0,0
42501,0,0,64,0,-64
42502,0,0,17,0,-17
42503,0,0,58,0,-58
42504,0,0,5,0,-5
42505,1,1,1447,1468,21
42506,1,0,0,0,0
42507,0,0,84,0,-84
42508,1,1,580,1318,738
42509,0,0,39,0,-39
42510,0,0,88,0,-88
42511,0,0,13,0,-13
42512,1,1,986,1228,242
42513,1,1,92,1483,1391
42514,0,0,20,0,-20
42515,1,0,24,0,-24
42516,1,0,81,0,-81
42517,0,0,107,0,-107
42518,1,0,237,0,-237
42519,0,0,45,0,-45
42520,0,0,13,0,-13
42521,0,0,109,0,-109
42522,0,0,0,0,0
42523,0,0,56,0,-56
42524,1,1,186,2889,2703
42525,1,0,75,0,-75
42526,0,0,139,0,-139
42527,1,1,2346,1374,-972
42528,1,0,171,0,-171
42529,0,0,104,0,-104
42530,1,1,462,1582,1120
42531,0,0,10,0,-10
42532,0,0,32,0,-32
42533,0,0,9,0,-9
42534,0,0,25,0,-25
42535,1,0,183,0,-183
42536,0,0,36,0,-36
42537,1,0,34,0,-34
42538,1,0,8,0,-8
42539,0,0,4,0,-4
42540,0,0,41,0,-41
42541,0,0,68,0,-68
42542,0,0,111,0,-111
42543,1,1,37,2847,2810
42544,0,0,111,0,-111
42545,0,0,38,0,-38
42546,1,0,51,0,-51
42547,1,0,97,0,-97
42548,1,0,52,0,-52
42549,0,0,73,0,-73
42550,0,0,30,0,-30
42551,1,1,608,1536,928
42552,1,0,5,0,-5
42553,0,0,12,0,-12
42554,0,0,39,0,-39
42555,1,0,5,0,-5
42556,0,0,17,0,-17
42557,0,0,40,0,-40
42558,1,1,430,1597,1167
42559,1,0,0,0,0
42560,1,0,23,0,-23
42561,1,1,84,1405,1321
42562,1,0,8,0,-8
42563,1,0,33,0,-33
42564,0,0,13,0,-13
42565,1,0,19,0,-19
42566,0,0,25,0,-25
42567,1,0,1,0,-1
42568,1,1,420,1234,814
42569,0,0,33,0,-33
42570,0,0,82,0,-82
42571,1,1,692,1375,683
42572,1,0,30,0,-30
42573,0,0,10,0,-10
42574,0,0,15,0,-15
42575,0,0,52,0,-52
42576,1,1,759,2429,1670
42577,1,0,36,0,-36
42578,1,0,20,0,-20
42579,0,0,34,0,-34
42580,0,0,32,0,-32
42581,0,0,13,0,-13
42582,1,0,87,0,-87
42583,0,0,74,0,-74
42584,1,1,813,1317,504
42585,0,0,52,0,-52
42586,0,0,46,0,-46
42587,0,0,68,0,-68
42588,1,0,181,0,-181
42589,1,0,50,0,-50
42590,0,0,21,0,-21
42591,1,1,383,1232,849
42592,0,0,56,0,-56
42593,1,0,95,0,-95
42594,1,1,829,1738,909
42595,0,0,40,0,-40
42596,0,0,54,0,-54
42597,1,1,258,1207,949
42598,0,0,4,0,-4
42599,0,0,2,0,-2
42600,0,0,31,0,-31
42601,0,0,5,0,-5
42602,1,0,57,0,-57
42603,0,0,9,0,-9
42604,0,0,5,0,-5
42605,1,1,111,1607,1496
42606,0,0,19,0,-19
42607,1,1,276,1399,1123
42608,0,0,12,0,-12
42609,0,0,124,0,-124
42610,0,0,195,0,-195
42611,1,0,42,0,-42
42612,1,1,2422,1306,-1116
42613,0,0,4,0,-4
42614,0,0,164,0,-164
42615,1,0,39,0,-39
42616,1,0,49,0,-49
42617,1,1,372,1207,835
42618,1,1,651,1209,558
42619,1,1,68,2083,2015
42620,1,1,237,1392,1155
42621,0,0,17,0,-17
42622,0,0,345,0,-345
42623,1,0,13,0,-13
42624,0,0,37,0,-37
42625,1,0,61,0,-61
42626,1,0,38,0,-38
42627,1,1,242,1327,1085
42628,1,0,122,0,-122
42629,0,0,24,0,-24
42630,1,0,81,0,-81
42631,1,1,449,1335,886
42632,1,1,1564,2243,679
42633,1,1,848,1348,500
42634,1,1,345,1589,1244
42635,1,1,518,1302,784
42636,1,0,96,0,-96
42637,1,1,183,1881,1698
42638,0,0,44,0,-44
42639,0,0,98,0,-98
42640,0,0,11,0,-11
42641,0,0,26,0,-26
42642,1,1,710,1695,985
42643,1,0,102,0,-102
42644,1,0,3,0,-3
42645,0,0,168,0,-168
42646,1,1,1694,2093,399
42647,1,0,36,0,-36
42648,1,0,63,0,-63
42649,0,0,26,0,-26
42650,1,1,1016,1320,304
42651,1,0,7,0,-7
42652,0,0,1,0,-1
42653,1,1,370,1230,860
42654,1,1,487,1330,843
42655,0,0,12,0,-12
42656,1,0,7,0,-7
42657,1,0,3,0,-3
42658,0,0,52,0,-52
42659,1,1,98,1573,1475
42660,1,0,41,0,-41
42661,1,0,31,0,-31
42662,0,0,97,0,-97
42663,0,0,27,0,-27
42664,1,1,114,1482,1368
42665,1,1,110,1396,1286
42666,1,1,273,4396,4123
42667,1,0,20,0,-20
42668,1,0,31,0,-31
42669,0,0,11,0,-11
42670,0,0,4,0,-4
42671,1,1,361,4535,4174
42672,1,0,64,0,-64
42673,1,1,288,1225,937
42674,0,0,18,0,-18
42675,1,0,94,0,-94
42676,1,0,33,0,-33
42677,1,1,59,1279,1220
42678,0,0,25,0,-25
42679,0,0,0,0,0
42680,1,0,78,0,-78
42681,0,0,33,0,-33
42682,0,0,4,0,-4
42683,1,1,563,2368,1805
42684,0,0,11,0,-11
42685,1,1,741,1471,730
42686,1,1,906,1716,810
42687,0,0,45,0,-45
42688,0,0,31,0,-31
42689,1,1,464,1293,829
42690,1,1,91,1521,1430
42691,1,0,3,0,-3
42692,0,0,142,0,-142
42693,1,0,15,0,-15
42694,0,0,56,0,-56
42695,0,0,14,0,-14
42696,1,1,293,1243,950
42697,0,0,3,0,-3
42698,1,1,488,1203,715
42699,1,0,10,0,-10
42700,0,0,6,0,-6
42701,1,1,947,1351,404
42702,0,0,21,0,-21
42703,1,0,19,0,-19
42704,1,1,549,1501,952
42705,0,0,100,0,-100
42706,1,1,78,3590,3512
42707,0,0,10,0,-10
42708,1,0,37,0,-37
42709,1,1,162,2894,2732
42710,1,0,90,0,-90
42711,1,1,182,1353,1171
42712,1,0,21,0,-21
42713,1,0,33,0,-33
42714,1,0,14,0,-14
42715,1,1,218,1830,1612
42716,1,1,397,1458,1061
42717,1,0,169,0,-169
42718,1,0,20,0,-20
42719,1,0,51,0,-51
42720,0,0,87,0,-87
42721,1,1,439,1432,993
42722,1,1,172,2696,2524
42723,0,0,31,0,-31
42724,1,1,1901,1568,-333
42725,1,0,101,0,-101
42726,0,0,1,0,-1
42727,1,1,122,1279,1157
42728,1,1,91,1224,1133
42729,0,0,0,0,0
42730,0,0,31,0,-31
42731,0,0,15,0,-15
42732,1,0,57,0,-57
42733,1,1,675,1383,708
42734,0,0,37,0,-37
42735,0,0,45,0,-45
42736,0,0,20,0,-20
42737,0,0,10,0,-10
42738,0,0,33,0,-33
42739,0,0,93,0,-93
42740,1,0,7,0,-7
42741,0,0,47,0,-47
42742,0,0,45,0,-45
42743,0,0,7,0,-7
42744,1,0,23,0,-23
42745,1,0,3,0,-3
42746,1,0,7,0,-7
42747,0,0,5,0,-5
42748,1,0,35,0,-35
42749,1,0,1,0,-1
42750,0,0,107,0,-107
42751,0,0,31,0,-31
42752,0,0,126,0,-126
42753,0,0,20,0,-20
42754,1,0,17,0,-17
42755,0,0,66,0,-66
42756,0,0,16,0,-16
42757,1,0,162,0,-162
42758,1,1,158,1460,1302
42759,1,0,50,0,-50
42760,1,0,62,0,-62
42761,0,0,57,0,-57
42762,1,1,482,1224,742
42763,0,0,74,0,-74
42764,0,0,72,0,-72
42765,0,0,122,0,-122
42766,1,0,104,0,-104
42767,1,0,71,0,-71
42768,1,1,159,1407,1248
42769,1,0,34,0,-34
42770,1,1,574,2010,1436
42771,1,1,537,2433,1896
42772,1,1,1246,1301,55
42773,1,1,243,1357,1114
42774,0,0,28,0,-28
42775,1,1,182,1656,1474
42776,1,1,901,1329,428
42777,0,0,31,0,-31
42778,0,0,56,0,-56
42779,1,0,33,0,-33
42780,0,0,31,0,-31
42781,1,0,162,0,-162
42782,0,0,1,0,-1
42783,0,0,10,0,-10
42784,1,1,1450,1425,-25
42785,0,0,5,0,-5
42786,0,0,54,0,-54
42787,0,0,88,0,-88
42788,0,0,39,0,-39
42789,1,1,692,1554,862
42790,1,0,116,0,-116
42791,1,1,358,1376,1018
42792,0,0,7,0,-7
42793,1,0,35,0,-35
42794,1,0,14,0,-14
42795,1,1,177,1690,1513
42796,1,0,13,0,-13
42797,1,1,568,2234,1666
42798,0,0,23,0,-23
42799,1,0,57,0,-57
42800,1,0,30,0,-30
42801,1,1,628,2579,1951
42802,1,0,13,0,-13
42803,1,0,34,0,-34
42804,1,0,25,0,-25
42805,0,0,55,0,-55
42806,0,0,44,0,-44
42807,0,0,68,0,-68
42808,0,0,117,0,-117
42809,0,0,37,0,-37
42810,0,0,59,0,-59
42811,0,0,4,0,-4
42812,0,0,34,0,-34
42813,1,0,46,0,-46
42814,1,0,2,0,-2
42815,1,1,587,1312,725
42816,1,0,21,0,-21
42817,0,0,16,0,-16
42818,0,0,0,0,0
42819,1,1,2338,1493,-845
42820,1,0,48,0,-48
42821,1,1,162,1247,1085
42822,0,0,51,0,-51
42823,1,0,50,0,-50
42824,0,0,30,0,-30
42825,1,0,17,0,-17
42826,1,1,1193,1376,183
42827,1,1,836,1208,372
42828,0,0,77,0,-77
42829,1,0,3,0,-3
42830,1,1,1705,1452,-253
42831,1,1,231,1680,1449
42832,0,0,141,0,-141
42833,0,0,10,0,-10
42834,1,1,497,1411,914
42835,0,0,105,0,-105
42836,0,0,90,0,-90
42837,1,0,5,0,-5
42838,0,0,108,0,-108
42839,1,1,167,1226,1059
42840,0,0,27,0,-27
42841,0,0,11,0,-11
42842,0,0,138,0,-138
42843,0,0,3,0,-3
42844,1,1,23,1538,1515
42845,1,0,39,0,-39
42846,1,1,290,2320,2030
42847,1,0,21,0,-21
42848,0,0,25,0,-25
42849,1,1,368,1240,872
42850,1,1,370,1241,871
42851,0,0,52,0,-52
42852,0,0,28,0,-28
42853,0,0,10,0,-10
42854,1,1,590,1491,901
42855,1,0,76,0,-76
42856,0,0,47,0,-47
42857,1,0,6,0,-6
42858,1,1,513,1238,725
42859,1,1,624,1799,1175
42860,1,1,569,1517,948
42861,0,0,99,0,-99
42862,0,0,17,0,-17
42863,1,0,57,0,-57
42864,1,0,76,0,-76
42865,1,0,58,0,-58
42866,1,0,107,0,-107
42867,1,0,27,0,-27
42868,0,0,161,0,-161
42869,1,0,71,0,-71
42870,1,0,3,0,-3
42871,1,0,76,0,-76
42872,1,1,754,1588,834
42873,1,0,18,0,-18
42874,0,0,54,0,-54
42875,1,0,83,0,-83
42876,0,0,12,0,-12
42877,1,1,223,1316,1093
42878,1,1,769,1486,717
42879,1,1,927,1493,566
42880,1,0,108,0,-108
42881,1,1,318,1234,916
42882,1,1,940,1295,355
42883,1,1,1100,1671,571
42884,1,1,205,1731,1526
42885,0,0,6,0,-6
42886,0,0,69,0,-69
42887,1,1,204,1518,1314
42888,1,1,2199,1212,-987
42889,0,0,9,0,-9
42890,1,0,52,0,-52
42891,1,1,482,1251,769
42892,1,1,65,1704,1639
42893,1,0,331,0,-331
42894,1,1,591,1286,695
42895,1,0,50,0,-50
42896,1,0,11,0,-11
42897,1,0,20,0,-20
42898,1,1,657,2150,1493
42899,1,0,58,0,-58
42900,1,1,350,1566,1216
42901,0,0,25,0,-25
42902,0,0,16,0,-16
42903,0,0,4,0,-4
42904,1,1,223,1285,1062
42905,1,0,18,0,-18
42906,1,1,88,1590,1502
42907,1,0,78,0,-78
42908,0,0,2,0,-2
42909,1,0,27,0,-27
42910,0,0,75,0,-75
42911,0,0,54,0,-54
42912,1,0,34,0,-34
42913,1,0,105,0,-105
42914,1,1,6,1931,1925
42915,1,1,465,1290,825
42916,1,1,1070,1937,867
42917,1,0,58,0,-58
42918,1,0,16,0,-16
42919,0,0,5,0,-5
42920,1,0,3,0,-3
42921,0,0,38,0,-38
42922,0,0,171,0,-171
42923,1,0,27,0,-27
42924,0,0,56,0,-56
42925,1,0,31,0,-31
42926,1,1,98,1408,1310
42927,1,1,181,1438,1257
42928,1,1,504,1225,721
42929,1,1,1357,4333,2976
42930,0,0,15,0,-15
42931,1,0,142,0,-142
42932,0,0,11,0,-11
42933,1,1,619,1212,593
42934,0,0,127,0,-127
42935,1,0,12,0,-12
42936,0,0,43,0,-43
42937,1,1,284,1394,1110
42938,1,1,191,1965,1774
42939,1,0,51,0,-51
42940,1,1,248,1333,1085
42941,0,0,41,0,-41
42942,1,1,1195,1661,466
42943,1,1,196,1382,1186
42944,0,0,53,0,-53
42945,1,1,396,1452,1056
42946,1,0,9,0,-9
42947,1,1,1291,2402,1111
42948,1,0,7,0,-7
42949,1,0,62,0,-62
42950,0,0,423,0,-423
42951,0,0,99,0,-99
42952,1,1,1453,1386,-67
42953,1,0,72,0,-72
42954,0,0,5,0,-5
42955,0,0,10,0,-10
42956,0,0,24,0,-24
42957,1,0,74,0,-74
42958,1,1,1219,1245,26
42959,1,0,15,0,-15
42960,1,0,71,0,-71
42961,1,0,54,0,-54
42962,1,1,918,1270,352
42963,1,1,795,1634,839
42964,1,0,71,0,-71
42965,0,0,14,0,-14
42966,1,0,3,0,-3
42967,0,0,37,0,-37
42968,0,0,6,0,-6
42969,1,1,592,1334,742
42970,1,0,42,0,-42
42971,0,0,100,0,-100
42972,0,0,63,0,-63
42973,0,0,74,0,-74
42974,1,0,16,0,-16
42975,1,0,26,0,-26
42976,0,0,23,0,-23
42977,1,0,64,0,-64
42978,1,1,196,2723,2527
42979,1,0,18,0,-18
42980,1,0,24,0,-24
42981,0,0,35,0,-35
42982,1,0,89,0,-89
42983,0,0,67,0,-67
42984,0,0,20,0,-20
42985,0,0,6,0,-6
42986,1,1,213,1536,1323
42987,1,1,636,1553,917
42988,1,0,4,0,-4
42989,1,0,68,0,-68
42990,1,0,119,0,-119
42991,1,0,62,0,-62
42992,1,0,38,0,-38
42993,1,1,387,1735,1348
42994,0,0,174,0,-174
42995,1,0,242,0,-242
42996,0,0,9,0,-9
42997,1,1,311,1226,915
42998,0,0,89,0,-89
42999,1,0,4,0,-4
43000,1,0,63,0,-63
43001,1,0,100,0,-100
43002,1,1,273,1796,1523
43003,1,1,22,1390,1368
43004,0,0,23,0,-23
43005,1,1,578,1444,866
43006,1,0,72,0,-72
43007,1,0,46,0,-46
43008,1,1,519,1372,853
43009,0,0,3,0,-3
43010,1,1,1165,1227,62
43011,0,0,7,0,-7
43012,1,0,23,0,-23
43013,1,0,3,0,-3
43014,1,0,8,0,-8
43015,1,1,481,1287,806
43016,1,0,86,0,-86
43017,0,0,51,0,-51
43018,1,1,848,2470,1622
43019,1,0,15,0,-15
43020,0,0,25,0,-25
43021,0,0,84,0,-84
43022,0,0,86,0,-86
43023,1,0,55,0,-55
43024,1,0,45,0,-45
43025,0,0,1,0,-1
43026,0,0,35,0,-35
43027,0,0,129,0,-129
43028,0,0,66,0,-66
43029,1,1,565,1249,684
43030,0,0,15,0,-15
43031,1,0,67,0,-67
43032,1,0,0,0,0
43033,1,1,610,1390,780
43034,1,0,95,0,-95
43035,1,0,43,0,-43
43036,1,0,37,0,-37
43037,1,1,55,1303,1248
43038,1,0,4,0,-4
43039,0,0,24,0,-24
43040,1,1,282,1440,1158
43041,1,0,2,0,-2
43042,1,1,973,1425,452
43043,1,1,34,2401,2367
43044,0,0,64,0,-64
43045,1,0,28,0,-28
43046,0,0,13,0,-13
43047,1,0,42,0,-42
43048,1,0,38,0,-38
43049,0,0,20,0,-20
43050,0,0,53,0,-53
43051,0,0,29,0,-29
43052,0,0,9,0,-9
43053,0,0,89,0,-89
43054,1,0,87,0,-87
43055,0,0,28,0,-28
43056,0,0,79,0,-79
43057,1,1,1578,1705,127
43058,1,0,6,0,-6
43059,1,0,43,0,-43
43060,1,1,135,1424,1289
43061,0,0,34,0,-34
43062,1,0,34,0,-34
43063,1,1,155,2665,2510
43064,1,1,1211,1717,506
43065,0,0,26,0,-26
43066,1,1,384,1204,820
43067,0,0,37,0,-37
43068,1,1,732,1226,494
43069,1,0,137,0,-137
43070,0,0,103,0,-103
43071,1,0,99,0,-99
43072,1,0,85,0,-85
43073,0,0,0,0,0
43074,1,0,42,0,-42
43075,1,0,125,0,-125
43076,1,1,652,2173,1521
43077,0,0,131,0,-131
43078,1,0,3,0,-3
43079,0,0,4,0,-4
43080,0,0,161,0,-161
43081,0,0,102,0,-102
43082,1,1,181,1873,1692
43083,1,0,87,0,-87
43084,0,0,21,0,-21
43085,0,0,40,0,-40
43086,1,1,126,1234,1108
43087,1,0,35,0,-35
43088,1,0,34,0,-34
43089,1,0,135,0,-135
43090,1,0,72,0,-72
43091,0,0,119,0,-119
43092,1,0,102,0,-102
43093,1,0,33,0,-33
43094,1,0,165,0,-165
43095,1,1,229,1282,1053
43096,1,1,120,1429,1309
43097,1,1,1739,1442,-297
43098,1,1,20,1492,1472
43099,1,1,304,1227,923
43100,1,1,741,1462,721
43101,1,0,109,0,-109
43102,1,0,4,0,-4
43103,1,0,13,0,-13
43104,1,1,825,1446,621
43105,1,1,269,3026,2757
43106,1,1,208,1229,1021
43107,1,0,65,0,-65
43108,0,0,47,0,-47
43109,1,0,159,0,-159
43110,1,0,8,0,-8
43111,0,0,13,0,-13
43112,1,0,114,0,-114
43113,1,0,16,0,-16
43114,1,0,97,0,-97
43115,0,0,38,0,-38
43116,0,0,30,0,-30
43117,0,0,78,0,-78
43118,0,0,44,0,-44
43119,1,1,184,1408,1224
43120,0,0,37,0,-37
43121,1,1,308,1779,1471
43122,1,1,750,1228,478
43123,1,1,358,1546,1188
43124,0,0,58,0,-58
43125,1,1,396,1848,1452
43126,0,0,163,0,-163
43127,1,1,548,2005,1457
43128,1,0,3,0,-3
43129,0,0,29,0,-29
43130,0,0,36,0,-36
43131,1,1,193,1224,1031
43132,1,0,51,0,-51
43133,1,1,658,1367,709
43134,1,1,95,1348,1253
43135,1,0,6,0,-6
43136,1,0,67,0,-67
43137,0,0,96,0,-96
43138,0,0,222,0,-222
43139,1,1,188,1404,1216
43140,1,0,5,0,-5
43141,0,0,34,0,-34
43142,1,0,22,0,-22
43143,1,1,66,1305,1239
43144,1,1,498,1492,994
43145,1,1,908,1224,316
43146,1,0,89,0,-89
43147,1,1,1490,1795,305
43148,1,0,6,0,-6
43149,1,0,36,0,-36
43150,0,0,129,0,-129
43151,1,1,111,1259,1148
43152,1,1,314,1215,901
43153,0,0,68,0,-68
43154,1,0,25,0,-25
43155,1,0,9,0,-9
43156,0,0,10,0,-10
43157,1,1,1568,1456,-112
43158,1,0,15,0,-15
43159,1,1,302,1896,1594
43160,1,0,6,0,-6
43161,1,1,257,1216,959
43162,1,0,58,0,-58
43163,1,0,82,0,-82
43164,1,0,2,0,-2
43165,0,0,116,0,-116
43166,1,0,44,0,-44
43167,1,0,71,0,-71
43168,0,0,25,0,-25
43169,1,1,258,1302,1044
43170,0,0,75,0,-75
43171,0,0,47,0,-47
43172,0,0,29,0,-29
43173,1,1,258,1423,1165
43174,1,1,23,3643,3620
43175,0,0,176,0,-176
43176,1,1,478,1320,842
43177,1,1,126,1283,1157
43178,1,1,327,1290,963
43179,1,1,1721,1509,-212
43180,1,0,31,0,-31
43181,0,0,23,0,-23
43182,0,0,39,0,-39
43183,1,0,14,0,-14
43184,0,0,1,0,-1
43185,0,0,53,0,-53
43186,1,1,79,1201,1122
43187,1,1,279,2647,2368
43188,0,0,12,0,-12
43189,1,1,1598,1683,85
43190,1,1,1456,1310,-146
43191,0,0,78,0,-78
43192,1,0,41,0,-41
43193,0,0,9,0,-9
43194,0,0,34,0,-34
43195,1,1,1781,1287,-494
43196,1,0,68,0,-68
43197,0,0,197,0,-197
43198,1,0,12,0,-12
43199,1,0,41,0,-41
43200,1,0,31,0,-31
43201,1,1,86,1493,1407
43202,1,0,24,0,-24
43203,1,0,71,0,-71
43204,0,0,149,0,-149
43205,1,1,157,1733,1576
43206,0,0,69,0,-69
43207,0,0,8,0,-8
43208,1,1,661,1256,595
43209,1,1,376,1297,921
43210,0,0,38,0,-38
43211,1,0,60,0,-60
43212,1,0,55,0,-55
43213,0,0,5,0,-5
43214,0,0,54,0,-54
43215,1,0,17,0,-17
43216,1,0,26,0,-26
43217,1,0,70,0,-70
43218,0,0,51,0,-51
43219,0,0,30,0,-30
43220,1,1,162,1928,1766
43221,1,0,43,0,-43
43222,1,0,74,0,-74
43223,1,0,21,0,-21
43224,1,0,29,0,-29
43225,0,0,14,0,-14
43226,0,0,102,0,-102
43227,0,0,205,0,-205
43228,0,0,45,0,-45
43229,1,1,128,1328,1200
43230,0,0,9,0,-9
43231,0,0,58,0,-58
43232,1,0,11,0,-11
43233,1,0,148,0,-148
43234,1,0,0,0,0
43235,0,0,20,0,-20
43236,1,0,38,0,-38
43237,1,1,1288,1212,-76
43238,1,1,804,1761,957
43239,1,1,323,1421,1098
43240,1,0,3,0,-3
43241,1,1,180,1542,1362
43242,1,1,270,1734,1464
43243,0,0,8,0,-8
43244,0,0,0,0,0
43245,0,0,79,0,-79
43246,1,0,163,0,-163
43247,0,0,3,0,-3
43248,1,0,81,0,-81
43249,0,0,38,0,-38
43250,0,0,11,0,-11
43251,0,0,28,0,-28
43252,1,0,25,0,-25
43253,1,0,37,0,-37
43254,1,0,56,0,-56
43255,1,1,148,1281,1133
43256,1,0,1,0,-1
43257,1,1,940,1580,640
43258,1,0,64,0,-64
43259,1,1,131,1221,1090
43260,0,0,33,0,-33
43261,1,0,51,0,-51
43262,1,1,453,1556,1103
43263,1,0,27,0,-27
43264,1,0,38,0,-38
43265,1,1,462,1547,1085
43266,0,0,115,0,-115
43267,1,1,487,1429,942
43268,1,1,116,1768,1652
43269,0,0,5,0,-5
43270,1,1,36,1205,1169
43271,1,0,168,0,-168
43272,1,0,115,0,-115
43273,0,0,144,0,-144
43274,1,0,56,0,-56
43275,1,0,139,0,-139
43276,0,0,12,0,-12
43277,1,1,86,1272,1186
43278,1,0,10,0,-10
43279,1,1,980,2953,1973
43280,1,1,1209,1422,213
43281,0,0,93,0,-93
43282,1,0,37,0,-37
43283,0,0,47,0,-47
43284,1,1,305,1835,1530
43285,0,0,10,0,-10
43286,1,0,25,0,-25
43287,1,0,130,0,-130
43288,1,0,80,0,-80
43289,1,1,848,1392,544
43290,0,0,23,0,-23
43291,1,1,349,1344,995
43292,0,0,25,0,-25
43293,1,0,24,0,-24
43294,1,1,410,1732,1322
43295,1,0,52,0,-52
43296,1,1,306,1340,1034
43297,1,0,6,0,-6
43298,1,1,75,1551,1476
43299,1,0,13,0,-13
43300,1,1,1012,1649,637
43301,0,0,56,0,-56
43302,0,0,123,0,-123
43303,1,0,2,0,-2
43304,0,0,26,0,-26
43305,0,0,6,0,-6
43306,1,1,334,2047,1713
43307,1,1,813,1257,444
43308,1,0,97,0,-97
43309,0,0,0,0,0
43310,1,0,0,0,0
43311,1,1,1465,1431,-34
43312,0,0,13,0,-13
43313,1,1,753,1930,1177
43314,0,0,46,0,-46
43315,1,1,510,1254,744
43316,0,0,39,0,-39
43317,0,0,30,0,-30
43318,1,0,115,0,-115
43319,1,0,4,0,-4
43320,1,0,68,0,-68
43321,1,1,235,1465,1230
43322,0,0,69,0,-69
43323,0,0,64,0,-64
43324,0,0,22,0,-22
43325,1,1,533,1332,799
43326,1,0,32,0,-32
43327,0,0,20,0,-20
43328,1,1,1099,1307,208
43329,0,0,40,0,-40
43330,1,1,364,1400,1036
43331,1,1,1468,1352,-116
43332,1,1,194,1510,1316
43333,1,1,68,2214,2146
43334,0,0,5,0,-5
43335,0,0,13,0,-13
43336,1,0,73,0,-73
43337,1,0,13,0,-13
43338,0,0,241,0,-241
43339,1,0,21,0,-21
43340,1,0,7,0,-7
43341,1,1,135,1456,1321
43342,1,1,72,1242,1170
43343,0,0,41,0,-41
43344,0,0,3,0,-3
43345,0,0,344,0,-344
43346,1,0,119,0,-119
43347,0,0,4,0,-4
43348,1,0,29,0,-29
43349,1,1,288,1208,920
43350,1,0,13,0,-13
43351,0,0,66,0,-66
43352,1,1,23,1677,1654
43353,1,0,15,0,-15
43354,0,0,16,0,-16
43355,1,1,254,1249,995
43356,0,0,16,0,-16
43357,1,1,189,1593,1404
43358,0,0,62,0,-62
43359,1,1,2764,1237,-1527
43360,0,0,127,0,-127
43361,0,0,247,0,-247
43362,0,0,9,0,-9
43363,0,0,22,0,-22
43364,1,0,23,0,-23
43365,1,1,47,1547,1500
43366,0,0,13,0,-13
43367,1,0,15,0,-15
43368,1,0,22,0,-22
43369,0,0,17,0,-17
43370,0,0,78,0,-78
43371,0,0,48,0,-48
43372,1,0,11,0,-11
43373,1,0,49,0,-49
43374,1,0,2,0,-2
43375,1,1,130,1577,1447
43376,1,0,123,0,-123
43377,0,0,49,0,-49
43378,0,0,99,0,-99
43379,1,0,70,0,-70
43380,1,1,419,1298,879
43381,0,0,27,0,-27
43382,0,0,0,0,0
43383,1,0,39,0,-39
43384,0,0,3,0,-3
43385,1,0,1,0,-1
43386,0,0,0,0,0
43387,0,0,136,0,-136
43388,1,0,61,0,-61
43389,0,0,50,0,-50
43390,1,0,50,0,-50
43391,1,0,4,0,-4
43392,0,0,5,0,-5
43393,0,0,4,0,-4
43394,1,1,705,1343,638
43395,1,0,6,0,-6
43396,1,0,13,0,-13
43397,1,0,0,0,0
43398,1,1,1760,1231,-529
43399,1,0,7,0,-7
43400,0,0,28,0,-28
43401,0,0,78,0,-78
43402,0,0,91,0,-91
43403,1,1,353,1663,1310
43404,1,0,43,0,-43
43405,1,0,24,0,-24
43406,1,1,359,4104,3745
43407,1,0,108,0,-108
43408,0,0,18,0,-18
43409,1,1,325,1202,877
43410,0,0,11,0,-11
43411,1,0,43,0,-43
43412,1,1,421,1563,1142
43413,1,1,740,1506,766
43414,1,0,233,0,-233
43415,0,0,1,0,-1
43416,1,0,91,0,-91
43417,0,0,63,0,-63
43418,0,0,17,0,-17
43419,0,0,14,0,-14
43420,0,0,90,0,-90
43421,1,1,1160,1517,357
43422,1,1,47,2470,2423
43423,1,0,12,0,-12
43424,0,0,84,0,-84
43425,0,0,62,0,-62
43426,1,1,373,1766,1393
43427,0,0,5,0,-5
43428,1,0,0,0,0
43429,0,0,132,0,-132
43430,1,1,103,2015,1912
43431,0,0,59,0,-59
43432,0,0,29,0,-29
43433,1,1,668,1361,693
43434,1,1,88,1428,1340
43435,1,0,15,0,-15
43436,0,0,18,0,-18
43437,1,0,25,0,-25
43438,1,1,146,1281,1135
43439,0,0,60,0,-60
43440,1,0,11,0,-11
43441,1,1,144,1555,1411
43442,0,0,57,0,-57
43443,1,0,45,0,-45
43444,1,0,94,0,-94
43445,0,0,86,0,-86
43446,1,0,15,0,-15
43447,0,0,45,0,-45
43448,0,0,56,0,-56
43449,1,0,47,0,-47
43450,1,0,23,0,-23
43451,1,0,100,0,-100
43452,1,0,61,0,-61
43453,1,1,574,1741,1167
43454,0,0,159,0,-159
43455,0,0,45,0,-45
43456,0,0,52,0,-52
43457,0,0,118,0,-118
43458,1,1,62,1568,1506
43459,1,1,1333,1799,466
43460,1,0,69,0,-69
43461,1,1,68,1550,1482
43462,1,1,277,1399,1122
43463,1,0,18,0,-18
43464,0,0,45,0,-45
43465,1,1,248,1419,1171
43466,0,0,2,0,-2
43467,1,0,278,0,-278
43468,1,1,910,1748,838
43469,0,0,96,0,-96
43470,1,1,456,1206,750
43471,1,0,39,0,-39
43472,0,0,51,0,-51
43473,0,0,7,0,-7
43474,1,1,249,1466,1217
43475,0,0,28,0,-28
43476,1,0,3,0,-3
43477,0,0,35,0,-35
43478,0,0,45,0,-45
43479,1,1,1445,1275,-170
43480,1,0,45,0,-45
43481,0,0,238,0,-238
43482,0,0,2,0,-2
43483,1,1,248,1382,1134
43484,0,0,52,0,-52
43485,1,1,82,1668,1586
43486,1,1,354,1685,1331
43487,0,0,39,0,-39
43488,0,0,69,0,-69
43489,0,0,14,0,-14
43490,1,1,400,1676,1276
43491,1,0,47,0,-47
43492,1,0,72,0,-72
43493,0,0,18,0,-18
43494,1,1,271,1399,1128
43495,1,1,579,1278,699
43496,1,0,25,0,-25
43497,0,0,70,0,-70
43498,0,0,173,0,-173
43499,1,0,20,0,-20
43500,0,0,259,0,-259
43501,1,1,1287,1289,2
43502,0,0,8,0,-8
43503,0,0,143,0,-143
43504,1,1,255,1505,1250
43505,1,0,56,0,-56
43506,0,0,154,0,-154
43507,1,1,1516,2469,953
43508,1,1,377,1426,1049
43509,1,1,285,1474,1189
43510,1,1,419,1769,1350
43511,1,0,101,0,-101
43512,1,1,489,1280,791
43513,1,1,389,1280,891
43514,0,0,34,0,-34
43515,1,1,670,1363,693
43516,0,0,119,0,-119
43517,1,1,203,1267,1064
43518,1,1,1105,2485,1380
43519,0,0,166,0,-166
43520,1,1,410,1308,898
43521,1,1,1158,1300,142
43522,1,1,761,1269,508
43523,1,0,8,0,-8
43524,1,0,5,0,-5
43525,0,0,1,0,-1
43526,0,0,124,0,-124
43527,0,0,119,0,-119
43528,1,0,51,0,-51
43529,0,0,39,0,-39
43530,1,1,555,1222,667
43531,0,0,84,0,-84
43532,1,0,3,0,-3
43533,1,0,72,0,-72
43534,1,1,1138,1256,118
43535,1,1,231,1323,1092
43536,0,0,297,0,-297
43537,1,1,251,1435,1184
43538,1,0,43,0,-43
43539,1,1,214,1880,1666
43540,1,1,318,1209,891
43541,1,1,73,2280,2207
43542,1,1,486,1989,1503
43543,1,0,8,0,-8
43544,1,0,92,0,-92
43545,0,0,7,0,-7
43546,1,0,76,0,-76
43547,1,0,103,0,-103
43548,1,1,456,1322,866
43549,0,0,25,0,-25
43550,0,0,9,0,-9
43551,1,1,350,1275,925
43552,1,0,37,0,-37
43553,0,0,21,0,-21
43554,1,0,57,0,-57
43555,0,0,38,0,-38
43556,1,1,1604,1546,-58
43557,1,0,62,0,-62
43558,0,0,1,0,-1
43559,0,0,32,0,-32
43560,0,0,118,0,-118
43561,0,0,132,0,-132
43562,1,1,363,2833,2470
43563,0,0,0,0,0
43564,1,1,198,1955,1757
43565,1,0,8,0,-8
43566,0,0,9,0,-9
43567,0,0,5,0,-5
43568,1,1,385,1363,978
43569,0,0,104,0,-104
43570,0,0,3,0,-3
43571,1,0,83,0,-83
43572,1,0,81,0,-81
43573,1,1,960,1498,538
43574,1,0,104,0,-104
43575,0,0,139,0,-139
43576,0,0,12,0,-12
43577,0,0,32,0,-32
43578,1,0,11,0,-11
43579,1,0,69,0,-69
43580,0,0,8,0,-8
43581,1,0,12,0,-12
43582,0,0,17,0,-17
43583,1,1,1076,1400,324
43584,1,0,47,0,-47
43585,1,0,72,0,-72
43586,1,1,1563,1279,-284
43587,0,0,5,0,-5
43588,1,1,82,1827,1745
43589,1,0,18,0,-18
43590,1,1,185,1565,1380
43591,1,1,266,1284,1018
43592,1,0,20,0,-20
43593,1,0,37,0,-37
43594,0,0,69,0,-69
43595,0,0,50,0,-50
43596,0,0,9,0,-9
43597,0,0,70,0,-70
43598,1,0,153,0,-153
43599,0,0,27,0,-27
43600,0,0,32,0,-32
43601,1,0,10,0,-10
43602,0,0,1,0,-1
43603,1,1,408,1653,1245
43604,1,1,1201,1213,12
43605,1,1,1757,1724,-33
43606,1,0,59,0,-59
43607,1,0,8,0,-8
43608,0,0,14,0,-14
43609,0,0,120,0,-120
43610,1,0,3,0,-3
43611,0,0,57,0,-57
43612,1,0,264,0,-264
43613,0,0,20,0,-20
43614,0,0,41,0,-41
43615,0,0,74,0,-74
43616,1,1,2461,1284,-1177
43617,1,1,168,1229,1061
43618,1,0,67,0,-67
43619,1,0,40,0,-40
43620,1,1,1416,1283,-133
43621,1,0,37,0,-37
43622,0,0,41,0,-41
43623,1,1,913,1848,935
43624,0,0,152,0,-152
43625,0,0,9,0,-9
43626,1,1,565,1641,1076
43627,1,0,71,0,-71
43628,1,0,5,0,-5
43629,0,0,0,0,0
43630,1,0,60,0,-60
43631,0,0,26,0,-26
43632,1,0,325,0,-325
43633,0,0,184,0,-184
43634,0,0,28,0,-28
43635,1,1,901,1275,374
43636,1,1,961,1200,239
43637,1,0,22,0,-22
43638,0,0,38,0,-38
43639,1,1,1110,1232,122
43640,0,0,17,0,-17
43641,1,1,566,1336,770
43642,1,0,8,0,-8
43643,0,0,7,0,-7
43644,1,1,1273,2942,1669
43645,0,0,48,0,-48
43646,0,0,76,0,-76
43647,1,0,103,0,-103
43648,0,0,67,0,-67
43649,1,0,20,0,-20
43650,1,1,392,1492,1100
43651,0,0,26,0,-26
43652,0,0,13,0,-13
43653,0,0,28,0,-28
43654,1,0,78,0,-78
43655,1,1,1001,2085,1084
43656,0,0,14,0,-14
43657,1,1,176,1672,1496
43658,1,0,17,0,-17
43659,1,0,119,0,-119
43660,1,0,87,0,-87
43661,0,0,54,0,-54
43662,1,1,334,1323,989
43663,1,0,20,0,-20
43664,1,0,21,0,-21
43665,0,0,38,0,-38
43666,0,0,46,0,-46
43667,1,0,33,0,-33
43668,1,0,208,0,-208
43669,1,0,90,0,-90
43670,0,0,98,0,-98
43671,1,1,737,1377,640
43672,0,0,32,0,-32
43673,1,0,12,0,-12
43674,1,0,29,0,-29
43675,1,0,19,0,-19
43676,1,0,76,0,-76
43677,1,1,186,1931,1745
43678,1,1,269,1274,1005
43679,0,0,9,0,-9
43680,1,0,32,0,-32
43681,1,0,21,0,-21
43682,1,0,11,0,-11
43683,0,0,31,0,-31
43684,1,1,222,1753,1531
43685,0,0,40,0,-40
43686,1,0,98,0,-98
43687,1,1,345,1419,1074
43688,0,0,3,0,-3
43689,1,1,350,1300,950
43690,0,0,9,0,-9
43691,1,1,1370,1966,596
43692,0,0,10,0,-10
43693,1,0,98,0,-98
43694,1,1,598,1390,792
43695,0,0,21,0,-21
43696,1,1,82,1248,1166
43697,1,0,48,0,-48
43698,1,1,859,1898,1039
43699,1,1,1046,1308,262
43700,1,1,1748,2260,512
43701,1,0,3,0,-3
43702,1,0,24,0,-24
43703,0,0,152,0,-152
43704,1,0,65,0,-65
43705,0,0,70,0,-70
43706,0,0,34,0,-34
43707,1,0,47,0,-47
43708,1,0,18,0,-18
43709,1,1,162,1733,1571
43710,1,0,15,0,-15
43711,1,0,21,0,-21
43712,1,0,54,0,-54
43713,1,0,48,0,-48
43714,1,1,302,2019,1717
43715,1,0,10,0,-10
43716,1,0,2,0,-2
43717,1,1,26,1229,1203
43718,0,0,29,0,-29
43719,0,0,0,0,0
43720,1,1,1789,1292,-497
43721,0,0,58,0,-58
43722,0,0,88,0,-88
43723,0,0,62,0,-62
43724,1,1,166,1282,1116
43725,0,0,13,0,-13
43726,0,0,15,0,-15
43727,0,0,26,0,-26
43728,0,0,38,0,-38
43729,1,0,38,0,-38
43730,1,0,16,0,-16
43731,1,1,503,1923,1420
43732,1,1,1058,1799,741
43733,1,0,106,0,-106
43734,0,0,44,0,-44
43735,0,0,38,0,-38
43736,1,0,27,0,-27
43737,0,0,35,0,-35
43738,1,0,7,0,-7
43739,1,1,283,1311,1028
43740,1,0,9,0,-9
43741,1,0,39,0,-39
43742,0,0,12,0,-12
43743,1,0,44,0,-44
43744,1,0,57,0,-57
43745,1,1,287,1289,1002
43746,0,0,146,0,-146
43747,0,0,15,0,-15
43748,1,0,14,0,-14
43749,0,0,14,0,-14
43750,1,0,10,0,-10
43751,0,0,108,0,-108
43752,1,0,25,0,-25
43753,1,1,321,1201,880
43754,0,0,1,0,-1
43755,0,0,8,0,-8
43756,1,0,109,0,-109
43757,1,1,425,2064,1639
43758,1,0,12,0,-12
43759,0,0,85,0,-85
43760,1,0,93,0,-93
43761,1,1,743,1375,632
43762,0,0,47,0,-47
43763,1,0,34,0,-34
43764,0,0,198,0,-198
43765,0,0,18,0,-18
43766,0,0,41,0,-41
43767,0,0,101,0,-101
43768,0,0,13,0,-13
43769,1,1,225,1441,1216
43770,0,0,144,0,-144
43771,0,0,38,0,-38
43772,0,0,43,0,-43
43773,1,0,0,0,0
43774,1,1,110,2217,2107
43775,1,0,42,0,-42
43776,0,0,80,0,-80
43777,0,0,160,0,-160
43778,0,0,67,0,-67
43779,0,0,62,0,-62
43780,0,0,171,0,-171
43781,1,1,77,1444,1367
43782,1,1,824,1386,562
43783,1,0,17,0,-17
43784,1,0,14,0,-14
43785,0,0,29,0,-29
43786,0,0,94,0,-94
43787,1,0,172,0,-172
43788,1,0,63,0,-63
43789,1,1,317,3550,3233
43790,1,1,1268,1288,20
43791,0,0,7,0,-7
43792,1,0,3,0,-3
43793,0,0,15,0,-15
43794,1,0,68,0,-68
43795,0,0,16,0,-16
43796,0,0,3,0,-3
43797,0,0,133,0,-133
43798,1,0,39,0,-39
43799,0,0,16,0,-16
43800,0,0,90,0,-90
43801,0,0,12,0,-12
43802,1,0,37,0,-37
43803,0,0,43,0,-43
43804,0,0,48,0,-48
43805,1,0,7,0,-7
43806,1,1,8,1635,1627
43807,0,0,41,0,-41
43808,1,0,29,0,-29
43809,1,0,63,0,-63
43810,1,0,27,0,-27
43811,1,0,4,0,-4
43812,1,1,466,1657,1191
43813,0,0,7,0,-7
43814,0,0,36,0,-36
43815,0,0,70,0,-70
43816,1,1,98,1965,1867
43817,1,1,966,1910,944
43818,0,0,58,0,-58
43819,1,0,59,0,-59
43820,1,1,449,1501,1052
43821,0,0,4,0,-4
43822,1,0,37,0,-37
43823,1,1,526,1711,1185
43824,0,0,117,0,-117
43825,1,0,72,0,-72
43826,0,0,81,0,-81
43827,0,0,34,0,-34
43828,0,0,21,0,-21
43829,1,1,428,1218,790
43830,1,0,45,0,-45
43831,0,0,112,0,-112
43832,1,1,513,1477,964
43833,1,1,625,1292,667
43834,1,0,158,0,-158
43835,1,1,834,1826,992
43836,0,0,21,0,-21
43837,1,0,15,0,-15
43838,0,0,37,0,-37
43839,0,0,5,0,-5
43840,1,0,7,0,-7
43841,1,1,483,1368,885
43842,1,0,174,0,-174
43843,1,0,28,0,-28
43844,0,0,110,0,-110
43845,1,0,133,0,-133
43846,1,0,42,0,-42
43847,1,0,6,0,-6
43848,1,0,85,0,-85
43849,0,0,79,0,-79
43850,0,0,98,0,-98
43851,0,0,4,0,-4
43852,0,0,9,0,-9
43853,1,0,3,0,-3
43854,0,0,6,0,-6
43855,0,0,5,0,-5
43856,0,0,12,0,-12
43857,1,1,743,1204,461
43858,1,1,60,1259,1199
43859,0,0,177,0,-177
43860,1,0,88,0,-88
43861,0,0,17,0,-17
43862,1,0,16,0,-16
43863,1,0,72,0,-72
43864,1,1,590,1287,697
43865,0,0,3,0,-3
43866,1,0,2,0,-2
43867,1,0,80,0,-80
43868,1,0,129,0,-129
43869,0,0,20,0,-20
43870,0,0,43,0,-43
43871,1,1,130,1302,1172
43872,1,1,802,1201,399
43873,0,0,12,0,-12
43874,1,0,70,0,-70
43875,0,0,20,0,-20
43876,1,0,40,0,-40
43877,1,1,48,1528,1480
43878,1,1,319,1553,1234
43879,1,1,172,1202,1030
43880,1,1,182,1594,1412
43881,1,0,14,0,-14
43882,0,0,20,0,-20
43883,1,0,56,0,-56
43884,0,0,180,0,-180
43885,0,0,48,0,-48
43886,1,1,119,1235,1116
43887,0,0,77,0,-77
43888,0,0,44,0,-44
43889,1,1,839,1477,638
43890,1,0,10,0,-10
43891,0,0,62,0,-62
43892,1,1,1324,1822,498
43893,1,0,0,0,0
43894,1,1,1065,1394,329
43895,0,0,53,0,-53
43896,1,1,88,1266,1178
43897,1,0,39,0,-39
43898,1,1,273,1740,1467
43899,1,0,17,0,-17
43900,0,0,16,0,-16
43901,1,0,50,0,-50
43902,1,0,5,0,-5
43903,1,1,164,1262,1098
43904,0,0,26,0,-26
43905,0,0,12,0,-12
43906,1,1,502,1439,937
43907,0,0,20,0,-20
43908,1,0,68,0,-68
43909,1,1,421,1592,1171
43910,1,1,917,1282,365
43911,0,0,189,0,-189
43912,1,0,53,0,-53
43913,0,0,10,0,-10
43914,1,1,1360,1927,567
43915,1,0,46,0,-46
43916,1,0,215,0,-215
43917,1,0,8,0,-8
43918,0,0,5,0,-5
43919,0,0,63,0,-63
43920,1,0,17,0,-17
43921,0,0,43,0,-43
43922,1,0,1,0,-1
43923,1,1,375,2059,1684
43924,0,0,21,0,-21
43925,0,0,4,0,-4
43926,1,1,342,1398,1056
43927,0,0,2,0,-2
43928,1,0,26,0,-26
43929,1,0,0,0,0
43930,1,1,672,1509,837
43931,1,1,2443,1234,-1209
43932,0,0,40,0,-40
43933,0,0,15,0,-15
43934,0,0,67,0,-67
43935,0,0,90,0,-90
43936,1,0,48,0,-48
43937,0,0,21,0,-21
43938,0,0,141,0,-141
43939,0,0,12,0,-12
43940,1,1,677,1812,1135
43941,0,0,81,0,-81
43942,1,1,1101,1744,643
43943,1,1,93,1524,1431
43944,1,0,53,0,-53
43945,1,1,1142,18393,17251
43946,1,1,540,2419,1879
43947,0,0,23,0,-23
43948,0,0,49,0,-49
43949,0,0,17,0,-17
43950,1,0,25,0,-25
43951,1,1,264,1392,1128
43952,0,0,24,0,-24
43953,0,0,0,0,0
43954,0,0,99,0,-99
43955,1,0,58,0,-58
43956,1,0,24,0,-24
43957,1,0,6,0,-6
43958,1,1,81,1270,1189
43959,0,0,1,0,-1
43960,0,0,214,0,-214
43961,1,1,495,1239,744
43962,0,0,11,0,-11
43963,1,1,916,1450,534
43964,1,1,470,1305,835
43965,0,0,82,0,-82
43966,1,1,639,1424,785
43967,1,0,6,0,-6
43968,1,0,32,0,-32
43969,1,1,150,1328,1178
43970,1,0,100,0,-100
43971,1,0,15,0,-15
43972,1,0,44,0,-44
43973,1,0,65,0,-65
43974,1,0,76,0,-76
43975,1,0,245,0,-245
43976,1,1,206,1360,1154
43977,0,0,35,0,-35
43978,1,0,46,0,-46
43979,1,1,350,1244,894
43980,1,0,20,0,-20
43981,1,1,244,2130,1886
43982,0,0,18,0,-18
43983,1,1,568,1497,929
43984,1,0,13,0,-13
43985,0,0,16,0,-16
43986,1,0,1,0,-1
43987,1,0,10,0,-10
43988,1,1,197,1222,1025
43989,1,1,297,1754,1457
43990,1,0,43,0,-43
43991,0,0,88,0,-88
43992,1,0,25,0,-25
43993,0,0,92,0,-92
43994,0,0,1,0,-1
43995,1,1,565,1229,664
43996,1,1,194,1955,1761
43997,1,1,1140,1224,84
43998,1,1,645,1306,661
43999,1,0,29,0,-29
44000,1,1,605,1409,804
44001,1,1,645,2350,1705
44002,0,0,9,0,-9
44003,1,0,18,0,-18
44004,0,0,11,0,-11
44005,1,0,122,0,-122
44006,1,0,10,0,-10
44007,1,1,2045,1272,-773
44008,1,0,71,0,-71
44009,0,0,7,0,-7
44010,0,0,6,0,-6
44011,1,1,634,1340,706
44012,1,0,14,0,-14
44013,0,0,117,0,-117
44014,0,0,108,0,-108
44015,1,1,2072,2125,53
44016,1,0,29,0,-29
44017,1,1,174,1331,1157
44018,1,1,282,1479,1197
44019,1,1,348,2367,2019
44020,1,1,651,1875,1224
44021,1,1,947,1535,588
44022,0,0,236,0,-236
44023,1,1,56,1905,1849
44024,1,0,10,0,-10
44025,0,0,44,0,-44
44026,1,0,23,0,-23
44027,1,1,239,1263,1024
44028,0,0,54,0,-54
44029,1,0,52,0,-52
44030,0,0,97,0,-97
44031,1,0,59,0,-59
44032,1,0,26,0,-26
44033,1,1,859,1289,430
44034,1,0,31,0,-31
44035,1,1,109,1322,1213
44036,1,0,118,0,-118
44037,0,0,13,0,-13
44038,1,0,0,0,0
44039,0,0,6,0,-6
44040,1,0,29,0,-29
44041,0,0,46,0,-46
44042,0,0,2,0,-2
44043,0,0,94,0,-94
44044,1,1,430,2441,2011
44045,0,0,3,0,-3
44046,1,1,1370,1459,89
44047,1,1,581,1668,1087
44048,1,1,336,1335,999
44049,1,1,227,1843,1616
44050,1,0,15,0,-15
44051,1,0,55,0,-55
44052,1,0,13,0,-13
44053,1,0,55,0,-55
44054,1,0,146,0,-146
44055,1,1,306,1399,1093
44056,1,0,220,0,-220
44057,1,0,14,0,-14
44058,0,0,82,0,-82
44059,0,0,62,0,-62
44060,0,0,46,0,-46
44061,1,1,182,2301,2119
44062,1,0,195,0,-195
44063,1,0,86,0,-86
44064,0,0,17,0,-17
44065,1,0,124,0,-124
44066,1,1,1698,1208,-490
44067,1,0,76,0,-76
44068,0,0,6,0,-6
44069,0,0,12,0,-12
44070,0,0,47,0,-47
44071,1,0,35,0,-35
44072,0,0,8,0,-8
44073,1,0,449,0,-449
44074,1,1,672,1740,1068
44075,1,0,58,0,-58
44076,1,1,2609,1211,-1398
44077,1,0,9,0,-9
44078,1,0,38,0,-38
44079,0,0,106,0,-106
44080,1,0,123,0,-123
44081,0,0,32,0,-32
44082,1,0,38,0,-38
44083,1,0,17,0,-17
44084,1,0,0,0,0
44085,1,1,447,1341,894
44086,1,1,784,1318,534
44087,1,0,20,0,-20
44088,1,1,815,2447,1632
44089,1,1,546,1259,713
44090,1,0,123,0,-123
44091,1,1,203,1426,1223
44092,0,0,71,0,-71
44093,1,1,125,1797,1672
44094,1,1,116,1908,1792
44095,1,1,131,1364,1233
44096,1,1,12,1243,1231
44097,1,0,47,0,-47
44098,0,0,19,0,-19
44099,0,0,37,0,-37
44100,1,1,890,1335,445
44101,1,1,266,1286,1020
44102,1,1,701,1323,622
44103,1,1,274,1656,1382
44104,1,0,57,0,-57
44105,0,0,63,0,-63
44106,0,0,14,0,-14
44107,1,1,91,1619,1528
44108,1,0,16,0,-16
44109,0,0,97,0,-97
44110,1,1,553,1719,1166
44111,1,1,222,1764,1542
44112,0,0,66,0,-66
44113,0,0,119,0,-119
44114,0,0,125,0,-125
44115,1,1,576,1262,686
44116,0,0,42,0,-42
44117,0,0,18,0,-18
44118,0,0,35,0,-35
44119,0,0,102,0,-102
44120,0,0,0,0,0
44121,1,1,809,1369,560
44122,1,0,20,0,-20
44123,1,1,763,1215,452
44124,1,1,384,1323,939
44125,1,0,4,0,-4
44126,0,0,27,0,-27
44127,0,0,33,0,-33
44128,1,0,4,0,-4
44129,0,0,10,0,-10
44130,0,0,64,0,-64
44131,0,0,56,0,-56
44132,1,1,122,1214,1092
44133,1,1,203,1309,1106
44134,1,0,24,0,-24
44135,0,0,12,0,-12
44136,1,1,374,2496,2122
44137,1,1,280,1234,954
44138,1,1,155,1426,1271
44139,0,0,54,0,-54
44140,1,0,24,0,-24
44141,0,0,31,0,-31
44142,1,1,626,1898,1272
44143,1,0,3,0,-3
44144,1,1,14,1350,1336
44145,1,1,1229,1391,162
44146,1,1,833,1293,460
44147,0,0,49,0,-49
44148,0,0,0,0,0
44149,0,0,70,0,-70
44150,1,0,47,0,-47
44151,0,0,158,0,-158
44152,1,0,149,0,-149
44153,1,1,346,1353,1007
44154,0,0,169,0,-169
44155,0,0,4,0,-4
44156,1,0,60,0,-60
44157,1,0,13,0,-13
44158,1,1,633,1330,697
44159,1,0,17,0,-17
44160,1,0,4,0,-4
44161,1,1,21,1262,1241
44162,1,1,975,1203,228
44163,1,0,77,0,-77
44164,1,0,1,0,-1
44165,1,0,40,0,-40
44166,0,0,113,0,-113
44167,0,0,100,0,-100
44168,1,0,33,0,-33
44169,1,1,66,1387,1321
44170,1,0,21,0,-21
44171,1,0,21,0,-21
44172,1,0,26,0,-26
44173,1,1,561,1381,820
44174,0,0,46,0,-46
44175,0,0,16,0,-16
44176,1,1,418,1429,1011
44177,1,0,118,0,-118
44178,0,0,53,0,-53
44179,1,1,87,1251,1164
44180,1,1,125,1415,1290
44181,1,0,43,0,-43
44182,1,1,607,1203,596
44183,1,1,212,1505,1293
44184,1,0,54,0,-54
44185,1,1,1043,1766,723
44186,0,0,85,0,-85
44187,1,0,199,0,-199
44188,1,0,133,0,-133
44189,0,0,81,0,-81
44190,1,1,280,1981,1701
44191,1,1,638,1755,1117
44192,1,1,288,1295,1007
44193,1,0,17,0,-17
44194,1,1,349,1838,1489
44195,1,1,439,1239,800
44196,1,0,28,0,-28
44197,0,0,40,0,-40
44198,1,1,219,1642,1423
44199,0,0,40,0,-40
44200,1,0,14,0,-14
44201,1,1,245,1262,1017
44202,1,0,20,0,-20
44203,1,0,28,0,-28
44204,1,1,463,1742,1279
44205,1,0,32,0,-32
44206,1,1,168,1274,1106
44207,1,1,448,1202,754
44208,1,0,254,0,-254
44209,1,1,765,1529,764
44210,1,1,151,1542,1391
44211,0,0,25,0,-25
44212,0,0,31,0,-31
44213,1,0,52,0,-52
44214,0,0,94,0,-94
44215,0,0,46,0,-46
44216,0,0,102,0,-102
44217,1,0,68,0,-68
44218,1,0,126,0,-126
44219,0,0,30,0,-30
44220,1,0,13,0,-13
44221,0,0,18,0,-18
44222,1,1,61,1319,1258
44223,1,0,26,0,-26
44224,1,1,416,1303,887
44225,1,0,133,0,-133
44226,1,1,197,1217,1020
44227,0,0,7,0,-7
44228,0,0,2,0,-2
44229,1,1,62,1272,1210
44230,1,0,173,0,-173
44231,1,1,335,1625,1290
44232,0,0,7,0,-7
44233,0,0,17,0,-17
44234,1,1,295,1222,927
44235,1,1,234,1284,1050
44236,1,1,604,1669,1065
44237,1,1,696,1440,744
44238,0,0,5,0,-5
44239,1,1,1078,1445,367
44240,1,0,50,0,-50
44241,0,0,33,0,-33
44242,0,0,132,0,-132
44243,1,0,40,0,-40
44244,0,0,20,0,-20
44245,0,0,90,0,-90
44246,0,0,22,0,-22
44247,1,0,55,0,-55
44248,0,0,101,0,-101
44249,1,1,212,2921,2709
44250,1,1,388,1382,994
44251,0,0,26,0,-26
44252,0,0,71,0,-71
44253,0,0,27,0,-27
44254,1,0,4,0,-4
44255,1,0,21,0,-21
44256,1,1,396,1251,855
44257,1,0,35,0,-35
44258,0,0,64,0,-64
44259,0,0,113,0,-113
44260,1,1,194,1266,1072
44261,0,0,206,0,-206
44262,1,0,59,0,-59
44263,1,1,230,1338,1108
44264,0,0,173,0,-173
44265,1,0,167,0,-167
44266,1,0,62,0,-62
44267,0,0,67,0,-67
44268,1,1,254,2144,1890
44269,1,0,22,0,-22
44270,0,0,44,0,-44
44271,1,0,45,0,-45
44272,1,1,630,1429,799
44273,1,0,13,0,-13
44274,1,1,112,2838,2726
44275,1,0,13,0,-13
44276,1,0,85,0,-85
44277,0,0,19,0,-19
44278,1,1,772,1215,443
44279,1,0,47,0,-47
44280,1,1,214,1319,1105
44281,1,0,79,0,-79
44282,0,0,27,0,-27
44283,1,0,99,0,-99
44284,1,1,201,1430,1229
44285,1,0,5,0,-5
44286,1,0,113,0,-113
44287,1,0,87,0,-87
44288,1,1,309,1245,936
44289,1,1,631,1413,782
44290,1,0,132,0,-132
44291,0,0,28,0,-28
44292,0,0,30,0,-30
44293,1,1,238,1245,1007
44294,1,1,726,1775,1049
44295,0,0,44,0,-44
44296,1,1,706,1816,1110
44297,1,1,1638,1225,-413
44298,1,0,53,0,-53
44299,1,1,527,1245,718
44300,1,1,373,2176,1803
44301,0,0,2,0,-2
44302,1,0,113,0,-113
44303,0,0,107,0,-107
44304,1,1,567,1453,886
44305,0,0,47,0,-47
44306,0,0,8,0,-8
44307,1,1,231,1297,1066
44308,0,0,66,0,-66
44309,1,1,784,1290,506
44310,0,0,108,0,-108
44311,1,1,964,1722,758
44312,1,1,48,1309,1261
44313,1,1,277,1495,1218
44314,1,1,232,1745,1513
44315,1,0,8,0,-8
44316,1,1,1165,1249,84
44317,0,0,20,0,-20
44318,0,0,13,0,-13
44319,0,0,55,0,-55
44320,0,0,73,0,-73
44321,1,0,8,0,-8
44322,0,0,15,0,-15
44323,1,1,442,1257,815
44324,0,0,0,0,0
44325,0,0,59,0,-59
44326,0,0,31,0,-31
44327,1,0,29,0,-29
44328,0,0,21,0,-21
44329,0,0,23,0,-23
44330,0,0,96,0,-96
44331,0,0,67,0,-67
44332,1,0,22,0,-22
44333,0,0,42,0,-42
44334,1,1,215,1580,1365
44335,1,0,25,0,-25
44336,1,0,102,0,-102
44337,1,1,197,2275,2078
44338,1,0,83,0,-83
44339,1,0,78,0,-78
44340,0,0,0,0,0
44341,0,0,158,0,-158
44342,0,0,59,0,-59
44343,1,1,1713,1472,-241
44344,1,1,301,1319,1018
44345,1,0,40,0,-40
44346,1,0,40,0,-40
44347,1,0,51,0,-51
44348,0,0,30,0,-30
44349,1,0,236,0,-236
44350,1,1,557,2259,1702
44351,0,0,21,0,-21
44352,0,0,143,0,-143
44353,1,1,323,1762,1439
44354,1,1,198,1675,1477
44355,1,0,169,0,-169
44356,1,0,55,0,-55
44357,1,0,5,0,-5
44358,1,1,804,1454,650
44359,1,1,341,1296,955
44360,0,0,23,0,-23
44361,1,0,0,0,0
44362,1,0,89,0,-89
44363,1,0,42,0,-42
44364,1,0,13,0,-13
44365,1,0,73,0,-73
44366,0,0,13,0,-13
44367,0,0,16,0,-16
44368,0,0,31,0,-31
44369,1,1,449,1218,769
44370,0,0,8,0,-8
44371,1,1,194,1658,1464
44372,0,0,42,0,-42
44373,0,0,58,0,-58
44374,0,0,92,0,-92
44375,0,0,50,0,-50
44376,1,1,155,1210,1055
44377,0,0,10,0,-10
44378,0,0,133,0,-133
44379,1,1,359,1567,1208
44380,1,0,46,0,-46
44381,1,1,1872,1847,-25
44382,1,1,898,1270,372
44383,1,1,537,1461,924
44384,0,0,1,0,-1
44385,0,0,17,0,-17
44386,1,0,47,0,-47
44387,0,0,19,0,-19
44388,0,0,71,0,-71
44389,1,0,3,0,-3
44390,1,1,232,1398,1166
44391,1,0,15,0,-15
44392,0,0,40,0,-40
44393,0,0,148,0,-148
44394,1,0,10,0,-10
44395,0,0,13,0,-13
44396,0,0,30,0,-30
44397,1,0,62,0,-62
44398,1,0,133,0,-133
44399,0,0,59,0,-59
44400,0,0,42,0,-42
44401,0,0,8,0,-8
44402,1,0,36,0,-36
44403,0,0,90,0,-90
44404,0,0,12,0,-12
44405,1,1,1131,1218,87
44406,1,1,200,1745,1545
44407,1,0,39,0,-39
44408,1,1,128,1271,1143
44409,0,0,78,0,-78
44410,0,0,164,0,-164
44411,1,0,120,0,-120
44412,1,0,178,0,-178
44413,0,0,61,0,-61
44414,1,1,926,1387,461
44415,1,1,205,1330,1125
44416,1,0,32,0,-32
44417,1,0,162,0,-162
44418,0,0,28,0,-28
44419,0,0,0,0,0
44420,0,0,45,0,-45
44421,1,1,433,1234,801
44422,1,1,455,1248,793
44423,1,0,40,0,-40
44424,0,0,46,0,-46
44425,1,0,20,0,-20
44426,0,0,20,0,-20
44427,0,0,99,0,-99
44428,1,0,68,0,-68
44429,0,0,104,0,-104
44430,1,0,46,0,-46
44431,1,0,39,0,-39
44432,1,0,97,0,-97
44433,1,0,45,0,-45
44434,0,0,134,0,-134
44435,0,0,30,0,-30
44436,0,0,30,0,-30
44437,1,0,108,0,-108
44438,1,0,75,0,-75
44439,1,1,407,1200,793
44440,0,0,34,0,-34
44441,0,0,59,0,-59
44442,1,1,952,1316,364
44443,0,0,16,0,-16
44444,1,0,9,0,-9
44445,1,1,381,1314,933
44446,1,0,5,0,-5
44447,1,1,1299,2618,1319
44448,1,1,236,1556,1320
44449,1,0,15,0,-15
44450,1,1,109,1251,1142
44451,1,1,65,1423,1358
44452,1,1,894,2064,1170
44453,1,1,136,1242,1106
44454,1,1,777,1803,1026
44455,1,0,28,0,-28
44456,1,0,54,0,-54
44457,1,0,62,0,-62
44458,1,0,17,0,-17
44459,1,1,63,2379,2316
44460,1,0,19,0,-19
44461,1,1,261,1346,1085
44462,1,1,1186,1200,14
44463,0,0,4,0,-4
44464,1,0,12,0,-12
44465,0,0,8,0,-8
44466,1,0,22,0,-22
44467,0,0,62,0,-62
44468,1,1,380,2504,2124
44469,1,0,155,0,-155
44470,1,0,31,0,-31
44471,0,0,8,0,-8
44472,1,1,245,1280,1035
44473,1,0,11,0,-11
44474,1,1,1366,1711,345
44475,0,0,37,0,-37
44476,0,0,6,0,-6
44477,0,0,40,0,-40
44478,1,1,549,1376,827
44479,1,0,36,0,-36
44480,1,1,122,1630,1508
44481,1,1,596,1450,854
44482,1,0,42,0,-42
44483,0,0,11,0,-11
44484,1,0,6,0,-6
44485,1,1,103,1364,1261
44486,0,0,113,0,-113
44487,0,0,62,0,-62
44488,1,1,778,1505,727
44489,0,0,6,0,-6
44490,1,0,58,0,-58
44491,0,0,35,0,-35
44492,1,1,2218,1666,-552
44493,1,1,226,1274,1048
44494,0,0,28,0,-28
44495,1,0,26,0,-26
44496,1,1,81,8032,7951
44497,0,0,30,0,-30
44498,1,1,305,2142,1837
44499,1,1,378,1303,925
44500,0,0,9,0,-9
44501,1,0,11,0,-11
44502,1,1,1197,1444,247
44503,1,1,1227,1299,72
44504,1,1,54,2400,2346
44505,0,0,2,0,-2
44506,1,1,354,1577,1223
44507,1,0,101,0,-101
44508,1,1,656,1637,981
44509,0,0,45,0,-45
44510,0,0,31,0,-31
44511,1,0,1,0,-1
44512,1,0,42,0,-42
44513,1,0,36,0,-36
44514,1,1,1155,1329,174
44515,0,0,96,0,-96
44516,0,0,96,0,-96
44517,0,0,8,0,-8
44518,0,0,20,0,-20
44519,0,0,23,0,-23
44520,0,0,41,0,-41
44521,1,1,382,1646,1264
44522,1,0,127,0,-127
44523,1,1,1710,1778,68
44524,0,0,60,0,-60
44525,0,0,95,0,-95
44526,1,0,130,0,-130
44527,1,0,25,0,-25
44528,1,0,44,0,-44
44529,1,1,184,1653,1469
44530,0,0,7,0,-7
44531,0,0,0,0,0
44532,0,0,33,0,-33
44533,1,1,62,2199,2137
44534,0,0,15,0,-15
44535,1,0,16,0,-16
44536,0,0,136,0,-136
44537,0,0,35,0,-35
44538,1,1,1109,1565,456
44539,1,1,150,1430,1280
44540,1,1,620,1253,633
44541,1,1,191,1749,1558
44542,1,1,132,1310,1178
44543,0,0,68,0,-68
44544,1,1,1986,1362,-624
44545,0,0,153,0,-153
44546,0,0,163,0,-163
44547,1,1,504,1283,779
44548,1,1,1040,2009,969
44549,1,0,17,0,-17
44550,0,0,27,0,-27
44551,0,0,2,0,-2
44552,1,0,2,0,-2
44553,0,0,13,0,-13
44554,1,1,159,1203,1044
44555,1,0,40,0,-40
44556,0,0,236,0,-236
44557,1,1,417,1345,928
44558,0,0,13,0,-13
44559,1,1,58,1439,1381
44560,1,1,1118,1368,250
44561,1,0,126,0,-126
44562,0,0,14,0,-14
44563,1,0,26,0,-26
44564,0,0,28,0,-28
44565,1,1,1521,1397,-124
44566,1,0,95,0,-95
44567,0,0,44,0,-44
44568,1,1,1283,1730,447
44569,1,0,70,0,-70
44570,1,1,1430,1231,-199
44571,0,0,184,0,-184
44572,0,0,56,0,-56
44573,0,0,100,0,-100
44574,0,0,0,0,0
44575,0,0,136,0,-136
44576,1,1,254,1300,1046
44577,1,1,1768,1295,-473
44578,1,1,294,2468,2174
44579,0,0,1,0,-1
44580,0,0,68,0,-68
44581,1,1,1358,1248,-110
44582,0,0,104,0,-104
44583,0,0,3,0,-3
44584,0,0,2,0,-2
44585,1,1,543,1288,745
44586,0,0,4,0,-4
44587,1,1,205,1259,1054
44588,1,0,46,0,-46
44589,1,1,700,1506,806
44590,1,0,38,0,-38
44591,1,1,363,1545,1182
44592,0,0,25,0,-25
44593,1,1,640,1783,1143
44594,1,1,430,1228,798
44595,0,0,18,0,-18
44596,0,0,62,0,-62
44597,1,0,6,0,-6
44598,0,0,124,0,-124
44599,1,1,647,1415,768
44600,1,0,36,0,-36
44601,0,0,162,0,-162
44602,1,1,302,2422,2120
44603,1,0,10,0,-10
44604,1,0,16,0,-16
44605,1,1,782,1218,436
44606,0,0,21,0,-21
44607,1,0,46,0,-46
44608,1,0,39,0,-39
44609,1,1,786,1600,814
44610,1,1,463,1315,852
44611,0,0,10,0,-10
44612,1,0,127,0,-127
44613,1,1,154,2055,1901
44614,0,0,18,0,-18
44615,1,1,139,2917,2778
44616,1,0,35,0,-35
44617,1,1,559,1222,663
44618,0,0,15,0,-15
44619,0,0,14,0,-14
44620,0,0,24,0,-24
44621,1,1,546,1267,721
44622,1,1,986,1661,675
44623,1,0,55,0,-55
44624,1,1,956,1229,273
44625,0,0,0,0,0
44626,1,1,257,1392,1135
44627,1,0,25,0,-25
44628,1,1,573,1392,819
44629,1,0,84,0,-84
44630,0,0,14,0,-14
44631,1,0,7,0,-7
44632,1,0,129,0,-129
44633,1,1,652,1219,567
44634,0,0,0,0,0
44635,1,1,608,2490,1882
44636,1,0,80,0,-80
44637,1,1,513,1273,760
44638,0,0,8,0,-8
44639,0,0,49,0,-49
44640,0,0,139,0,-139
44641,0,0,3,0,-3
44642,1,0,3,0,-3
44643,0,0,75,0,-75
44644,0,0,51,0,-51
44645,0,0,46,0,-46
44646,1,0,22,0,-22
44647,1,0,9,0,-9
44648,1,1,356,1204,848
44649,1,1,686,1810,1124
44650,1,0,11,0,-11
44651,0,0,21,0,-21
44652,1,0,117,0,-117
44653,0,0,22,0,-22
44654,1,0,37,0,-37
44655,1,0,7,0,-7
44656,0,0,51,0,-51
44657,1,0,44,0,-44
44658,0,0,124,0,-124
44659,0,0,6,0,-6
44660,1,1,858,1581,723
44661,1,1,582,1488,906
44662,0,0,23,0,-23
44663,0,0,16,0,-16
44664,1,0,24,0,-24
44665,1,1,434,1264,830
44666,0,0,27,0,-27
44667,1,1,470,1248,778
44668,1,1,207,1460,1253
44669,1,1,1145,3311,2166
44670,1,0,62,0,-62
44671,0,0,6,0,-6
44672,1,0,2,0,-2
44673,1,0,51,0,-51
44674,1,0,12,0,-12
44675,1,0,40,0,-40
44676,1,1,320,1273,953
44677,0,0,59,0,-59
44678,1,1,477,1703,1226
44679,0,0,84,0,-84
44680,0,0,88,0,-88
44681,0,0,34,0,-34
44682,0,0,15,0,-15
44683,1,1,624,1748,1124
44684,0,0,70,0,-70
44685,0,0,9,0,-9
44686,0,0,3,0,-3
44687,1,1,181,1477,1296
44688,1,1,987,1443,456
44689,0,0,18,0,-18
44690,1,0,26,0,-26
44691,1,1,454,1393,939
44692,1,0,45,0,-45
44693,1,0,40,0,-40
44694,1,0,144,0,-144
44695,0,0,43,0,-43
44696,1,0,10,0,-10
44697,0,0,3,0,-3
44698,0,0,58,0,-58
44699,1,0,6,0,-6
44700,1,1,698,1220,522
44701,1,1,568,1754,1186
44702,1,0,29,0,-29
44703,1,0,39,0,-39
44704,1,1,1685,1828,143
44705,1,1,908,1258,350
44706,0,0,42,0,-42
44707,1,1,587,1309,722
44708,1,1,273,1581,1308
44709,0,0,28,0,-28
44710,1,0,37,0,-37
44711,0,0,30,0,-30
44712,1,1,281,1260,979
44713,0,0,6,0,-6
44714,0,0,115,0,-115
44715,0,0,5,0,-5
44716,1,1,529,1509,980
44717,0,0,18,0,-18
44718,1,1,18,1431,1413
44719,0,0,4,0,-4
44720,0,0,46,0,-46
44721,1,1,1492,1624,132
44722,1,1,588,1202,614
44723,1,1,73,2907,2834
44724,1,1,1062,1270,208
44725,1,0,25,0,-25
44726,1,1,275,1469,1194
44727,0,0,21,0,-21
44728,0,0,52,0,-52
44729,1,1,319,1236,917
44730,1,0,18,0,-18
44731,0,0,32,0,-32
44732,0,0,100,0,-100
44733,0,0,27,0,-27
44734,1,0,2,0,-2
44735,1,1,470,1211,741
44736,0,0,11,0,-11
44737,0,0,64,0,-64
44738,1,0,118,0,-118
44739,1,0,52,0,-52
44740,0,0,28,0,-28
44741,0,0,43,0,-43
44742,1,0,63,0,-63
44743,1,0,2,0,-2
44744,0,0,26,0,-26
44745,1,1,2430,1241,-1189
44746,0,0,49,0,-49
44747,1,1,335,1273,938
44748,1,0,10,0,-10
44749,1,0,43,0,-43
44750,0,0,46,0,-46
44751,0,0,2,0,-2
44752,0,0,10,0,-10
44753,0,0,37,0,-37
44754,0,0,22,0,-22
44755,1,0,23,0,-23
44756,1,0,64,0,-64
44757,1,1,275,1243,968
44758,1,0,6,0,-6
44759,0,0,56,0,-56
44760,1,0,1,0,-1
44761,1,0,81,0,-81
44762,0,0,81,0,-81
44763,1,0,13,0,-13
44764,1,0,97,0,-97
44765,1,1,1834,1265,-569
44766,1,1,131,1731,1600
44767,0,0,30,0,-30
44768,1,1,753,1241,488
44769,1,0,9,0,-9
44770,0,0,28,0,-28
44771,1,1,886,3047,2161
44772,0,0,35,0,-35
44773,1,0,62,0,-62
44774,1,0,170,0,-170
44775,1,1,88,1434,1346
44776,1,0,125,0,-125
44777,1,1,1373,1205,-168
44778,0,0,19,0,-19
44779,0,0,29,0,-29
44780,0,0,8,0,-8
44781,1,0,139,0,-139
44782,1,0,62,0,-62
44783,1,1,612,1231,619
44784,0,0,70,0,-70
44785,1,0,6,0,-6
44786,1,1,209,1466,1257
44787,0,0,48,0,-48
44788,0,0,52,0,-52
44789,0,0,9,0,-9
44790,0,0,3,0,-3
44791,1,0,374,0,-374
44792,1,1,790,1230,440
44793,1,1,147,1553,1406
44794,1,0,38,0,-38
44795,1,1,108,1243,1135
44796,0,0,3,0,-3
44797,1,0,66,0,-66
44798,0,0,48,0,-48
44799,1,1,363,1707,1344
44800,0,0,87,0,-87
44801,1,1,157,1218,1061
44802,1,1,174,1812,1638
44803,1,1,393,1252,859
44804,0,0,8,0,-8
44805,1,1,422,1234,812
44806,1,1,141,1620,1479
44807,1,1,147,1364,1217
44808,1,0,9,0,-9
44809,1,1,267,1574,1307
44810,0,0,10,0,-10
44811,1,0,64,0,-64
44812,1,0,93,0,-93
44813,1,1,1300,1250,-50
44814,1,1,952,1381,429
44815,0,0,18,0,-18
44816,0,0,68,0,-68
44817,1,1,204,3427,3223
44818,0,0,75,0,-75
44819,1,1,303,1251,948
44820,0,0,14,0,-14
44821,1,1,418,1364,946
44822,0,0,3,0,-3
44823,1,0,90,0,-90
44824,0,0,10,0,-10
44825,1,1,113,1566,1453
44826,0,0,7,0,-7
44827,1,1,394,1526,1132
44828,0,0,10,0,-10
44829,0,0,79,0,-79
44830,0,0,66,0,-66
44831,0,0,13,0,-13
44832,0,0,23,0,-23
44833,0,0,46,0,-46
44834,1,1,580,1459,879
44835,1,0,37,0,-37
44836,0,0,198,0,-198
44837,0,0,13,0,-13
44838,1,1,496,1340,844
44839,1,0,4,0,-4
44840,1,0,61,0,-61
44841,0,0,13,0,-13
44842,1,1,642,1257,615
44843,1,0,3,0,-3
44844,1,0,152,0,-152
44845,0,0,20,0,-20
44846,1,0,57,0,-57
44847,1,1,333,1221,888
44848,1,0,94,0,-94
44849,1,1,158,1255,1097
44850,1,1,1311,1548,237
44851,1,0,0,0,0
44852,1,0,21,0,-21
44853,1,1,205,1706,1501
44854,1,1,192,1406,1214
44855,1,1,207,2747,2540
44856,0,0,10,0,-10
44857,1,1,3323,1698,-1625
44858,0,0,85,0,-85
44859,0,0,36,0,-36
44860,1,1,3790,2308,-1482
44861,1,1,1606,1268,-338
44862,1,1,737,1236,499
44863,1,1,19,1563,1544
44864,1,1,45,1774,1729
44865,0,0,6,0,-6
44866,1,1,1225,1333,108
44867,1,0,62,0,-62
44868,0,0,34,0,-34
44869,1,0,23,0,-23
44870,1,0,56,0,-56
44871,1,0,62,0,-62
44872,1,0,50,0,-50
44873,1,0,158,0,-158
44874,0,0,7,0,-7
44875,1,1,1207,1398,191
44876,0,0,21,0,-21
44877,1,0,13,0,-13
44878,0,0,76,0,-76
44879,0,0,9,0,-9
44880,1,1,654,1610,956
44881,0,0,25,0,-25
44882,0,0,38,0,-38
44883,0,0,202,0,-202
44884,1,1,173,1400,1227
44885,0,0,75,0,-75
44886,1,1,458,1563,1105
44887,0,0,18,0,-18
44888,1,0,141,0,-141
44889,0,0,4,0,-4
44890,1,1,169,1471,1302
44891,0,0,18,0,-18
44892,1,1,194,2217,2023
44893,0,0,8,0,-8
44894,0,0,151,0,-151
44895,1,0,106,0,-106
44896,1,1,813,1212,399
44897,1,0,27,0,-27
44898,1,0,17,0,-17
44899,0,0,232,0,-232
44900,1,1,1122,1229,107
44901,1,0,76,0,-76
44902,0,0,67,0,-67
44903,1,1,887,1583,696
44904,0,0,60,0,-60
44905,0,0,19,0,-19
44906,1,0,67,0,-67
44907,0,0,106,0,-106
44908,1,1,63,1895,1832
44909,0,0,5,0,-5
44910,1,1,2099,1228,-871
44911,0,0,76,0,-76
44912,1,1,248,1483,1235
44913,0,0,0,0,0
44914,1,1,231,1293,1062
44915,0,0,93,0,-93
44916,1,0,4,0,-4
44917,1,0,5,0,-5
44918,0,0,119,0,-119
44919,1,1,150,1428,1278
44920,0,0,1,0,-1
44921,1,1,2290,1276,-1014
44922,1,1,259,1784,1525
44923,0,0,67,0,-67
44924,1,1,710,2818,2108
44925,0,0,40,0,-40
44926,1,0,35,0,-35
44927,0,0,61,0,-61
44928,1,1,3493,1290,-2203
44929,1,0,75,0,-75
44930,0,0,1,0,-1
44931,0,0,13,0,-13
44932,1,0,45,0,-45
44933,0,0,53,0,-53
44934,0,0,19,0,-19
44935,1,1,149,2199,2050
44936,1,0,4,0,-4
44937,1,1,472,1326,854
44938,1,1,234,1763,1529
44939,1,1,185,1303,1118
44940,0,0,4,0,-4
44941,1,0,7,0,-7
44942,0,0,39,0,-39
44943,1,0,50,0,-50
44944,1,0,96,0,-96
44945,0,0,20,0,-20
44946,1,0,47,0,-47
44947,1,0,34,0,-34
44948,0,0,88,0,-88
44949,1,0,18,0,-18
44950,0,0,49,0,-49
44951,1,0,7,0,-7
44952,0,0,39,0,-39
44953,0,0,50,0,-50
44954,1,0,146,0,-146
44955,1,1,1038,1249,211
44956,1,1,387,1224,837
44957,0,0,27,0,-27
44958,0,0,17,0,-17
44959,1,1,310,1335,1025
44960,1,1,1056,1408,352
44961,0,0,16,0,-16
44962,1,1,371,1294,923
44963,0,0,166,0,-166
44964,0,0,77,0,-77
44965,1,0,96,0,-96
44966,1,1,313,3245,2932
44967,1,0,85,0,-85
44968,0,0,17,0,-17
44969,0,0,87,0,-87
44970,1,0,60,0,-60
44971,0,0,20,0,-20
44972,0,0,42,0,-42
44973,1,1,312,1416,1104
44974,1,1,766,1276,510
44975,0,0,133,0,-133
44976,1,1,441,1858,1417
44977,1,0,14,0,-14
44978,1,0,3,0,-3
44979,0,0,11,0,-11
44980,0,0,5,0,-5
44981,1,0,89,0,-89
44982,0,0,38,0,-38
44983,0,0,18,0,-18
44984,1,0,58,0,-58
44985,0,0,3,0,-3
44986,1,0,43,0,-43
44987,0,0,30,0,-30
44988,1,1,544,1889,1345
44989,1,0,1,0,-1
44990,1,0,78,0,-78
44991,0,0,71,0,-71
44992,1,0,127,0,-127
44993,1,0,13,0,-13
44994,1,0,23,0,-23
44995,0,0,9,0,-9
44996,0,0,51,0,-51
44997,0,0,88,0,-88
44998,1,0,63,0,-63
44999,0,0,10,0,-10
45000,0,0,64,0,-64
45001,1,1,507,1228,721
45002,1,0,19,0,-19
45003,1,1,104,1515,1411
45004,1,1,1820,1210,-610
45005,1,0,4,0,-4
45006,0,0,41,0,-41
45007,1,0,45,0,-45
45008,1,1,71,1582,1511
45009,1,0,40,0,-40
45010,1,1,292,1202,910
45011,1,1,157,1478,1321
45012,1,1,325,1496,1171
45013,1,0,62,0,-62
45014,1,1,80,1205,1125
45015,0,0,29,0,-29
45016,1,0,46,0,-46
45017,0,0,3,0,-3
45018,0,0,10,0,-10
45019,0,0,73,0,-73
45020,0,0,120,0,-120
45021,0,0,9,0,-9
45022,1,0,8,0,-8
45023,1,1,428,1225,797
45024,1,1,107,1212,1105
45025,1,1,169,1411,1242
45026,0,0,3,0,-3
45027,1,1,1439,2005,566
45028,1,1,1475,1413,-62
45029,0,0,71,0,-71
45030,1,0,36,0,-36
45031,0,0,79,0,-79
45032,1,1,223,2275,2052
45033,1,0,92,0,-92
45034,0,0,72,0,-72
45035,0,0,4,0,-4
45036,0,0,53,0,-53
45037,1,0,72,0,-72
45038,0,0,65,0,-65
45039,0,0,19,0,-19
45040,1,0,51,0,-51
45041,1,1,973,1688,715
45042,0,0,38,0,-38
45043,0,0,164,0,-164
45044,1,1,238,1539,1301
45045,0,0,17,0,-17
45046,1,1,627,2085,1458
45047,1,1,71,1465,1394
45048,1,1,756,1589,833
45049,1,0,80,0,-80
45050,1,1,471,1432,961
45051,1,0,56,0,-56
45052,1,0,73,0,-73
45053,0,0,32,0,-32
45054,0,0,57,0,-57
45055,0,0,40,0,-40
45056,1,1,181,1433,1252
45057,1,1,316,1236,920
45058,1,1,303,1244,941
45059,0,0,15,0,-15
45060,1,0,7,0,-7
45061,0,0,36,0,-36
45062,0,0,0,0,0
45063,0,0,27,0,-27
45064,1,1,481,1577,1096
45065,1,0,28,0,-28
45066,1,1,506,4780,4274
45067,1,1,346,1296,950
45068,1,0,173,0,-173
45069,1,1,533,1213,680
45070,1,1,317,2131,1814
45071,1,1,119,1627,1508
45072,1,0,14,0,-14
45073,1,0,20,0,-20
45074,1,0,30,0,-30
45075,0,0,5,0,-5
45076,0,0,11,0,-11
45077,0,0,3,0,-3
45078,1,0,41,0,-41
45079,1,1,273,1368,1095
45080,1,0,132,0,-132
45081,1,1,130,1254,1124
45082,0,0,18,0,-18
45083,0,0,98,0,-98
45084,1,0,0,0,0
45085,1,1,53,3962,3909
45086,0,0,75,0,-75
45087,0,0,88,0,-88
45088,1,1,618,1573,955
45089,1,1,1318,1333,15
45090,0,0,25,0,-25
45091,0,0,60,0,-60
45092,0,0,97,0,-97
45093,1,0,73,0,-73
45094,0,0,117,0,-117
45095,1,1,245,1554,1309
45096,1,1,962,1325,363
45097,1,0,89,0,-89
45098,1,0,74,0,-74
45099,1,1,454,1894,1440
45100,1,1,18,1863,1845
45101,0,0,22,0,-22
45102,0,0,1,0,-1
45103,1,1,772,1502,730
45104,1,1,542,1224,682
45105,0,0,26,0,-26
45106,0,0,37,0,-37
45107,1,0,35,0,-35
45108,1,1,256,1711,1455
45109,1,1,309,1342,1033
45110,1,1,373,1256,883
45111,1,1,558,1249,691
45112,1,1,104,1344,1240
45113,1,1,15,1724,1709
45114,0,0,23,0,-23
45115,0,0,75,0,-75
45116,1,1,381,1425,1044
45117,0,0,41,0,-41
45118,1,1,150,1545,1395
45119,1,0,134,0,-134
45120,0,0,80,0,-80
45121,1,1,1980,1291,-689
45122,0,0,38,0,-38
45123,1,1,360,2067,1707
45124,1,1,428,1359,931
45125,0,0,198,0,-198
45126,0,0,1,0,-1
45127,1,0,7,0,-7
45128,1,0,7,0,-7
45129,0,0,28,0,-28
45130,1,1,52,1880,1828
45131,1,0,50,0,-50
45132,1,1,643,1230,587
45133,0,0,13,0,-13
45134,1,1,1074,1246,172
45135,1,1,635,1251,616
45136,0,0,0,0,0
45137,1,1,844,2046,1202
45138,0,0,4,0,-4
45139,1,0,5,0,-5
45140,1,0,30,0,-30
45141,1,0,7,0,-7
45142,1,0,28,0,-28
45143,0,0,168,0,-168
45144,1,1,1547,1344,-203
45145,0,0,18,0,-18
45146,1,0,2,0,-2
45147,1,0,98,0,-98
45148,1,1,266,1495,1229
45149,1,1,578,1529,951
45150,1,1,195,1519,1324
45151,1,1,165,1232,1067
45152,0,0,119,0,-119
45153,0,0,13,0,-13
45154,1,0,217,0,-217
45155,0,0,39,0,-39
45156,0,0,15,0,-15
45157,0,0,68,0,-68
45158,1,0,231,0,-231
45159,1,1,117,1318,1201
45160,1,1,234,1243,1009
45161,0,0,0,0,0
45162,0,0,104,0,-104
45163,1,0,62,0,-62
45164,0,0,38,0,-38
45165,0,0,37,0,-37
45166,0,0,19,0,-19
45167,1,0,70,0,-70
45168,0,0,57,0,-57
45169,1,0,18,0,-18
45170,1,0,76,0,-76
45171,1,0,11,0,-11
45172,0,0,37,0,-37
45173,1,1,872,1789,917
45174,1,1,193,2104,1911
45175,0,0,13,0,-13
45176,0,0,28,0,-28
45177,0,0,1,0,-1
45178,0,0,28,0,-28
45179,1,0,1,0,-1
45180,1,1,605,1405,800
45181,0,0,113,0,-113
45182,1,0,119,0,-119
45183,1,1,1156,1276,120
45184,1,0,37,0,-37
45185,0,0,2,0,-2
45186,1,0,37,0,-37
45187,1,1,332,2101,1769
45188,0,0,121,0,-121
45189,1,0,3,0,-3
45190,1,1,227,2537,2310
45191,1,1,979,1594,615
45192,1,0,77,0,-77
45193,1,0,101,0,-101
45194,0,0,129,0,-129
45195,0,0,80,0,-80
45196,1,0,236,0,-236
45197,0,0,23,0,-23
45198,0,0,2,0,-2
45199,1,0,76,0,-76
45200,1,0,58,0,-58
45201,0,0,45,0,-45
45202,0,0,43,0,-43
45203,1,0,157,0,-157
45204,0,0,20,0,-20
45205,1,1,215,2652,2437
45206,1,1,690,1219,529
45207,0,0,21,0,-21
45208,0,0,176,0,-176
45209,0,0,58,0,-58
45210,1,0,67,0,-67
45211,0,0,38,0,-38
45212,0,0,66,0,-66
45213,0,0,50,0,-50
45214,0,0,25,0,-25
45215,1,0,121,0,-121
45216,1,0,0,0,0
45217,1,0,76,0,-76
45218,1,1,127,1346,1219
45219,1,0,10,0,-10
45220,0,0,44,0,-44
45221,1,1,2513,1205,-1308
45222,0,0,72,0,-72
45223,1,0,170,0,-170
45224,1,1,108,1296,1188
45225,1,1,561,1452,891
45226,1,0,12,0,-12
45227,1,0,5,0,-5
45228,1,0,75,0,-75
45229,1,1,145,1202,1057
45230,0,0,28,0,-28
45231,1,1,661,1283,622
45232,0,0,33,0,-33
45233,1,0,10,0,-10
45234,0,0,25,0,-25
45235,1,0,47,0,-47
45236,1,0,132,0,-132
45237,0,0,1,0,-1
45238,0,0,2,0,-2
45239,0,0,8,0,-8
45240,1,1,400,1228,828
45241,1,0,59,0,-59
45242,1,1,307,1349,1042
45243,1,0,8,0,-8
45244,1,0,39,0,-39
45245,1,1,378,1317,939
45246,1,1,1234,1233,-1
45247,1,0,20,0,-20
45248,1,0,44,0,-44
45249,0,0,129,0,-129
45250,0,0,15,0,-15
45251,0,0,294,0,-294
45252,1,0,31,0,-31
45253,1,0,22,0,-22
45254,0,0,31,0,-31
45255,1,0,4,0,-4
45256,1,0,11,0,-11
45257,1,0,118,0,-118
45258,1,0,14,0,-14
45259,0,0,54,0,-54
45260,1,0,111,0,-111
45261,1,0,17,0,-17
45262,1,1,611,1390,779
45263,0,0,9,0,-9
45264,0,0,178,0,-178
45265,1,1,271,2841,2570
45266,1,1,947,1341,394
45267,1,1,643,2588,1945
45268,0,0,16,0,-16
45269,1,1,81,2531,2450
45270,1,0,167,0,-167
45271,1,1,137,1378,1241
45272,0,0,5,0,-5
45273,1,1,1439,1615,176
45274,1,0,4,0,-4
45275,1,1,213,1483,1270
45276,1,0,17,0,-17
45277,1,0,15,0,-15
45278,1,1,567,1445,878
45279,1,1,522,1587,1065
45280,0,0,164,0,-164
45281,0,0,98,0,-98
45282,0,0,12,0,-12
45283,0,0,113,0,-113
45284,1,0,21,0,-21
45285,0,0,3,0,-3
45286,1,1,731,1330,599
45287,1,0,14,0,-14
45288,1,0,70,0,-70
45289,0,0,34,0,-34
45290,1,1,743,1276,533
45291,0,0,18,0,-18
45292,0,0,62,0,-62
45293,1,0,2,0,-2
45294,1,1,1001,1626,625
45295,0,0,18,0,-18
45296,0,0,3,0,-3
45297,1,1,835,1238,403
45298,0,0,82,0,-82
45299,0,0,2,0,-2
45300,1,1,569,1688,1119
45301,0,0,149,0,-149
45302,0,0,19,0,-19
45303,1,1,364,1287,923
45304,1,0,0,0,0
45305,1,0,95,0,-95
45306,1,1,112,1947,1835
45307,1,0,77,0,-77
45308,1,0,35,0,-35
45309,1,0,16,0,-16
45310,1,1,756,2185,1429
45311,1,0,46,0,-46
45312,1,1,323,1461,1138
45313,1,1,606,2608,2002
45314,1,1,795,1333,538
45315,0,0,11,0,-11
45316,1,1,459,1422,963
45317,1,1,930,1232,302
45318,1,0,25,0,-25
45319,0,0,58,0,-58
45320,1,0,28,0,-28
45321,1,1,126,1422,1296
45322,0,0,22,0,-22
45323,1,1,78,1308,1230
45324,0,0,70,0,-70
45325,0,0,60,0,-60
45326,0,0,20,0,-20
45327,1,1,11,1561,1550
45328,1,0,53,0,-53
45329,0,0,29,0,-29
45330,1,1,92,1659,1567
45331,0,0,6,0,-6
45332,0,0,171,0,-171
45333,0,0,8,0,-8
45334,0,0,28,0,-28
45335,0,0,35,0,-35
45336,1,0,34,0,-34
45337,1,0,13,0,-13
45338,0,0,243,0,-243
45339,1,0,51,0,-51
45340,0,0,31,0,-31
45341,0,0,0,0,0
45342,0,0,54,0,-54
45343,1,0,65,0,-65
45344,1,0,50,0,-50
45345,0,0,63,0,-63
45346,1,1,807,1702,895
45347,1,0,18,0,-18
45348,0,0,42,0,-42
45349,0,0,13,0,-13
45350,0,0,38,0,-38
45351,1,0,24,0,-24
45352,1,0,25,0,-25
45353,0,0,11,0,-11
45354,1,1,167,1286,1119
45355,0,0,30,0,-30
45356,1,1,859,1293,434
45357,1,0,69,0,-69
45358,0,0,13,0,-13
45359,1,1,1252,1236,-16
45360,0,0,58,0,-58
45361,1,1,1931,2020,89
45362,1,1,932,1669,737
45363,1,1,359,1350,991
45364,1,0,134,0,-134
45365,0,0,63,0,-63
45366,1,0,11,0,-11
45367,0,0,18,0,-18
45368,1,1,624,1526,902
45369,1,0,133,0,-133
45370,1,0,44,0,-44
45371,1,1,352,1207,855
45372,1,1,900,1334,434
45373,1,1,250,1463,1213
45374,1,1,466,1331,865
45375,0,0,2,0,-2
45376,0,0,16,0,-16
45377,0,0,47,0,-47
45378,1,1,101,1752,1651
45379,1,1,745,1246,501
45380,1,0,2,0,-2
45381,0,0,18,0,-18
45382,0,0,4,0,-4
45383,1,0,53,0,-53
45384,0,0,51,0,-51
45385,1,1,325,1200,875
45386,0,0,67,0,-67
45387,0,0,9,0,-9
45388,1,1,375,1425,1050
45389,0,0,8,0,-8
45390,0,0,54,0,-54
45391,1,1,2411,1224,-1187
45392,0,0,10,0,-10
45393,0,0,32,0,-32
45394,0,0,58,0,-58
45395,1,1,306,1921,1615
45396,1,1,512,1394,882
45397,1,0,48,0,-48
45398,1,0,116,0,-116
45399,1,1,35,1250,1215
45400,0,0,19,0,-19
45401,1,1,247,1616,1369
45402,0,0,0,0,0
45403,1,1,512,1386,874
45404,0,0,4,0,-4
45405,1,0,109,0,-109
45406,0,0,48,0,-48
45407,0,0,29,0,-29
45408,0,0,41,0,-41
45409,1,1,1201,1900,699
45410,0,0,3,0,-3
45411,0,0,7,0,-7
45412,0,0,13,0,-13
45413,1,1,1523,1523,0
45414,1,0,28,0,-28
45415,0,0,32,0,-32
45416,1,0,48,0,-48
45417,1,0,116,0,-116
45418,0,0,7,0,-7
45419,0,0,36,0,-36
45420,1,1,389,1551,1162
45421,0,0,46,0,-46
45422,0,0,11,0,-11
45423,0,0,7,0,-7
45424,0,0,39,0,-39
45425,0,0,52,0,-52
45426,1,1,394,1721,1327
45427,0,0,43,0,-43
45428,1,0,21,0,-21
45429,1,1,1088,1324,236
45430,1,0,17,0,-17
45431,0,0,6,0,-6
45432,0,0,141,0,-141
45433,0,0,50,0,-50
45434,1,1,380,1672,1292
45435,0,0,51,0,-51
45436,1,1,8,1257,1249
45437,1,1,473,1216,743
45438,0,0,18,0,-18
45439,0,0,18,0,-18
45440,1,0,125,0,-125
45441,1,1,154,1714,1560
45442,1,0,1,0,-1
45443,0,0,2,0,-2
45444,0,0,66,0,-66
45445,1,1,248,1413,1165
45446,1,1,39,1534,1495
45447,1,0,22,0,-22
45448,1,0,69,0,-69
45449,1,1,781,1861,1080
45450,1,1,1004,1418,414
45451,0,0,20,0,-20
45452,0,0,106,0,-106
45453,0,0,21,0,-21
45454,0,0,1,0,-1
45455,0,0,101,0,-101
45456,1,1,167,3016,2849
45457,0,0,17,0,-17
45458,0,0,17,0,-17
45459,0,0,50,0,-50
45460,1,0,37,0,-37
45461,1,0,115,0,-115
45462,1,1,2179,1995,-184
45463,1,1,343,1357,1014
45464,1,0,17,0,-17
45465,1,1,343,1531,1188
45466,1,1,495,1843,1348
45467,1,1,629,1365,736
45468,1,0,164,0,-164
45469,1,0,11,0,-11
45470,1,1,40,2197,2157
45471,0,0,23,0,-23
45472,0,0,15,0,-15
45473,0,0,10,0,-10
45474,0,0,30,0,-30
45475,1,0,45,0,-45
45476,1,0,81,0,-81
45477,1,0,54,0,-54
45478,0,0,5,0,-5
45479,1,1,1050,1329,279
45480,0,0,43,0,-43
45481,1,0,131,0,-131
45482,0,0,41,0,-41
45483,0,0,4,0,-4
45484,0,0,60,0,-60
45485,0,0,2,0,-2
45486,1,1,496,1386,890
45487,1,0,7,0,-7
45488,0,0,32,0,-32
45489,0,0,0,0,0
45490,1,0,9,0,-9
45491,1,1,650,2253,1603
45492,1,0,5,0,-5
45493,1,0,125,0,-125
45494,1,0,68,0,-68
45495,0,0,2,0,-2
45496,0,0,76,0,-76
45497,1,1,403,1794,1391
45498,0,0,153,0,-153
45499,0,0,37,0,-37
45500,0,0,2,0,-2
45501,0,0,18,0,-18
45502,1,0,6,0,-6
45503,1,1,407,1451,1044
45504,0,0,26,0,-26
45505,0,0,13,0,-13
45506,0,0,72,0,-72
45507,1,0,16,0,-16
45508,1,0,69,0,-69
45509,0,0,6,0,-6
45510,0,0,103,0,-103
45511,1,0,79,0,-79
45512,0,0,239,0,-239
45513,1,0,44,0,-44
45514,1,1,481,2793,2312
45515,1,1,548,1478,930
45516,1,0,41,0,-41
45517,1,0,15,0,-15
45518,1,0,120,0,-120
45519,0,0,39,0,-39
45520,1,0,26,0,-26
45521,1,0,18,0,-18
45522,0,0,76,0,-76
45523,1,0,10,0,-10
45524,1,0,59,0,-59
45525,0,0,229,0,-229
45526,1,0,16,0,-16
45527,1,1,501,1855,1354
45528,0,0,15,0,-15
45529,1,1,866,2587,1721
45530,0,0,43,0,-43
45531,0,0,40,0,-40
45532,1,1,218,1711,1493
45533,1,1,208,1231,1023
45534,1,0,29,0,-29
45535,1,0,140,0,-140
45536,1,1,452,1231,779
45537,0,0,1,0,-1
45538,0,0,53,0,-53
45539,1,0,57,0,-57
45540,1,1,271,2724,2453
45541,1,0,9,0,-9
45542,1,0,3,0,-3
45543,0,0,30,0,-30
45544,1,0,33,0,-33
45545,1,1,493,1447,954
45546,0,0,98,0,-98
45547,1,1,457,2297,1840
45548,1,0,36,0,-36
45549,1,0,39,0,-39
45550,1,1,330,1202,872
45551,0,0,46,0,-46
45552,0,0,11,0,-11
45553,0,0,51,0,-51
45554,1,1,289,1378,1089
45555,0,0,12,0,-12
45556,1,0,67,0,-67
45557,1,1,382,2459,2077
45558,0,0,12,0,-12
45559,0,0,46,0,-46
45560,1,0,10,0,-10
45561,0,0,151,0,-151
45562,0,0,11,0,-11
45563,1,1,942,1538,596
45564,1,0,0,0,0
45565,1,0,113,0,-113
45566,0,0,120,0,-120
45567,1,1,377,1234,857
45568,0,0,55,0,-55
45569,1,0,15,0,-15
45570,1,1,394,1592,1198
45571,1,1,183,1253,1070
45572,0,0,2,0,-2
45573,1,1,192,1291,1099
45574,1,1,235,1486,1251
45575,1,1,1723,1431,-292
45576,1,0,68,0,-68
45577,1,0,0,0,0
45578,0,0,4,0,-4
45579,0,0,101,0,-101
45580,0,0,1,0,-1
45581,0,0,60,0,-60
45582,0,0,30,0,-30
45583,1,0,1,0,-1
45584,1,0,68,0,-68
45585,1,1,52,1357,1305
45586,1,0,36,0,-36
45587,1,1,243,1364,1121
45588,1,1,1156,1437,281
45589,1,0,146,0,-146
45590,0,0,10,0,-10
45591,1,1,1122,2304,1182
45592,1,0,0,0,0
45593,0,0,4,0,-4
45594,1,0,66,0,-66
45595,0,0,49,0,-49
45596,0,0,5,0,-5
45597,1,1,607,1739,1132
45598,0,0,50,0,-50
45599,0,0,56,0,-56
45600,1,0,156,0,-156
45601,0,0,9,0,-9
45602,1,0,98,0,-98
45603,1,1,116,1522,1406
45604,0,0,6,0,-6
45605,0,0,23,0,-23
45606,1,0,41,0,-41
45607,0,0,86,0,-86
45608,1,1,747,1255,508
45609,1,1,350,1550,1200
45610,1,0,90,0,-90
45611,1,1,86,2003,1917
45612,1,1,1355,1217,-138
45613,0,0,240,0,-240
45614,0,0,0,0,0
45615,1,1,604,1593,989
45616,0,0,65,0,-65
45617,0,0,8,0,-8
45618,1,1,541,1679,1138
45619,1,0,70,0,-70
45620,1,0,93,0,-93
45621,1,0,13,0,-13
45622,1,1,568,1372,804
45623,0,0,0,0,0
45624,0,0,8,0,-8
45625,0,0,4,0,-4
45626,0,0,4,0,-4
45627,0,0,25,0,-25
45628,1,1,524,1364,840
45629,1,0,103,0,-103
45630,1,0,31,0,-31
45631,1,0,47,0,-47
45632,0,0,34,0,-34
45633,1,1,353,1594,1241
45634,0,0,36,0,-36
45635,1,0,25,0,-25
45636,1,1,505,2054,1549
45637,0,0,38,0,-38
45638,1,1,738,1443,705
45639,1,0,9,0,-9
45640,1,1,26,1207,1181
45641,1,1,174,1384,1210
45642,0,0,73,0,-73
45643,1,1,879,1457,578
45644,0,0,1,0,-1
45645,1,1,259,2082,1823
45646,0,0,23,0,-23
45647,1,0,57,0,-57
45648,1,0,2,0,-2
45649,1,1,669,1211,542
45650,0,0,26,0,-26
45651,0,0,6,0,-6
45652,1,1,1796,1492,-304
45653,0,0,24,0,-24
45654,0,0,24,0,-24
45655,1,1,935,1358,423
45656,0,0,27,0,-27
45657,1,0,48,0,-48
45658,1,1,527,1305,778
45659,0,0,160,0,-160
45660,0,0,46,0,-46
45661,1,0,110,0,-110
45662,0,0,3,0,-3
45663,0,0,56,0,-56
45664,0,0,48,0,-48
45665,1,0,7,0,-7
45666,1,1,157,2982,2825
45667,1,1,296,1282,986
45668,1,0,6,0,-6
45669,1,0,46,0,-46
45670,1,1,130,1294,1164
45671,0,0,51,0,-51
45672,1,1,198,1560,1362
45673,1,1,92,2274,2182
45674,1,1,1015,2043,1028
45675,0,0,11,0,-11
45676,0,0,136,0,-136
45677,1,0,10,0,-10
45678,1,0,132,0,-132
45679,1,0,38,0,-38
45680,1,1,398,1506,1108
45681,0,0,21,0,-21
45682,0,0,190,0,-190
45683,0,0,159,0,-159
45684,1,0,12,0,-12
45685,1,0,27,0,-27
45686,1,0,14,0,-14
45687,1,0,93,0,-93
45688,0,0,7,0,-7
45689,0,0,93,0,-93
45690,1,0,10,0,-10
45691,0,0,33,0,-33
45692,1,0,54,0,-54
45693,1,1,189,1306,1117
45694,0,0,34,0,-34
45695,1,1,245,1739,1494
45696,1,0,2,0,-2
45697,0,0,87,0,-87
45698,0,0,48,0,-48
45699,1,1,503,1720,1217
45700,0,0,55,0,-55
45701,0,0,30,0,-30
45702,0,0,65,0,-65
45703,1,1,567,1367,800
45704,0,0,54,0,-54
45705,0,0,0,0,0
45706,1,1,331,1261,930
45707,0,0,41,0,-41
45708,1,1,366,1205,839
45709,1,1,179,1305,1126
45710,1,1,1095,2667,1572
45711,1,1,1048,1363,315
45712,1,0,13,0,-13
45713,0,0,7,0,-7
45714,1,1,470,1969,1499
45715,0,0,30,0,-30
45716,0,0,0,0,0
45717,0,0,113,0,-113
45718,1,0,60,0,-60
45719,1,1,128,1262,1134
45720,1,0,21,0,-21
45721,1,0,88,0,-88
45722,0,0,63,0,-63
45723,1,0,7,0,-7
45724,0,0,35,0,-35
45725,0,0,108,0,-108
45726,0,0,10,0,-10
45727,0,0,36,0,-36
45728,0,0,116,0,-116
45729,1,1,1101,1543,442
45730,0,0,49,0,-49
45731,1,1,633,1534,901
45732,0,0,43,0,-43
45733,1,0,127,0,-127
45734,0,0,32,0,-32
45735,1,0,76,0,-76
45736,0,0,1,0,-1
45737,1,0,8,0,-8
45738,0,0,131,0,-131
45739,0,0,25,0,-25
45740,1,1,136,1336,1200
45741,1,1,95,1295,1200
45742,1,1,1105,1527,422
45743,1,1,739,1227,488
45744,1,0,0,0,0
45745,1,1,1034,2235,1201
45746,1,1,1446,2156,710
45747,0,0,6,0,-6
45748,0,0,19,0,-19
45749,1,1,745,1225,480
45750,1,0,38,0,-38
45751,0,0,84,0,-84
45752,0,0,2,0,-2
45753,0,0,64,0,-64
45754,0,0,60,0,-60
45755,1,0,76,0,-76
45756,1,1,337,1260,923
45757,1,1,914,1263,349
45758,1,0,249,0,-249
45759,1,1,90,1291,1201
45760,1,1,334,1472,1138
45761,0,0,45,0,-45
45762,0,0,40,0,-40
45763,1,1,689,2950,2261
45764,1,0,94,0,-94
45765,1,0,41,0,-41
45766,1,1,127,1367,1240
45767,1,1,431,1275,844
45768,0,0,28,0,-28
45769,1,1,668,1247,579
45770,1,0,46,0,-46
45771,1,1,781,1324,543
45772,0,0,0,0,0
45773,0,0,0,0,0
45774,0,0,11,0,-11
45775,1,0,267,0,-267
45776,1,1,673,2238,1565
45777,0,0,32,0,-32
45778,1,1,949,1387,438
45779,1,1,150,1410,1260
45780,0,0,4,0,-4
45781,1,1,739,2244,1505
45782,0,0,22,0,-22
45783,1,1,155,3296,3141
45784,0,0,8,0,-8
45785,1,1,349,1284,935
45786,1,1,431,1214,783
45787,0,0,23,0,-23
45788,0,0,15,0,-15
45789,1,0,37,0,-37
45790,1,0,21,0,-21
45791,0,0,80,0,-80
45792,0,0,12,0,-12
45793,1,1,147,1975,1828
45794,1,0,52,0,-52
45795,1,1,1056,1772,716
45796,1,1,1076,4800,3724
45797,1,1,332,1293,961
45798,1,1,557,1260,703
45799,1,0,51,0,-51
45800,0,0,14,0,-14
45801,1,1,248,1206,958
45802,1,1,415,1293,878
45803,1,1,103,2066,1963
45804,0,0,55,0,-55
45805,1,0,61,0,-61
45806,0,0,112,0,-112
45807,1,0,5,0,-5
45808,1,0,74,0,-74
45809,0,0,39,0,-39
45810,0,0,9,0,-9
45811,1,0,81,0,-81
45812,0,0,15,0,-15
45813,1,0,137,0,-137
45814,1,0,5,0,-5
45815,1,0,42,0,-42
45816,1,0,8,0,-8
45817,1,0,21,0,-21
45818,1,1,140,1206,1066
45819,1,0,22,0,-22
45820,1,1,1114,1682,568
45821,1,1,783,1217,434
45822,1,1,1776,1960,184
45823,1,0,13,0,-13
45824,1,0,0,0,0
45825,0,0,1,0,-1
45826,1,1,675,1933,1258
45827,1,0,13,0,-13
45828,0,0,98,0,-98
45829,0,0,7,0,-7
45830,1,0,70,0,-70
45831,1,0,173,0,-173
45832,1,1,221,1998,1777
45833,0,0,38,0,-38
45834,0,0,1,0,-1
45835,0,0,47,0,-47
45836,1,0,71,0,-71
45837,0,0,59,0,-59
45838,1,1,105,1567,1462
45839,1,1,121,1249,1128
45840,0,0,66,0,-66
45841,0,0,43,0,-43
45842,0,0,25,0,-25
45843,1,1,220,1221,1001
45844,0,0,53,0,-53
45845,1,0,125,0,-125
45846,1,0,75,0,-75
45847,1,0,37,0,-37
45848,0,0,59,0,-59
45849,0,0,80,0,-80
45850,0,0,9,0,-9
45851,1,0,5,0,-5
45852,1,1,250,2889,2639
45853,1,1,3,1413,1410
45854,1,0,92,0,-92
45855,0,0,1,0,-1
45856,1,1,733,1456,723
45857,0,0,10,0,-10
45858,1,1,1298,1657,359
45859,1,1,393,1299,906
45860,1,0,12,0,-12
45861,1,0,31,0,-31
45862,0,0,67,0,-67
45863,0,0,29,0,-29
45864,1,1,131,1446,1315
45865,1,1,395,1529,1134
45866,0,0,5,0,-5
45867,0,0,130,0,-130
45868,0,0,19,0,-19
45869,1,0,64,0,-64
45870,0,0,3,0,-3
45871,1,0,12,0,-12
45872,0,0,70,0,-70
45873,1,1,232,1234,1002
45874,1,1,679,1236,557
45875,1,1,665,1798,1133
45876,0,0,32,0,-32
45877,1,0,6,0,-6
45878,0,0,3,0,-3
45879,1,0,125,0,-125
45880,0,0,34,0,-34
45881,0,0,13,0,-13
45882,1,0,35,0,-35
45883,0,0,48,0,-48
45884,1,1,324,1566,1242
45885,0,0,33,0,-33
45886,1,0,193,0,-193
45887,1,1,1501,1273,-228
45888,1,1,377,1737,1360
45889,1,1,340,1398,1058
45890,1,0,19,0,-19
45891,0,0,27,0,-27
45892,0,0,9,0,-9
45893,1,1,978,1232,254
45894,1,0,41,0,-41
45895,1,1,2009,1309,-700
45896,1,1,264,1654,1390
45897,1,0,7,0,-7
45898,1,0,43,0,-43
45899,1,1,87,1315,1228
45900,1,0,29,0,-29
45901,1,0,141,0,-141
45902,0,0,25,0,-25
45903,1,0,224,0,-224
45904,1,1,92,2801,2709
45905,0,0,25,0,-25
45906,1,0,8,0,-8
45907,1,1,223,1233,1010
45908,0,0,18,0,-18
45909,0,0,81,0,-81
45910,0,0,42,0,-42
45911,1,0,175,0,-175
45912,0,0,8,0,-8
45913,1,1,451,1244,793
45914,1,0,89,0,-89
45915,1,1,997,1377,380
45916,1,0,18,0,-18
45917,1,1,153,2148,1995
45918,1,0,9,0,-9
45919,0,0,5,0,-5
45920,1,1,359,1545,1186
45921,0,0,10,0,-10
45922,0,0,208,0,-208
45923,0,0,40,0,-40
45924,1,0,14,0,-14
45925,0,0,0,0,0
45926,0,0,29,0,-29
45927,0,0,15,0,-15
45928,0,0,121,0,-121
45929,1,1,291,1710,1419
45930,1,1,184,1556,1372
45931,0,0,137,0,-137
45932,0,0,72,0,-72
45933,0,0,28,0,-28
45934,1,1,1163,1336,173
45935,0,0,17,0,-17
45936,1,0,26,0,-26
45937,1,1,1820,1206,-614
45938,0,0,208,0,-208
45939,1,1,479,3328,2849
45940,1,1,115,2176,2061
45941,1,1,73,1308,1235
45942,1,1,432,2440,2008
45943,1,1,831,1323,492
45944,1,0,49,0,-49
45945,0,0,36,0,-36
45946,0,0,6,0,-6
45947,1,1,44,1525,1481
45948,1,1,629,1223,594
45949,1,1,98,1451,1353
45950,1,1,391,2556,2165
45951,1,1,181,2135,1954
45952,0,0,100,0,-100
45953,0,0,34,0,-34
45954,0,0,66,0,-66
45955,0,0,110,0,-110
45956,1,1,1113,1416,303
45957,1,1,179,1920,1741
45958,0,0,95,0,-95
45959,1,0,94,0,-94
45960,1,0,38,0,-38
45961,1,0,108,0,-108
45962,1,1,472,1584,1112
45963,0,0,109,0,-109
45964,1,0,49,0,-49
45965,0,0,59,0,-59
45966,0,0,3,0,-3
45967,1,1,1031,1231,200
45968,1,0,63,0,-63
45969,1,1,64,1503,1439
45970,1,1,65,1257,1192
45971,1,0,8,0,-8
45972,1,1,343,2021,1678
45973,1,0,25,0,-25
45974,1,0,109,0,-109
45975,1,0,64,0,-64
45976,0,0,154,0,-154
45977,1,0,92,0,-92
45978,1,1,81,1413,1332
45979,1,1,957,1497,540
45980,1,1,111,2002,1891
45981,0,0,35,0,-35
45982,1,0,17,0,-17
45983,0,0,29,0,-29
45984,1,1,73,1323,1250
45985,0,0,119,0,-119
45986,1,0,16,0,-16
45987,0,0,5,0,-5
45988,0,0,31,0,-31
45989,0,0,41,0,-41
45990,1,1,138,1331,1193
45991,1,0,11,0,-11
45992,0,0,17,0,-17
45993,0,0,144,0,-144
45994,1,1,468,1746,1278
45995,1,0,120,0,-120
45996,0,0,111,0,-111
45997,1,0,46,0,-46
45998,1,0,54,0,-54
45999,1,0,96,0,-96
46000,0,0,14,0,-14
46001,1,0,3,0,-3
46002,1,1,83,1226,1143
46003,1,0,3,0,-3
46004,1,0,62,0,-62
46005,1,1,562,1463,901
46006,1,0,4,0,-4
46007,0,0,7,0,-7
46008,1,0,95,0,-95
46009,1,0,32,0,-32
46010,1,0,27,0,-27
46011,0,0,55,0,-55
46012,1,0,219,0,-219
46013,1,0,18,0,-18
46014,1,1,848,1274,426
46015,1,1,680,1267,587
46016,1,0,279,0,-279
46017,1,1,1679,1500,-179
46018,0,0,81,0,-81
46019,1,0,24,0,-24
46020,1,0,20,0,-20
46021,0,0,44,0,-44
46022,1,0,1,0,-1
46023,1,0,118,0,-118
46024,0,0,65,0,-65
46025,1,1,330,1395,1065
46026,1,1,630,1361,731
46027,1,0,55,0,-55
46028,0,0,1,0,-1
46029,1,1,683,2518,1835
46030,1,1,985,1357,372
46031,0,0,22,0,-22
46032,0,0,22,0,-22
46033,0,0,51,0,-51
46034,1,1,693,1344,651
46035,1,1,212,1697,1485
46036,1,1,829,1215,386
46037,1,1,329,2510,2181
46038,1,1,636,1517,881
46039,1,0,15,0,-15
46040,0,0,8,0,-8
46041,1,1,93,1539,1446
46042,1,0,89,0,-89
46043,1,0,0,0,0
46044,0,0,49,0,-49
46045,0,0,8,0,-8
46046,1,0,80,0,-80
46047,1,0,98,0,-98
46048,1,1,860,1327,467
46049,1,1,519,1880,1361
46050,1,0,53,0,-53
46051,0,0,40,0,-40
46052,0,0,48,0,-48
46053,1,1,681,1420,739
46054,1,0,11,0,-11
46055,1,1,149,1417,1268
46056,1,1,55,1330,1275
46057,0,0,2,0,-2
46058,1,0,94,0,-94
46059,0,0,4,0,-4
46060,0,0,8,0,-8
46061,1,1,234,1299,1065
46062,1,1,451,1934,1483
46063,1,1,762,1317,555
46064,0,0,28,0,-28
46065,0,0,21,0,-21
46066,0,0,61,0,-61
46067,1,1,209,1216,1007
46068,1,0,36,0,-36
46069,1,0,36,0,-36
46070,1,0,52,0,-52
46071,0,0,119,0,-119
46072,1,0,57,0,-57
46073,0,0,30,0,-30
46074,1,1,715,1830,1115
46075,0,0,139,0,-139
46076,1,0,140,0,-140
46077,0,0,135,0,-135
46078,1,1,1842,2153,311
46079,0,0,36,0,-36
46080,1,1,420,1580,1160
46081,1,1,205,1356,1151
46082,0,0,5,0,-5
46083,1,1,49,3178,3129
46084,1,0,50,0,-50
46085,1,0,109,0,-109
46086,1,0,9,0,-9
46087,1,1,92,2077,1985
46088,1,0,35,0,-35
46089,0,0,17,0,-17
46090,1,0,4,0,-4
46091,1,0,28,0,-28
46092,1,1,367,1458,1091
46093,1,0,66,0,-66
46094,0,0,5,0,-5
46095,1,0,24,0,-24
46096,1,1,594,1944,1350
46097,1,0,7,0,-7
46098,1,1,927,1276,349
46099,1,0,26,0,-26
46100,1,1,151,1479,1328
46101,1,0,31,0,-31
46102,0,0,118,0,-118
46103,1,0,93,0,-93
46104,1,1,193,1790,1597
46105,1,0,53,0,-53
46106,0,0,111,0,-111
46107,0,0,15,0,-15
46108,0,0,33,0,-33
46109,1,1,2057,1525,-532
46110,1,0,12,0,-12
46111,1,0,15,0,-15
46112,1,1,864,1221,357
46113,1,0,25,0,-25
46114,0,0,88,0,-88
46115,0,0,14,0,-14
46116,0,0,43,0,-43
46117,1,1,627,1789,1162
46118,1,1,40,1263,1223
46119,1,0,9,0,-9
46120,1,0,23,0,-23
46121,1,1,1485,1257,-228
46122,1,0,74,0,-74
46123,1,1,540,1379,839
46124,1,1,300,1767,1467
46125,0,0,55,0,-55
46126,1,0,3,0,-3
46127,1,0,7,0,-7
46128,0,0,176,0,-176
46129,1,0,10,0,-10
46130,1,1,355,1452,1097
46131,1,1,647,1229,582
46132,1,0,124,0,-124
46133,0,0,10,0,-10
46134,1,0,8,0,-8
46135,1,1,503,1774,1271
46136,0,0,57,0,-57
46137,1,1,115,3231,3116
46138,1,0,74,0,-74
46139,1,1,248,1222,974
46140,1,1,855,1695,840
46141,1,0,34,0,-34
46142,1,0,5,0,-5
46143,0,0,52,0,-52
46144,1,0,9,0,-9
46145,0,0,43,0,-43
46146,1,0,6,0,-6
46147,0,0,101,0,-101
46148,1,1,1563,1306,-257
46149,1,1,830,1435,605
46150,1,1,608,1482,874
46151,1,0,71,0,-71
46152,1,1,637,1431,794
46153,1,1,807,1491,684
46154,1,1,516,1406,890
46155,1,1,117,1436,1319
46156,1,1,2144,1755,-389
46157,1,1,486,1358,872
46158,1,0,16,0,-16
46159,1,1,60,1224,1164
46160,1,0,24,0,-24
46161,0,0,60,0,-60
46162,0,0,37,0,-37
46163,1,1,83,1364,1281
46164,0,0,5,0,-5
46165,0,0,52,0,-52
46166,1,0,109,0,-109
46167,1,0,2,0,-2
46168,0,0,50,0,-50
46169,1,0,51,0,-51
46170,0,0,4,0,-4
46171,1,0,53,0,-53
46172,0,0,102,0,-102
46173,0,0,34,0,-34
46174,1,0,69,0,-69
46175,0,0,24,0,-24
46176,1,1,126,1314,1188
46177,1,0,30,0,-30
46178,0,0,83,0,-83
46179,1,0,30,0,-30
46180,1,0,28,0,-28
46181,0,0,4,0,-4
46182,1,0,103,0,-103
46183,1,0,0,0,0
46184,0,0,64,0,-64
46185,0,0,7,0,-7
46186,0,0,114,0,-114
46187,1,0,44,0,-44
46188,0,0,68,0,-68
46189,1,0,50,0,-50
46190,1,1,761,1314,553
46191,0,0,29,0,-29
46192,1,1,154,1474,1320
46193,0,0,45,0,-45
46194,1,0,10,0,-10
46195,0,0,12,0,-12
46196,1,1,231,1236,1005
46197,1,0,22,0,-22
46198,0,0,49,0,-49
46199,0,0,113,0,-113
46200,0,0,55,0,-55
46201,1,0,121,0,-121
46202,1,1,826,1246,420
46203,0,0,14,0,-14
46204,1,1,519,1342,823
46205,1,1,157,1230,1073
46206,1,1,100,5565,5465
46207,1,0,4,0,-4
46208,1,1,92,1507,1415
46209,0,0,6,0,-6
46210,0,0,34,0,-34
46211,1,1,397,1248,851
46212,1,0,2,0,-2
46213,0,0,38,0,-38
46214,0,0,95,0,-95
46215,1,1,438,1616,1178
46216,1,0,124,0,-124
46217,1,1,517,1538,1021
46218,1,0,73,0,-73
46219,0,0,31,0,-31
46220,1,0,129,0,-129
46221,1,1,201,1262,1061
46222,0,0,42,0,-42
46223,0,0,18,0,-18
46224,0,0,67,0,-67
46225,0,0,14,0,-14
46226,1,0,19,0,-19
46227,1,1,293,1985,1692
46228,0,0,64,0,-64
46229,1,1,405,1246,841
46230,1,0,58,0,-58
46231,0,0,65,0,-65
46232,1,1,209,1632,1423
46233,0,0,93,0,-93
46234,1,0,0,0,0
46235,1,1,366,1295,929
46236,0,0,20,0,-20
46237,1,1,461,1366,905
46238,1,1,201,1603,1402
46239,0,0,220,0,-220
46240,1,1,96,1428,1332
46241,0,0,11,0,-11
46242,1,1,348,2211,1863
46243,0,0,80,0,-80
46244,0,0,166,0,-166
46245,0,0,116,0,-116
46246,0,0,14,0,-14
46247,1,0,76,0,-76
46248,1,0,5,0,-5
46249,1,1,143,1351,1208
46250,1,1,1615,2062,447
46251,0,0,45,0,-45
46252,1,0,26,0,-26
46253,1,1,31,2715,2684
46254,0,0,66,0,-66
46255,1,0,0,0,0
46256,1,0,71,0,-71
46257,0,0,24,0,-24
46258,1,1,58,1881,1823
46259,1,1,107,2597,2490
46260,1,1,175,1443,1268
46261,1,0,14,0,-14
46262,1,1,74,1706,1632
46263,0,0,118,0,-118
46264,0,0,63,0,-63
46265,0,0,34,0,-34
46266,1,0,52,0,-52
46267,0,0,88,0,-88
46268,1,0,84,0,-84
46269,1,1,66,2056,1990
46270,0,0,76,0,-76
46271,1,0,87,0,-87
46272,1,1,593,2259,1666
46273,1,1,484,1370,886
46274,1,0,45,0,-45
46275,1,1,303,1737,1434
46276,0,0,107,0,-107
46277,0,0,18,0,-18
46278,1,0,55,0,-55
46279,0,0,24,0,-24
46280,1,0,11,0,-11
46281,1,0,7,0,-7
46282,1,0,9,0,-9
46283,1,1,494,1524,1030
46284,1,0,11,0,-11
46285,1,0,0,0,0
46286,0,0,29,0,-29
46287,1,0,159,0,-159
46288,1,1,2177,1260,-917
46289,0,0,11,0,-11
46290,1,0,95,0,-95
46291,1,1,207,1792,1585
46292,0,0,65,0,-65
46293,0,0,24,0,-24
46294,1,1,763,1263,500
46295,1,1,259,1607,1348
46296,0,0,70,0,-70
46297,1,0,88,0,-88
46298,1,0,17,0,-17
46299,0,0,17,0,-17
46300,1,1,503,1343,840
46301,0,0,47,0,-47
46302,0,0,62,0,-62
46303,1,0,28,0,-28
46304,1,1,1331,1430,99
46305,0,0,14,0,-14
46306,1,1,51,1628,1577
46307,1,1,36,1217,1181
46308,1,1,762,1659,897
46309,0,0,61,0,-61
46310,1,1,799,1678,879
46311,1,0,71,0,-71
46312,1,0,154,0,-154
46313,1,1,727,1327,600
46314,0,0,88,0,-88
46315,1,0,74,0,-74
46316,0,0,12,0,-12
46317,1,1,233,5935,5702
46318,0,0,3,0,-3
46319,1,1,195,2360,2165
46320,1,1,167,1488,1321
46321,0,0,37,0,-37
46322,1,1,254,1226,972
46323,0,0,127,0,-127
46324,1,1,1175,1236,61
46325,1,0,4,0,-4
46326,1,0,57,0,-57
46327,0,0,131,0,-131
46328,1,0,39,0,-39
46329,1,1,210,3125,2915
46330,0,0,59,0,-59
46331,1,1,116,1509,1393
46332,0,0,46,0,-46
46333,0,0,67,0,-67
46334,1,0,42,0,-42
46335,1,1,345,1380,1035
46336,0,0,70,0,-70
46337,0,0,62,0,-62
46338,1,0,107,0,-107
46339,0,0,12,0,-12
46340,1,1,819,1225,406
46341,1,1,69,1210,1141
46342,1,0,34,0,-34
46343,1,0,94,0,-94
46344,0,0,159,0,-159
46345,0,0,14,0,-14
46346,1,0,15,0,-15
46347,0,0,24,0,-24
46348,1,0,18,0,-18
46349,0,0,60,0,-60
46350,1,0,35,0,-35
46351,0,0,13,0,-13
46352,0,0,20,0,-20
46353,1,1,711,2510,1799
46354,0,0,46,0,-46
46355,1,1,201,1668,1467
46356,1,0,9,0,-9
46357,0,0,133,0,-133
46358,0,0,7,0,-7
46359,0,0,140,0,-140
46360,1,1,114,1207,1093
46361,0,0,66,0,-66
46362,0,0,8,0,-8
46363,0,0,13,0,-13
46364,1,0,11,0,-11
46365,0,0,37,0,-37
46366,1,0,149,0,-149
46367,1,0,133,0,-133
46368,1,1,707,1902,1195
46369,1,0,4,0,-4
46370,1,0,60,0,-60
46371,1,1,1929,1550,-379
46372,0,0,19,0,-19
46373,0,0,57,0,-57
46374,1,1,310,1272,962
46375,1,1,811,1208,397
46376,1,0,1,0,-1
46377,1,1,572,1358,786
46378,1,0,28,0,-28
46379,1,1,596,1208,612
46380,0,0,4,0,-4
46381,1,1,620,1223,603
46382,0,0,30,0,-30
46383,1,0,14,0,-14
46384,1,1,988,1301,313
46385,0,0,85,0,-85
46386,0,0,20,0,-20
46387,0,0,78,0,-78
46388,1,1,151,2583,2432
46389,1,0,6,0,-6
46390,1,0,16,0,-16
46391,1,1,1261,1562,301
46392,1,1,192,1675,1483
46393,1,0,73,0,-73
46394,0,0,9,0,-9
46395,0,0,35,0,-35
46396,0,0,15,0,-15
46397,0,0,24,0,-24
46398,0,0,6,0,-6
46399,1,0,24,0,-24
46400,1,0,106,0,-106
46401,1,1,36,1449,1413
46402,1,1,381,1425,1044
46403,1,0,81,0,-81
46404,1,1,422,1204,782
46405,0,0,53,0,-53
46406,1,1,586,2303,1717
46407,0,0,2,0,-2
46408,1,0,20,0,-20
46409,1,1,220,3046,2826
46410,1,1,138,1217,1079
46411,0,0,73,0,-73
46412,0,0,133,0,-133
46413,0,0,59,0,-59
46414,0,0,68,0,-68
46415,1,1,744,1210,466
46416,1,1,83,1433,1350
46417,0,0,136,0,-136
46418,0,0,164,0,-164
46419,1,1,649,1580,931
46420,0,0,34,0,-34
46421,0,0,10,0,-10
46422,1,0,17,0,-17
46423,0,0,6,0,-6
46424,1,1,679,1258,579
46425,1,1,435,1520,1085
46426,1,0,94,0,-94
46427,1,1,253,1267,1014
46428,0,0,11,0,-11
46429,1,1,2007,1235,-772
46430,1,0,32,0,-32
46431,1,0,27,0,-27
46432,0,0,16,0,-16
46433,1,1,919,1353,434
46434,0,0,94,0,-94
46435,1,1,281,1340,1059
46436,1,1,720,2137,1417
46437,0,0,30,0,-30
46438,1,0,352,0,-352
46439,1,1,515,1211,696
46440,0,0,178,0,-178
46441,1,0,10,0,-10
46442,0,0,20,0,-20
46443,1,1,447,2746,2299
46444,1,1,1173,1285,112
46445,1,1,730,1274,544
46446,0,0,14,0,-14
46447,0,0,9,0,-9
46448,1,1,748,1245,497
46449,0,0,14,0,-14
46450,0,0,5,0,-5
46451,1,1,973,1442,469
46452,0,0,167,0,-167
46453,0,0,39,0,-39
46454,0,0,78,0,-78
46455,0,0,0,0,0
46456,1,1,968,1249,281
46457,0,0,37,0,-37
46458,1,1,306,1335,1029
46459,1,1,1022,1267,245
46460,1,0,33,0,-33
46461,0,0,35,0,-35
46462,1,1,1456,1456,0
46463,0,0,7,0,-7
46464,1,0,157,0,-157
46465,1,1,228,1386,1158
46466,1,0,9,0,-9
46467,0,0,112,0,-112
46468,1,1,920,1289,369
46469,0,0,88,0,-88
46470,0,0,4,0,-4
46471,1,1,1471,1305,-166
46472,0,0,60,0,-60
46473,1,0,235,0,-235
46474,1,1,257,1232,975
46475,0,0,79,0,-79
46476,1,1,29,1637,1608
46477,0,0,2,0,-2
46478,1,0,2,0,-2
46479,1,0,0,0,0
46480,1,1,659,3122,2463
46481,1,1,1168,1286,118
46482,0,0,8,0,-8
46483,0,0,0,0,0
46484,1,0,45,0,-45
46485,0,0,110,0,-110
46486,1,0,42,0,-42
46487,1,1,289,2005,1716
46488,1,1,76,1202,1126
46489,1,1,527,1242,715
46490,1,0,11,0,-11
46491,1,0,80,0,-80
46492,0,0,11,0,-11
46493,1,0,12,0,-12
46494,0,0,7,0,-7
46495,1,0,21,0,-21
46496,0,0,98,0,-98
46497,0,0,15,0,-15
46498,0,0,105,0,-105
46499,0,0,9,0,-9
46500,0,0,0,0,0
46501,1,0,80,0,-80
46502,1,1,162,1266,1104
46503,0,0,51,0,-51
46504,0,0,27,0,-27
46505,0,0,34,0,-34
46506,0,0,112,0,-112
46507,0,0,6,0,-6
46508,0,0,25,0,-25
46509,1,1,574,2140,1566
46510,0,0,18,0,-18
46511,0,0,8,0,-8
46512,0,0,6,0,-6
46513,1,1,953,1208,255
46514,1,1,72,1225,1153
46515,0,0,59,0,-59
46516,1,1,42,1269,1227
46517,1,1,384,1453,1069
46518,0,0,86,0,-86
46519,0,0,30,0,-30
46520,0,0,12,0,-12
46521,1,1,154,1492,1338
46522,1,0,85,0,-85
46523,0,0,12,0,-12
46524,0,0,13,0,-13
46525,0,0,46,0,-46
46526,1,0,124,0,-124
46527,1,0,24,0,-24
46528,0,0,14,0,-14
46529,0,0,66,0,-66
46530,0,0,8,0,-8
46531,0,0,2,0,-2
46532,1,0,19,0,-19
46533,0,0,8,0,-8
46534,0,0,4,0,-4
46535,1,0,229,0,-229
46536,1,1,573,1493,920
46537,0,0,23,0,-23
46538,0,0,23,0,-23
46539,1,1,88,1345,1257
46540,1,0,8,0,-8
46541,0,0,15,0,-15
46542,1,0,70,0,-70
46543,0,0,99,0,-99
46544,1,0,12,0,-12
46545,1,1,121,1367,1246
46546,1,1,1005,1226,221
46547,0,0,5,0,-5
46548,0,0,197,0,-197
46549,1,1,112,1680,1568
46550,1,0,3,0,-3
46551,1,0,45,0,-45
46552,0,0,49,0,-49
46553,0,0,0,0,0
46554,1,0,50,0,-50
46555,1,0,10,0,-10
46556,1,1,347,1520,1173
46557,1,1,20,1607,1587
46558,1,0,164,0,-164
46559,0,0,35,0,-35
46560,0,0,46,0,-46
46561,1,1,723,3019,2296
46562,1,1,508,1277,769
46563,1,1,238,1784,1546
46564,1,0,7,0,-7
46565,0,0,22,0,-22
46566,0,0,0,0,0
46567,1,1,275,2132,1857
46568,1,0,5,0,-5
46569,1,0,55,0,-55
46570,0,0,16,0,-16
46571,1,0,35,0,-35
46572,1,0,77,0,-77
46573,1,1,519,2671,2152
46574,1,1,295,1319,1024
46575,0,0,12,0,-12
46576,0,0,14,0,-14
46577,1,0,10,0,-10
46578,1,0,30,0,-30
46579,1,0,3,0,-3
46580,0,0,38,0,-38
46581,0,0,19,0,-19
46582,1,0,7,0,-7
46583,1,0,7,0,-7
46584,0,0,4,0,-4
46585,1,0,33,0,-33
46586,1,0,35,0,-35
46587,1,0,24,0,-24
46588,0,0,26,0,-26
46589,0,0,48,0,-48
46590,0,0,29,0,-29
46591,0,0,140,0,-140
46592,1,1,287,1868,1581
46593,1,1,595,1214,619
46594,1,0,47,0,-47
46595,0,0,49,0,-49
46596,1,1,190,1709,1519
46597,0,0,145,0,-145
46598,0,0,23,0,-23
46599,1,1,1601,1341,-260
46600,1,1,346,1341,995
46601,0,0,34,0,-34
46602,0,0,75,0,-75
46603,1,0,0,0,0
46604,1,0,19,0,-19
46605,0,0,9,0,-9
46606,1,0,84,0,-84
46607,0,0,61,0,-61
46608,1,1,788,1236,448
46609,1,1,532,1261,729
46610,1,0,46,0,-46
46611,1,0,69,0,-69
46612,1,0,94,0,-94
46613,1,1,1356,2268,912
46614,0,0,46,0,-46
46615,0,0,4,0,-4
46616,1,1,583,1208,625
46617,0,0,27,0,-27
46618,0,0,16,0,-16
46619,0,0,26,0,-26
46620,1,0,19,0,-19
46621,0,0,48,0,-48
46622,1,1,90,2019,1929
46623,1,1,435,1445,1010
46624,1,0,39,0,-39
46625,1,1,102,1247,1145
46626,1,1,1147,4202,3055
46627,0,0,72,0,-72
46628,1,1,357,2906,2549
46629,1,1,1563,1330,-233
46630,1,0,2,0,-2
46631,0,0,38,0,-38
46632,1,1,83,1428,1345
46633,1,1,179,1583,1404
46634,0,0,150,0,-150
46635,0,0,16,0,-16
46636,0,0,7,0,-7
46637,1,0,50,0,-50
46638,0,0,5,0,-5
46639,1,0,59,0,-59
46640,0,0,12,0,-12
46641,0,0,50,0,-50
46642,1,0,77,0,-77
46643,1,1,1117,1587,470
46644,1,1,343,1419,1076
46645,1,0,47,0,-47
46646,1,0,67,0,-67
46647,1,1,36,1355,1319
46648,0,0,4,0,-4
46649,1,1,628,1271,643
46650,0,0,16,0,-16
46651,0,0,15,0,-15
46652,1,0,25,0,-25
46653,1,0,32,0,-32
46654,1,1,196,1247,1051
46655,1,0,70,0,-70
46656,1,0,4,0,-4
46657,1,0,54,0,-54
46658,1,1,697,1203,506
46659,1,1,330,1714,1384
46660,0,0,26,0,-26
46661,0,0,99,0,-99
46662,1,0,1,0,-1
46663,1,0,8,0,-8
46664,1,0,125,0,-125
46665,1,0,32,0,-32
46666,0,0,36,0,-36
46667,0,0,35,0,-35
46668,1,1,415,1508,1093
46669,1,0,28,0,-28
46670,1,1,437,1209,772
46671,1,0,20,0,-20
46672,1,1,707,1403,696
46673,1,0,26,0,-26
46674,1,1,292,1343,1051
46675,0,0,134,0,-134
46676,1,0,31,0,-31
46677,1,0,43,0,-43
46678,1,1,56,1437,1381
46679,1,1,820,1360,540
46680,1,0,99,0,-99
46681,1,1,714,1420,706
46682,1,1,225,1232,1007
46683,1,0,63,0,-63
46684,1,0,21,0,-21
46685,0,0,103,0,-103
46686,0,0,187,0,-187
46687,1,0,73,0,-73
46688,0,0,15,0,-15
46689,1,1,356,1663,1307
46690,0,0,84,0,-84
46691,0,0,29,0,-29
46692,1,1,540,3723,3183
46693,1,1,1019,1402,383
46694,1,0,17,0,-17
46695,1,0,11,0,-11
46696,1,0,0,0,0
46697,1,1,712,1303,591
46698,0,0,47,0,-47
46699,0,0,31,0,-31
46700,1,1,1873,2241,368
46701,0,0,32,0,-32
46702,0,0,85,0,-85
46703,0,0,2,0,-2
46704,1,1,160,1473,1313
46705,1,0,71,0,-71
46706,0,0,68,0,-68
46707,1,1,652,1270,618
46708,0,0,31,0,-31
46709,1,1,963,1323,360
46710,0,0,7,0,-7
46711,0,0,22,0,-22
46712,1,0,49,0,-49
46713,1,1,332,1239,907
46714,1,0,21,0,-21
46715,0,0,14,0,-14
46716,1,1,1185,1292,107
46717,1,0,18,0,-18
46718,0,0,108,0,-108
46719,0,0,5,0,-5
46720,0,0,201,0,-201
46721,1,1,632,1323,691
46722,0,0,23,0,-23
46723,1,1,675,3572,2897
46724,1,1,167,1317,1150
46725,0,0,55,0,-55
46726,1,0,47,0,-47
46727,1,0,6,0,-6
46728,1,1,75,1204,1129
46729,0,0,31,0,-31
46730,0,0,14,0,-14
46731,1,0,6,0,-6
46732,1,0,6,0,-6
46733,1,1,427,1330,903
46734,0,0,31,0,-31
46735,0,0,45,0,-45
46736,1,0,76,0,-76
46737,1,1,580,1989,1409
46738,1,0,112,0,-112
46739,0,0,110,0,-110
46740,1,1,229,1389,1160
46741,1,1,221,1377,1156
46742,0,0,8,0,-8
46743,1,0,136,0,-136
46744,0,0,19,0,-19
46745,1,0,11,0,-11
46746,1,1,336,1293,957
46747,1,0,8,0,-8
46748,0,0,14,0,-14
46749,0,0,118,0,-118
46750,0,0,100,0,-100
46751,1,1,495,1670,1175
46752,1,1,561,1254,693
46753,0,0,5,0,-5
46754,0,0,11,0,-11
46755,0,0,17,0,-17
46756,0,0,33,0,-33
46757,1,1,1142,1312,170
46758,1,0,171,0,-171
46759,1,0,25,0,-25
46760,1,0,1,0,-1
46761,0,0,9,0,-9
46762,0,0,17,0,-17
46763,1,1,533,1286,753
46764,1,0,120,0,-120
46765,1,1,129,1930,1801
46766,1,0,8,0,-8
46767,0,0,1,0,-1
46768,1,1,757,1683,926
46769,0,0,34,0,-34
46770,0,0,16,0,-16
46771,0,0,77,0,-77
46772,0,0,182,0,-182
46773,1,0,95,0,-95
46774,0,0,165,0,-165
46775,1,0,29,0,-29
46776,0,0,56,0,-56
46777,0,0,8,0,-8
46778,1,1,817,1284,467
46779,0,0,61,0,-61
46780,1,0,56,0,-56
46781,0,0,110,0,-110
46782,1,1,1625,1336,-289
46783,0,0,80,0,-80
46784,1,0,58,0,-58
46785,1,1,1182,1263,81
46786,1,1,63,1798,1735
46787,1,0,87,0,-87
46788,1,1,939,1454,515
46789,1,0,30,0,-30
46790,1,1,376,1379,1003
46791,0,0,137,0,-137
46792,0,0,25,0,-25
46793,1,1,1764,1222,-542
46794,1,1,2457,2083,-374
46795,1,1,79,1280,1201
46796,1,0,104,0,-104
46797,1,0,33,0,-33
46798,0,0,33,0,-33
46799,1,1,431,1514,1083
46800,1,0,0,0,0
46801,1,0,115,0,-115
46802,1,0,34,0,-34
46803,1,1,1650,3273,1623
46804,1,1,1288,1344,56
46805,0,0,62,0,-62
46806,0,0,118,0,-118
46807,0,0,53,0,-53
46808,1,1,631,2017,1386
46809,0,0,89,0,-89
46810,1,0,33,0,-33
46811,1,1,870,1317,447
46812,0,0,197,0,-197
46813,1,0,2,0,-2
46814,1,1,98,2280,2182
46815,0,0,82,0,-82
46816,1,0,61,0,-61
46817,1,0,130,0,-130
46818,1,0,84,0,-84
46819,0,0,101,0,-101
46820,1,1,390,1364,974
46821,0,0,110,0,-110
46822,1,1,649,1367,718
46823,0,0,72,0,-72
46824,1,1,38,1784,1746
46825,1,1,575,1634,1059
46826,0,0,105,0,-105
46827,0,0,34,0,-34
46828,1,1,113,3952,3839
46829,0,0,59,0,-59
46830,0,0,9,0,-9
46831,0,0,15,0,-15
46832,0,0,27,0,-27
46833,1,0,32,0,-32
46834,1,0,104,0,-104
46835,0,0,13,0,-13
46836,1,0,2,0,-2
46837,0,0,64,0,-64
46838,1,0,83,0,-83
46839,1,0,140,0,-140
46840,1,0,13,0,-13
46841,1,0,6,0,-6
46842,0,0,84,0,-84
46843,1,1,90,1217,1127
46844,0,0,173,0,-173
46845,0,0,2,0,-2
46846,0,0,50,0,-50
46847,0,0,5,0,-5
46848,1,0,3,0,-3
46849,1,1,179,1442,1263
46850,0,0,8,0,-8
46851,0,0,28,0,-28
46852,1,1,601,1303,702
46853,0,0,59,0,-59
46854,0,0,41,0,-41
46855,1,0,18,0,-18
46856,1,1,313,1327,1014
46857,1,0,37,0,-37
46858,1,1,12,2109,2097
46859,0,0,10,0,-10
46860,0,0,99,0,-99
46861,0,0,23,0,-23
46862,1,1,91,1767,1676
46863,1,0,52,0,-52
46864,1,1,1016,1300,284
46865,0,0,50,0,-50
46866,1,1,295,1935,1640
46867,0,0,236,0,-236
46868,0,0,62,0,-62
46869,1,0,15,0,-15
46870,1,1,440,1399,959
46871,0,0,37,0,-37
46872,0,0,7,0,-7
46873,1,0,144,0,-144
46874,1,0,14,0,-14
46875,0,0,6,0,-6
46876,0,0,79,0,-79
46877,1,0,5,0,-5
46878,0,0,7,0,-7
46879,0,0,1,0,-1
46880,1,0,4,0,-4
46881,1,1,99,1344,1245
46882,1,0,5,0,-5
46883,1,1,477,1370,893
46884,1,1,674,1374,700
46885,1,1,351,1485,1134
46886,0,0,23,0,-23
46887,0,0,33,0,-33
46888,0,0,11,0,-11
46889,1,0,17,0,-17
46890,1,1,1246,1540,294
46891,1,1,511,1208,697
46892,0,0,79,0,-79
46893,1,1,77,1471,1394
46894,0,0,20,0,-20
46895,1,1,184,1237,1053
46896,1,1,199,1690,1491
46897,1,0,20,0,-20
46898,1,0,23,0,-23
46899,1,0,35,0,-35
46900,0,0,10,0,-10
46901,1,0,0,0,0
46902,1,1,1047,1231,184
46903,0,0,33,0,-33
46904,1,0,54,0,-54
46905,1,1,444,2573,2129
46906,1,1,526,1790,1264
46907,0,0,1,0,-1
46908,0,0,89,0,-89
46909,1,0,35,0,-35
46910,0,0,46,0,-46
46911,1,0,80,0,-80
46912,1,0,126,0,-126
46913,1,0,240,0,-240
46914,1,0,152,0,-152
46915,1,1,203,1608,1405
46916,0,0,4,0,-4
46917,0,0,6,0,-6
46918,0,0,9,0,-9
46919,0,0,3,0,-3
46920,1,0,43,0,-43
46921,0,0,100,0,-100
46922,1,1,314,1278,964
46923,1,0,14,0,-14
46924,1,0,38,0,-38
46925,0,0,144,0,-144
46926,0,0,48,0,-48
46927,1,0,16,0,-16
46928,1,0,69,0,-69
46929,0,0,29,0,-29
46930,0,0,30,0,-30
46931,1,1,628,1549,921
46932,0,0,32,0,-32
46933,0,0,82,0,-82
46934,1,1,112,1437,1325
46935,0,0,12,0,-12
46936,1,1,316,1531,1215
46937,1,0,11,0,-11
46938,0,0,37,0,-37
46939,0,0,32,0,-32
46940,1,0,96,0,-96
46941,1,0,16,0,-16
46942,0,0,51,0,-51
46943,1,1,207,1247,1040
46944,1,0,69,0,-69
46945,1,1,629,1266,637
46946,1,1,993,1335,342
46947,0,0,52,0,-52
46948,1,1,277,1553,1276
46949,1,0,12,0,-12
46950,1,1,952,1359,407
46951,0,0,62,0,-62
46952,1,1,496,1469,973
46953,1,1,291,1361,1070
46954,1,0,63,0,-63
46955,0,0,56,0,-56
46956,1,0,73,0,-73
46957,0,0,72,0,-72
46958,1,1,261,1915,1654
46959,0,0,107,0,-107
46960,1,0,123,0,-123
46961,0,0,110,0,-110
46962,0,0,212,0,-212
46963,1,1,421,2410,1989
46964,1,1,385,1892,1507
46965,0,0,9,0,-9
46966,1,1,503,2828,2325
46967,1,1,1914,1361,-553
46968,0,0,78,0,-78
46969,1,0,38,0,-38
46970,1,0,65,0,-65
46971,1,1,339,1346,1007
46972,0,0,115,0,-115
46973,0,0,163,0,-163
46974,0,0,23,0,-23
46975,0,0,32,0,-32
46976,0,0,3,0,-3
46977,0,0,88,0,-88
46978,1,0,16,0,-16
46979,1,0,64,0,-64
46980,1,0,87,0,-87
46981,1,0,26,0,-26
46982,0,0,19,0,-19
46983,0,0,1,0,-1
46984,1,1,616,1546,930
46985,1,0,131,0,-131
46986,1,1,212,1691,1479
46987,1,1,435,1386,951
46988,1,1,524,1469,945
46989,1,0,37,0,-37
46990,0,0,106,0,-106
46991,0,0,14,0,-14
46992,0,0,67,0,-67
46993,1,0,7,0,-7
46994,0,0,5,0,-5
46995,1,0,5,0,-5
46996,1,0,71,0,-71
46997,1,0,3,0,-3
46998,1,1,183,1261,1078
46999,0,0,41,0,-41
47000,1,0,140,0,-140
47001,1,0,77,0,-77
47002,1,0,49,0,-49
47003,1,1,521,1570,1049
47004,0,0,21,0,-21
47005,0,0,95,0,-95
47006,0,0,35,0,-35
47007,1,1,358,1200,842
47008,1,1,241,1221,980
47009,1,0,28,0,-28
47010,1,0,56,0,-56
47011,0,0,29,0,-29
47012,0,0,28,0,-28
47013,0,0,69,0,-69
47014,0,0,2,0,-2
47015,1,0,69,0,-69
47016,0,0,106,0,-106
47017,1,1,107,1468,1361
47018,0,0,1,0,-1
47019,1,1,475,1315,840
47020,0,0,125,0,-125
47021,0,0,68,0,-68
47022,1,1,445,1375,930
47023,0,0,32,0,-32
47024,1,1,491,1227,736
47025,0,0,2,0,-2
47026,0,0,172,0,-172
47027,1,1,1928,1290,-638
47028,1,0,8,0,-8
47029,1,1,1037,1364,327
47030,0,0,20,0,-20
47031,1,1,481,1467,986
47032,1,0,8,0,-8
47033,1,1,184,1259,1075
47034,1,1,1221,1625,404
47035,0,0,98,0,-98
47036,0,0,147,0,-147
47037,1,1,664,1293,629
47038,1,1,32,1202,1170
47039,1,0,42,0,-42
47040,0,0,52,0,-52
47041,0,0,4,0,-4
47042,0,0,82,0,-82
47043,1,1,728,1709,981
47044,0,0,71,0,-71
47045,0,0,50,0,-50
47046,0,0,49,0,-49
47047,1,0,216,0,-216
47048,1,0,39,0,-39
47049,0,0,109,0,-109
47050,0,0,74,0,-74
47051,1,0,143,0,-143
47052,1,0,33,0,-33
47053,1,1,134,2031,1897
47054,1,0,19,0,-19
47055,1,1,208,2153,1945
47056,0,0,22,0,-22
47057,1,1,232,2186,1954
47058,0,0,38,0,-38
47059,1,1,1008,1265,257
47060,1,1,90,1685,1595
47061,0,0,4,0,-4
47062,1,1,398,1315,917
47063,1,1,1065,1509,444
47064,1,0,105,0,-105
47065,1,1,1229,2284,1055
47066,0,0,111,0,-111
47067,1,1,794,2297,1503
47068,1,0,7,0,-7
47069,1,1,229,1248,1019
47070,1,1,486,1510,1024
47071,1,0,15,0,-15
47072,1,0,16,0,-16
47073,0,0,6,0,-6
47074,0,0,9,0,-9
47075,0,0,75,0,-75
47076,1,1,1476,1255,-221
47077,0,0,147,0,-147
47078,1,1,361,1993,1632
47079,1,0,27,0,-27
47080,1,0,34,0,-34
47081,1,1,176,2015,1839
47082,1,0,52,0,-52
47083,0,0,43,0,-43
47084,1,1,53,1416,1363
47085,1,0,32,0,-32
47086,0,0,20,0,-20
47087,0,0,89,0,-89
47088,1,0,3,0,-3
47089,0,0,144,0,-144
47090,0,0,2,0,-2
47091,0,0,138,0,-138
47092,0,0,72,0,-72
47093,1,0,15,0,-15
47094,0,0,16,0,-16
47095,1,1,423,1219,796
47096,0,0,39,0,-39
47097,0,0,1,0,-1
47098,0,0,110,0,-110
47099,1,0,12,0,-12
47100,0,0,57,0,-57
47101,1,1,917,1472,555
47102,1,0,104,0,-104
47103,1,1,213,1791,1578
47104,1,0,33,0,-33
47105,1,0,51,0,-51
47106,0,0,54,0,-54
47107,1,1,961,1487,526
47108,1,0,25,0,-25
47109,1,1,1150,1694,544
47110,0,0,47,0,-47
47111,0,0,103,0,-103
47112,1,0,0,0,0
47113,0,0,130,0,-130
47114,0,0,18,0,-18
47115,1,0,34,0,-34
47116,0,0,13,0,-13
47117,1,1,1225,1472,247
47118,0,0,17,0,-17
47119,0,0,256,0,-256
47120,1,1,1061,1514,453
47121,0,0,22,0,-22
47122,1,1,530,1263,733
47123,0,0,21,0,-21
47124,1,0,1,0,-1
47125,1,1,182,2580,2398
47126,0,0,6,0,-6
47127,1,1,806,1414,608
47128,1,0,5,0,-5
47129,0,0,62,0,-62
47130,0,0,22,0,-22
47131,0,0,44,0,-44
47132,1,1,1064,2880,1816
47133,0,0,4,0,-4
47134,0,0,21,0,-21
47135,1,0,146,0,-146
47136,1,1,1680,2450,770
47137,1,1,782,1212,430
47138,1,0,47,0,-47
47139,0,0,48,0,-48
47140,0,0,52,0,-52
47141,1,1,118,1232,1114
47142,0,0,265,0,-265
47143,0,0,40,0,-40
47144,0,0,6,0,-6
47145,0,0,13,0,-13
47146,1,0,51,0,-51
47147,1,1,60,1304,1244
47148,1,1,351,1775,1424
47149,0,0,10,0,-10
47150,1,0,2,0,-2
47151,1,1,32,1262,1230
47152,0,0,46,0,-46
47153,0,0,50,0,-50
47154,1,0,31,0,-31
47155,1,1,1721,1749,28
47156,1,0,112,0,-112
47157,0,0,2,0,-2
47158,0,0,8,0,-8
47159,1,1,903,1209,306
47160,1,1,804,1331,527
47161,1,1,162,1336,1174
47162,0,0,0,0,0
47163,1,0,14,0,-14
47164,0,0,116,0,-116
47165,0,0,9,0,-9
47166,1,0,24,0,-24
47167,0,0,46,0,-46
47168,1,1,72,1558,1486
47169,1,1,315,1538,1223
47170,1,1,636,1378,742
47171,0,0,20,0,-20
47172,1,0,9,0,-9
47173,1,0,38,0,-38
47174,1,1,223,1541,1318
47175,0,0,3,0,-3
47176,1,0,2,0,-2
47177,1,1,604,1517,913
47178,1,0,25,0,-25
47179,0,0,110,0,-110
47180,0,0,60,0,-60
47181,1,1,305,1820,1515
47182,1,0,100,0,-100
47183,1,0,75,0,-75
47184,0,0,39,0,-39
47185,1,0,52,0,-52
47186,1,1,165,1583,1418
47187,1,1,321,2129,1808
47188,1,1,265,1585,1320
47189,0,0,24,0,-24
47190,1,0,10,0,-10
47191,1,0,181,0,-181
47192,1,1,872,2190,1318
47193,0,0,37,0,-37
47194,0,0,60,0,-60
47195,0,0,161,0,-161
47196,0,0,94,0,-94
47197,1,1,97,1452,1355
47198,0,0,142,0,-142
47199,0,0,1,0,-1
47200,0,0,31,0,-31
47201,0,0,65,0,-65
47202,0,0,31,0,-31
47203,1,1,576,2018,1442
47204,0,0,90,0,-90
47205,1,0,93,0,-93
47206,0,0,6,0,-6
47207,0,0,19,0,-19
47208,0,0,49,0,-49
47209,1,0,7,0,-7
47210,0,0,154,0,-154
47211,1,1,264,1756,1492
47212,1,0,30,0,-30
47213,1,0,31,0,-31
47214,1,1,1376,1273,-103
47215,0,0,26,0,-26
47216,0,0,44,0,-44
47217,1,0,67,0,-67
47218,1,0,15,0,-15
47219,0,0,21,0,-21
47220,1,0,78,0,-78
47221,1,0,6,0,-6
47222,1,0,123,0,-123
47223,1,1,1180,1337,157
47224,1,0,17,0,-17
47225,1,1,308,1201,893
47226,1,0,48,0,-48
47227,1,1,483,1361,878
47228,1,0,17,0,-17
47229,1,0,22,0,-22
47230,1,0,24,0,-24
47231,0,0,93,0,-93
47232,0,0,82,0,-82
47233,1,1,165,1407,1242
47234,1,1,1048,2072,1024
47235,0,0,71,0,-71
47236,1,1,1298,1486,188
47237,1,0,50,0,-50
47238,1,1,581,1257,676
47239,1,1,30,1857,1827
47240,1,0,4,0,-4
47241,1,1,375,1400,1025
47242,1,0,132,0,-132
47243,0,0,6,0,-6
47244,1,0,44,0,-44
47245,0,0,169,0,-169
47246,1,1,271,1224,953
47247,1,1,581,3271,2690
47248,1,0,25,0,-25
47249,0,0,17,0,-17
47250,0,0,64,0,-64
47251,0,0,8,0,-8
47252,1,1,200,1344,1144
47253,1,1,167,3097,2930
47254,1,0,47,0,-47
47255,1,0,11,0,-11
47256,1,0,8,0,-8
47257,0,0,28,0,-28
47258,1,0,16,0,-16
47259,0,0,240,0,-240
47260,1,1,78,1498,1420
47261,1,1,319,1583,1264
47262,1,1,930,1385,455
47263,0,0,6,0,-6
47264,0,0,29,0,-29
47265,1,0,76,0,-76
47266,1,0,36,0,-36
47267,0,0,46,0,-46
47268,0,0,66,0,-66
47269,1,0,9,0,-9
47270,0,0,16,0,-16
47271,0,0,1,0,-1
47272,0,0,50,0,-50
47273,1,0,12,0,-12
47274,1,0,20,0,-20
47275,1,0,4,0,-4
47276,1,1,366,1293,927
47277,1,1,331,1599,1268
47278,0,0,53,0,-53
47279,1,0,41,0,-41
47280,0,0,71,0,-71
47281,0,0,113,0,-113
47282,1,0,12,0,-12
47283,1,0,14,0,-14
47284,0,0,264,0,-264
47285,1,0,9,0,-9
47286,1,1,281,1288,1007
47287,1,0,10,0,-10
47288,1,1,242,1375,1133
47289,1,0,7,0,-7
47290,0,0,10,0,-10
47291,0,0,5,0,-5
47292,1,1,861,1307,446
47293,0,0,32,0,-32
47294,1,1,1199,1292,93
47295,0,0,0,0,0
47296,1,1,381,1538,1157
47297,0,0,12,0,-12
47298,1,0,173,0,-173
47299,0,0,10,0,-10
47300,1,1,258,1354,1096
47301,1,0,26,0,-26
47302,0,0,2,0,-2
47303,1,0,68,0,-68
47304,0,0,57,0,-57
47305,0,0,66,0,-66
47306,1,0,6,0,-6
47307,1,0,21,0,-21
47308,1,1,64,1429,1365
47309,0,0,2,0,-2
47310,1,0,46,0,-46
47311,0,0,28,0,-28
47312,1,1,645,1272,627
47313,1,0,76,0,-76
47314,1,1,92,1371,1279
47315,1,0,162,0,-162
47316,1,1,332,1483,1151
47317,1,0,26,0,-26
47318,0,0,0,0,0
47319,0,0,54,0,-54
47320,0,0,24,0,-24
47321,1,1,80,2050,1970
47322,0,0,11,0,-11
47323,1,0,8,0,-8
47324,0,0,9,0,-9
47325,1,1,1244,1653,409
47326,0,0,6,0,-6
47327,1,0,69,0,-69
47328,0,0,57,0,-57
47329,0,0,11,0,-11
47330,1,1,551,1244,693
47331,1,0,26,0,-26
47332,0,0,18,0,-18
47333,1,1,436,1253,817
47334,0,0,3,0,-3
47335,1,1,512,1277,765
47336,0,0,45,0,-45
47337,0,0,36,0,-36
47338,1,1,93,1207,1114
47339,0,0,16,0,-16
47340,0,0,13,0,-13
47341,1,0,38,0,-38
47342,0,0,8,0,-8
47343,1,1,346,1217,871
47344,0,0,8,0,-8
47345,1,1,284,2694,2410
47346,0,0,4,0,-4
47347,1,1,245,1311,1066
47348,1,1,786,1913,1127
47349,1,0,79,0,-79
47350,0,0,46,0,-46
47351,1,1,119,1350,1231
47352,1,0,2,0,-2
47353,1,1,476,1694,1218
47354,0,0,161,0,-161
47355,1,1,264,1663,1399
47356,0,0,0,0,0
47357,0,0,97,0,-97
47358,1,1,602,1883,1281
47359,1,0,56,0,-56
47360,0,0,41,0,-41
47361,1,1,169,1363,1194
47362,1,1,1253,1473,220
47363,0,0,156,0,-156
47364,0,0,19,0,-19
47365,0,0,71,0,-71
47366,0,0,6,0,-6
47367,1,1,399,1381,982
47368,1,0,3,0,-3
47369,1,0,78,0,-78
47370,1,0,43,0,-43
47371,1,1,415,1256,841
47372,0,0,9,0,-9
47373,0,0,97,0,-97
47374,0,0,61,0,-61
47375,1,0,125,0,-125
47376,1,0,13,0,-13
47377,0,0,9,0,-9
47378,0,0,9,0,-9
47379,1,0,62,0,-62
47380,1,1,201,1287,1086
47381,1,0,68,0,-68
47382,0,0,53,0,-53
47383,1,0,3,0,-3
47384,1,0,58,0,-58
47385,1,0,8,0,-8
47386,0,0,2,0,-2
47387,1,1,1273,2623,1350
47388,0,0,153,0,-153
47389,1,0,30,0,-30
47390,1,1,156,2130,1974
47391,0,0,36,0,-36
47392,0,0,21,0,-21
47393,1,1,200,1439,1239
47394,0,0,16,0,-16
47395,1,1,139,2318,2179
47396,0,0,67,0,-67
47397,0,0,165,0,-165
47398,1,1,153,2102,1949
47399,1,1,31,1373,1342
47400,1,0,10,0,-10
47401,0,0,92,0,-92
47402,0,0,53,0,-53
47403,0,0,1,0,-1
47404,0,0,16,0,-16
47405,1,0,34,0,-34
47406,1,1,229,1814,1585
47407,1,0,46,0,-46
47408,1,0,13,0,-13
47409,0,0,130,0,-130
47410,0,0,49,0,-49
47411,1,0,4,0,-4
47412,1,1,211,1813,1602
47413,1,0,52,0,-52
47414,1,1,152,1221,1069
47415,0,0,26,0,-26
47416,1,0,25,0,-25
47417,1,0,53,0,-53
47418,1,0,30,0,-30
47419,1,1,802,1294,492
47420,0,0,64,0,-64
47421,0,0,43,0,-43
47422,1,1,130,1202,1072
47423,1,1,670,1349,679
47424,1,0,142,0,-142
47425,1,0,77,0,-77
47426,0,0,36,0,-36
47427,0,0,14,0,-14
47428,1,1,383,1322,939
47429,1,0,28,0,-28
47430,0,0,53,0,-53
47431,1,0,35,0,-35
47432,0,0,53,0,-53
47433,1,1,252,1470,1218
47434,0,0,6,0,-6
47435,1,1,374,1588,1214
47436,0,0,74,0,-74
47437,1,1,232,1809,1577
47438,1,1,209,1266,1057
47439,1,0,17,0,-17
47440,1,0,81,0,-81
47441,1,1,208,2497,2289
47442,0,0,0,0,0
47443,0,0,58,0,-58
47444,1,0,46,0,-46
47445,1,1,57,1246,1189
47446,1,0,2,0,-2
47447,1,0,63,0,-63
47448,1,1,309,1286,977
47449,0,0,196,0,-196
47450,1,1,127,1260,1133
47451,0,0,87,0,-87
47452,1,1,98,1646,1548
47453,1,0,53,0,-53
47454,0,0,35,0,-35
47455,1,0,20,0,-20
47456,0,0,145,0,-145
47457,1,0,85,0,-85
47458,0,0,208,0,-208
47459,1,1,213,1360,1147
47460,1,0,238,0,-238
47461,0,0,207,0,-207
47462,1,0,14,0,-14
47463,1,0,17,0,-17
47464,0,0,16,0,-16
47465,1,0,81,0,-81
47466,1,0,54,0,-54
47467,0,0,36,0,-36
47468,1,1,1143,1683,540
47469,1,1,716,3039,2323
47470,0,0,170,0,-170
47471,1,1,1129,3983,2854
47472,0,0,6,0,-6
47473,0,0,30,0,-30
47474,1,0,41,0,-41
47475,0,0,11,0,-11
47476,1,0,15,0,-15
47477,1,1,27,1352,1325
47478,1,1,2287,1207,-1080
47479,0,0,3,0,-3
47480,1,1,1042,1875,833
47481,0,0,20,0,-20
47482,0,0,157,0,-157
47483,1,1,239,1402,1163
47484,1,0,54,0,-54
47485,0,0,153,0,-153
47486,1,0,31,0,-31
47487,1,0,38,0,-38
47488,1,0,33,0,-33
47489,1,0,160,0,-160
47490,1,1,1280,2243,963
47491,1,0,341,0,-341
47492,1,0,20,0,-20
47493,1,1,789,3399,2610
47494,1,1,160,1507,1347
47495,0,0,0,0,0
47496,1,0,26,0,-26
47497,0,0,2,0,-2
47498,0,0,14,0,-14
47499,1,1,171,1296,1125
47500,0,0,1,0,-1
47501,1,0,136,0,-136
47502,0,0,40,0,-40
47503,0,0,92,0,-92
47504,0,0,30,0,-30
47505,0,0,40,0,-40
47506,0,0,75,0,-75
47507,1,0,25,0,-25
47508,1,0,31,0,-31
47509,1,0,17,0,-17
47510,0,0,49,0,-49
47511,0,0,94,0,-94
47512,0,0,15,0,-15
47513,1,1,1007,1999,992
47514,1,0,11,0,-11
47515,1,0,56,0,-56
47516,0,0,227,0,-227
47517,0,0,24,0,-24
47518,0,0,11,0,-11
47519,0,0,37,0,-37
47520,0,0,35,0,-35
47521,0,0,112,0,-112
47522,0,0,7,0,-7
47523,0,0,36,0,-36
47524,1,0,112,0,-112
47525,1,1,201,1246,1045
47526,1,0,18,0,-18
47527,1,0,124,0,-124
47528,1,1,196,1375,1179
47529,1,1,227,1214,987
47530,1,0,6,0,-6
47531,1,0,126,0,-126
47532,1,0,30,0,-30
47533,1,0,58,0,-58
47534,0,0,35,0,-35
47535,1,1,1242,1247,5
47536,0,0,12,0,-12
47537,1,1,740,1670,930
47538,1,1,513,1308,795
47539,1,0,60,0,-60
47540,0,0,36,0,-36
47541,1,1,589,1400,811
47542,0,0,22,0,-22
47543,1,1,666,1938,1272
47544,0,0,25,0,-25
47545,0,0,55,0,-55
47546,1,0,121,0,-121
47547,1,1,491,1314,823
47548,0,0,63,0,-63
47549,1,1,133,1453,1320
47550,1,0,6,0,-6
47551,1,0,21,0,-21
47552,1,1,356,1336,980
47553,0,0,1,0,-1
47554,1,0,88,0,-88
47555,1,1,272,2219,1947
47556,1,1,1194,1289,95
47557,1,1,644,1267,623
47558,1,1,273,1747,1474
47559,1,0,8,0,-8
47560,0,0,32,0,-32
47561,0,0,178,0,-178
47562,0,0,105,0,-105
47563,0,0,91,0,-91
47564,1,1,1265,1307,42
47565,0,0,33,0,-33
47566,1,0,44,0,-44
47567,0,0,42,0,-42
47568,1,1,2360,1240,-1120
47569,0,0,9,0,-9
47570,1,1,180,1869,1689
47571,1,1,251,1215,964
47572,1,0,37,0,-37
47573,1,1,182,1202,1020
47574,1,1,342,1296,954
47575,1,1,35,1675,1640
47576,1,0,37,0,-37
47577,1,1,944,1205,261
47578,0,0,18,0,-18
47579,0,0,91,0,-91
47580,0,0,40,0,-40
47581,1,0,43,0,-43
47582,0,0,207,0,-207
47583,0,0,54,0,-54
47584,1,1,463,1347,884
47585,1,1,508,1339,831
47586,0,0,2,0,-2
47587,1,0,17,0,-17
47588,0,0,10,0,-10
47589,0,0,0,0,0
47590,1,0,93,0,-93
47591,0,0,170,0,-170
47592,0,0,6,0,-6
47593,0,0,53,0,-53
47594,0,0,33,0,-33
47595,0,0,7,0,-7
47596,1,1,565,1250,685
47597,1,1,554,1387,833
47598,1,0,16,0,-16
47599,1,1,2092,1508,-584
47600,0,0,89,0,-89
47601,0,0,114,0,-114
47602,0,0,7,0,-7
47603,1,0,11,0,-11
47604,0,0,41,0,-41
47605,1,1,1020,1239,219
47606,1,0,15,0,-15
47607,0,0,9,0,-9
47608,0,0,14,0,-14
47609,1,0,10,0,-10
47610,0,0,56,0,-56
47611,1,0,17,0,-17
47612,1,0,19,0,-19
47613,1,1,1583,1518,-65
47614,1,0,15,0,-15
47615,1,0,53,0,-53
47616,0,0,116,0,-116
47617,0,0,8,0,-8
47618,1,0,26,0,-26
47619,1,0,9,0,-9
47620,0,0,169,0,-169
47621,0,0,29,0,-29
47622,0,0,23,0,-23
47623,0,0,64,0,-64
47624,0,0,34,0,-34
47625,0,0,20,0,-20
47626,1,0,54,0,-54
47627,0,0,35,0,-35
47628,0,0,55,0,-55
47629,1,1,835,1473,638
47630,1,1,623,1767,1144
47631,0,0,78,0,-78
47632,1,1,320,1488,1168
47633,1,1,432,1933,1501
47634,1,0,21,0,-21
47635,0,0,12,0,-12
47636,0,0,3,0,-3
47637,1,0,26,0,-26
47638,1,0,110,0,-110
47639,1,1,50,1332,1282
47640,0,0,43,0,-43
47641,1,0,9,0,-9
47642,1,0,27,0,-27
47643,1,0,4,0,-4
47644,0,0,56,0,-56
47645,1,0,21,0,-21
47646,0,0,9,0,-9
47647,0,0,4,0,-4
47648,1,0,46,0,-46
47649,0,0,3,0,-3
47650,1,0,2,0,-2
47651,0,0,109,0,-109
47652,1,0,43,0,-43
47653,0,0,72,0,-72
47654,1,0,27,0,-27
47655,0,0,21,0,-21
47656,0,0,71,0,-71
47657,1,0,41,0,-41
47658,0,0,93,0,-93
47659,1,1,536,2332,1796
47660,1,1,190,1231,1041
47661,1,1,45,2953,2908
47662,1,1,351,1295,944
47663,0,0,32,0,-32
47664,1,1,479,1304,825
47665,1,1,1667,1466,-201
47666,1,1,722,2197,1475
47667,0,0,13,0,-13
47668,1,1,328,1262,934
47669,0,0,56,0,-56
47670,1,0,92,0,-92
47671,1,0,56,0,-56
47672,1,0,34,0,-34
47673,0,0,101,0,-101
47674,1,1,823,1757,934
47675,0,0,110,0,-110
47676,0,0,15,0,-15
47677,1,0,170,0,-170
47678,1,0,85,0,-85
47679,1,0,16,0,-16
47680,1,0,101,0,-101
47681,1,0,38,0,-38
47682,0,0,95,0,-95
47683,0,0,41,0,-41
47684,1,1,53,1482,1429
47685,0,0,52,0,-52
47686,1,0,92,0,-92
47687,1,1,682,1294,612
47688,0,0,5,0,-5
47689,0,0,32,0,-32
47690,1,1,125,1315,1190
47691,0,0,9,0,-9
47692,1,0,189,0,-189
47693,1,0,29,0,-29
47694,1,1,939,1267,328
47695,0,0,42,0,-42
47696,1,0,8,0,-8
47697,1,1,675,1630,955
47698,1,0,74,0,-74
47699,1,0,41,0,-41
47700,1,0,5,0,-5
47701,1,1,1824,1239,-585
47702,1,0,82,0,-82
47703,1,0,57,0,-57
47704,1,0,20,0,-20
47705,1,0,156,0,-156
47706,1,1,1453,1454,1
47707,0,0,74,0,-74
47708,1,1,111,1249,1138
47709,1,1,1142,1261,119
47710,0,0,40,0,-40
47711,1,1,249,1798,1549
47712,1,1,456,1221,765
47713,0,0,36,0,-36
47714,1,0,18,0,-18
47715,1,1,505,1630,1125
47716,0,0,171,0,-171
47717,1,1,414,1235,821
47718,1,0,146,0,-146
47719,1,0,131,0,-131
47720,0,0,9,0,-9
47721,0,0,52,0,-52
47722,0,0,4,0,-4
47723,1,0,48,0,-48
47724,1,0,64,0,-64
47725,0,0,8,0,-8
47726,1,1,1304,2129,825
47727,0,0,76,0,-76
47728,1,0,13,0,-13
47729,0,0,49,0,-49
47730,1,0,9,0,-9
47731,1,0,20,0,-20
47732,1,0,15,0,-15
47733,1,0,12,0,-12
47734,1,1,247,1466,1219
47735,0,0,68,0,-68
47736,1,0,46,0,-46
47737,0,0,22,0,-22
47738,1,1,582,1236,654
47739,0,0,16,0,-16
47740,0,0,75,0,-75
47741,1,1,742,1234,492
47742,1,0,30,0,-30
47743,1,1,106,1239,1133
47744,1,1,194,1313,1119
47745,0,0,31,0,-31
47746,0,0,117,0,-117
47747,1,1,1084,1541,457
47748,1,0,29,0,-29
47749,1,0,11,0,-11
47750,1,1,333,1217,884
47751,0,0,16,0,-16
47752,0,0,39,0,-39
47753,0,0,75,0,-75
47754,1,1,985,1511,526
47755,0,0,30,0,-30
47756,0,0,3,0,-3
47757,1,0,29,0,-29
47758,0,0,54,0,-54
47759,1,1,494,1514,1020
47760,0,0,34,0,-34
47761,1,1,85,1466,1381
47762,0,0,51,0,-51
47763,1,0,36,0,-36
47764,0,0,3,0,-3
47765,1,1,858,1604,746
47766,0,0,62,0,-62
47767,1,0,26,0,-26
47768,0,0,23,0,-23
47769,0,0,69,0,-69
47770,0,0,7,0,-7
47771,1,0,16,0,-16
47772,1,1,468,1558,1090
47773,1,0,6,0,-6
47774,1,1,578,1517,939
47775,1,1,522,1490,968
47776,1,1,109,1211,1102
47777,1,1,169,1472,1303
47778,1,1,272,1276,1004
47779,1,0,45,0,-45
47780,1,0,113,0,-113
47781,0,0,45,0,-45
47782,1,1,1288,1340,52
47783,0,0,12,0,-12
47784,0,0,23,0,-23
47785,0,0,0,0,0
47786,1,1,135,2174,2039
47787,0,0,21,0,-21
47788,1,0,65,0,-65
47789,0,0,6,0,-6
47790,0,0,221,0,-221
47791,1,1,733,1211,478
47792,1,0,30,0,-30
47793,0,0,10,0,-10
47794,0,0,102,0,-102
47795,0,0,53,0,-53
47796,1,1,213,1237,1024
47797,1,0,79,0,-79
47798,1,0,35,0,-35
47799,0,0,133,0,-133
47800,1,0,13,0,-13
47801,1,0,23,0,-23
47802,1,0,43,0,-43
47803,1,1,87,1646,1559
47804,0,0,10,0,-10
47805,0,0,90,0,-90
47806,1,0,36,0,-36
47807,1,1,827,1325,498
47808,0,0,29,0,-29
47809,1,0,41,0,-41
47810,0,0,52,0,-52
47811,0,0,62,0,-62
47812,1,1,410,2073,1663
47813,1,1,1160,1650,490
47814,0,0,4,0,-4
47815,1,1,1257,3401,2144
47816,0,0,23,0,-23
47817,1,0,46,0,-46
47818,0,0,7,0,-7
47819,1,0,18,0,-18
47820,0,0,59,0,-59
47821,0,0,47,0,-47
47822,1,0,72,0,-72
47823,0,0,19,0,-19
47824,0,0,51,0,-51
47825,0,0,42,0,-42
47826,0,0,2,0,-2
47827,1,1,377,1335,958
47828,1,0,89,0,-89
47829,1,1,279,3017,2738
47830,1,1,287,1281,994
47831,1,1,1523,1336,-187
47832,1,1,904,1840,936
47833,1,1,185,1761,1576
47834,0,0,24,0,-24
47835,0,0,115,0,-115
47836,0,0,1,0,-1
47837,0,0,106,0,-106
47838,0,0,0,0,0
47839,1,1,1907,1655,-252
47840,1,1,386,1650,1264
47841,1,0,47,0,-47
47842,0,0,35,0,-35
47843,1,0,109,0,-109
47844,1,1,814,1402,588
47845,0,0,14,0,-14
47846,1,0,11,0,-11
47847,1,0,31,0,-31
47848,1,1,388,1943,1555
47849,1,0,40,0,-40
47850,1,1,943,1269,326
47851,1,1,293,1273,980
47852,0,0,19,0,-19
47853,0,0,5,0,-5
47854,0,0,73,0,-73
47855,1,0,81,0,-81
47856,0,0,143,0,-143
47857,1,0,126,0,-126
47858,1,1,916,1830,914
47859,1,1,1094,1290,196
47860,0,0,1,0,-1
47861,1,0,35,0,-35
47862,1,1,1413,2581,1168
47863,1,1,193,1366,1173
47864,0,0,103,0,-103
47865,0,0,15,0,-15
47866,0,0,8,0,-8
47867,1,0,25,0,-25
47868,1,0,135,0,-135
47869,1,0,58,0,-58
47870,1,1,108,2085,1977
47871,0,0,49,0,-49
47872,0,0,9,0,-9
47873,1,0,5,0,-5
47874,1,0,44,0,-44
47875,0,0,6,0,-6
47876,1,0,52,0,-52
47877,1,0,33,0,-33
47878,1,1,438,1899,1461
47879,1,1,174,1754,1580
47880,0,0,53,0,-53
47881,1,1,317,2086,1769
47882,1,1,2621,3309,688
47883,1,0,27,0,-27
47884,1,1,986,1409,423
47885,1,1,442,3165,2723
47886,1,0,47,0,-47
47887,0,0,45,0,-45
47888,1,1,338,1584,1246
47889,1,1,117,1772,1655
47890,1,1,118,1287,1169
47891,0,0,56,0,-56
47892,0,0,34,0,-34
47893,1,1,1612,1479,-133
47894,1,1,513,2731,2218
47895,0,0,47,0,-47
47896,0,0,2,0,-2
47897,0,0,3,0,-3
47898,0,0,54,0,-54
47899,0,0,33,0,-33
47900,0,0,20,0,-20
47901,1,0,3,0,-3
47902,0,0,34,0,-34
47903,1,0,14,0,-14
47904,1,1,339,1646,1307
47905,1,1,505,1372,867
47906,1,0,14,0,-14
47907,1,1,602,1552,950
47908,0,0,6,0,-6
47909,1,0,10,0,-10
47910,0,0,89,0,-89
47911,1,0,2,0,-2
47912,0,0,34,0,-34
47913,1,0,1,0,-1
47914,0,0,13,0,-13
47915,0,0,10,0,-10
47916,0,0,69,0,-69
47917,1,1,768,1549,781
47918,1,1,186,2707,2521
47919,1,1,368,1348,980
47920,1,1,1019,1265,246
47921,1,1,442,1672,1230
47922,1,1,597,2696,2099
47923,0,0,186,0,-186
47924,1,1,575,1931,1356
47925,1,1,152,1447,1295
47926,1,1,417,2121,1704
47927,0,0,1,0,-1
47928,1,1,761,1345,584
47929,1,0,14,0,-14
47930,0,0,45,0,-45
47931,1,0,64,0,-64
47932,0,0,171,0,-171
47933,0,0,39,0,-39
47934,1,0,41,0,-41
47935,0,0,31,0,-31
47936,1,0,30,0,-30
47937,1,0,12,0,-12
47938,1,0,65,0,-65
47939,0,0,37,0,-37
47940,0,0,9,0,-9
47941,0,0,76,0,-76
47942,0,0,11,0,-11
47943,1,1,607,1242,635
47944,0,0,74,0,-74
47945,0,0,7,0,-7
47946,0,0,9,0,-9
47947,1,0,48,0,-48
47948,0,0,8,0,-8
47949,1,1,189,1647,1458
47950,0,0,55,0,-55
47951,0,0,57,0,-57
47952,1,1,823,1576,753
47953,1,1,759,1399,640
47954,1,1,300,3057,2757
47955,1,0,20,0,-20
47956,0,0,17,0,-17
47957,1,0,1,0,-1
47958,1,1,546,1278,732
47959,1,0,236,0,-236
47960,0,0,15,0,-15
47961,0,0,17,0,-17
47962,0,0,15,0,-15
47963,0,0,61,0,-61
47964,0,0,44,0,-44
47965,0,0,110,0,-110
47966,0,0,33,0,-33
47967,1,1,364,1316,952
47968,0,0,4,0,-4
47969,1,0,16,0,-16
47970,0,0,13,0,-13
47971,0,0,0,0,0
47972,0,0,29,0,-29
47973,1,1,716,1626,910
47974,1,1,214,1404,1190
47975,1,1,531,1679,1148
47976,1,1,874,1646,772
47977,1,0,5,0,-5
47978,1,0,30,0,-30
47979,1,1,624,1319,695
47980,1,1,221,1405,1184
47981,1,0,51,0,-51
47982,0,0,7,0,-7
47983,0,0,1,0,-1
47984,1,1,334,1245,911
47985,0,0,41,0,-41
47986,0,0,6,0,-6
47987,0,0,1,0,-1
47988,1,0,98,0,-98
47989,1,1,563,1613,1050
47990,1,0,10,0,-10
47991,1,1,862,1336,474
47992,1,0,33,0,-33
47993,0,0,63,0,-63
47994,1,1,26,1426,1400
47995,0,0,68,0,-68
47996,1,1,485,1308,823
47997,0,0,34,0,-34
47998,0,0,50,0,-50
47999,0,0,18,0,-18
48000,0,0,39,0,-39
48001,0,0,31,0,-31
48002,0,0,84,0,-84
48003,1,0,6,0,-6
48004,1,1,1707,1768,61
48005,0,0,1,0,-1
48006,1,0,51,0,-51
48007,0,0,130,0,-130
48008,1,1,926,1612,686
48009,0,0,40,0,-40
48010,1,1,87,1717,1630
48011,1,1,1006,3319,2313
48012,0,0,32,0,-32
48013,1,0,9,0,-9
48014,1,0,12,0,-12
48015,1,0,66,0,-66
48016,0,0,53,0,-53
48017,1,1,245,1617,1372
48018,1,1,501,1215,714
48019,1,1,96,1394,1298
48020,0,0,21,0,-21
48021,0,0,2,0,-2
48022,0,0,8,0,-8
48023,1,0,154,0,-154
48024,0,0,15,0,-15
48025,0,0,2,0,-2
48026,0,0,47,0,-47
48027,0,0,52,0,-52
48028,0,0,74,0,-74
48029,1,0,270,0,-270
48030,1,1,1420,1257,-163
48031,1,0,34,0,-34
48032,0,0,13,0,-13
48033,0,0,41,0,-41
48034,1,0,198,0,-198
48035,0,0,6,0,-6
48036,0,0,15,0,-15
48037,1,1,1875,1232,-643
48038,0,0,2,0,-2
48039,0,0,1,0,-1
48040,1,1,233,1417,1184
48041,0,0,112,0,-112
48042,1,1,996,1286,290
48043,0,0,74,0,-74
48044,1,0,8,0,-8
48045,1,1,1047,1242,195
48046,0,0,60,0,-60
48047,0,0,34,0,-34
48048,1,0,293,0,-293
48049,1,1,334,1274,940
48050,1,1,1269,1206,-63
48051,1,1,204,1576,1372
48052,1,1,132,1516,1384
48053,1,0,15,0,-15
48054,1,0,18,0,-18
48055,1,0,109,0,-109
48056,0,0,3,0,-3
48057,1,1,249,1346,1097
48058,0,0,53,0,-53
48059,1,1,219,1366,1147
48060,1,0,19,0,-19
48061,0,0,4,0,-4
48062,1,0,91,0,-91
48063,1,0,5,0,-5
48064,1,1,285,1406,1121
48065,1,1,135,1303,1168
48066,1,0,34,0,-34
48067,1,0,41,0,-41
48068,1,1,565,1322,757
48069,1,0,55,0,-55
48070,0,0,29,0,-29
48071,1,1,141,1544,1403
48072,0,0,18,0,-18
48073,1,1,232,1343,1111
48074,1,0,20,0,-20
48075,1,1,258,1435,1177
48076,0,0,151,0,-151
48077,0,0,68,0,-68
48078,0,0,71,0,-71
48079,0,0,15,0,-15
48080,1,0,54,0,-54
48081,1,0,77,0,-77
48082,1,0,6,0,-6
48083,1,0,14,0,-14
48084,1,1,152,2110,1958
48085,0,0,79,0,-79
48086,0,0,73,0,-73
48087,1,0,23,0,-23
48088,1,1,69,1495,1426
48089,1,1,1789,5265,3476
48090,0,0,3,0,-3
48091,0,0,60,0,-60
48092,0,0,99,0,-99
48093,1,1,190,1457,1267
48094,1,0,26,0,-26
48095,1,1,122,1374,1252
48096,1,0,34,0,-34
48097,1,1,378,1564,1186
48098,0,0,21,0,-21
48099,1,0,80,0,-80
48100,1,1,774,1359,585
48101,1,1,535,1765,1230
48102,0,0,73,0,-73
48103,1,1,921,1543,622
48104,0,0,5,0,-5
48105,0,0,7,0,-7
48106,1,0,117,0,-117
48107,0,0,21,0,-21
48108,1,0,15,0,-15
48109,1,0,155,0,-155
48110,0,0,20,0,-20
48111,1,1,547,2636,2089
48112,1,0,28,0,-28
48113,1,1,281,1253,972
48114,1,1,586,2846,2260
48115,1,0,2,0,-2
48116,1,1,2172,2024,-148
48117,1,0,16,0,-16
48118,0,0,192,0,-192
48119,1,0,9,0,-9
48120,0,0,3,0,-3
48121,1,0,100,0,-100
48122,1,0,9,0,-9
48123,1,1,434,1793,1359
48124,1,1,122,1404,1282
48125,1,1,595,1331,736
48126,1,1,195,2276,2081
48127,1,0,114,0,-114
48128,0,0,20,0,-20
48129,1,0,26,0,-26
48130,1,1,189,2224,2035
48131,0,0,2,0,-2
48132,0,0,1,0,-1
48133,0,0,16,0,-16
48134,0,0,51,0,-51
48135,1,1,336,1264,928
48136,1,0,34,0,-34
48137,0,0,37,0,-37
48138,1,1,870,1492,622
48139,0,0,26,0,-26
48140,1,0,15,0,-15
48141,1,1,773,1319,546
48142,1,0,10,0,-10
48143,1,1,83,1264,1181
48144,0,0,75,0,-75
48145,0,0,105,0,-105
48146,1,1,402,1362,960
48147,0,0,6,0,-6
48148,0,0,2,0,-2
48149,0,0,15,0,-15
48150,0,0,10,0,-10
48151,1,0,55,0,-55
48152,0,0,21,0,-21
48153,0,0,35,0,-35
48154,1,0,54,0,-54
48155,0,0,15,0,-15
48156,1,0,26,0,-26
48157,1,0,25,0,-25
48158,1,0,5,0,-5
48159,0,0,0,0,0
48160,1,0,174,0,-174
48161,1,0,18,0,-18
48162,0,0,42,0,-42
48163,0,0,75,0,-75
48164,1,0,28,0,-28
48165,0,0,29,0,-29
48166,1,0,28,0,-28
48167,1,0,33,0,-33
48168,1,1,138,1390,1252
48169,1,1,62,2037,1975
48170,1,1,312,1775,1463
48171,1,0,13,0,-13
48172,1,0,0,0,0
48173,1,1,243,1943,1700
48174,1,1,66,1965,1899
48175,1,0,49,0,-49
48176,0,0,32,0,-32
48177,0,0,43,0,-43
48178,1,0,102,0,-102
48179,1,0,61,0,-61
48180,0,0,32,0,-32
48181,0,0,18,0,-18
48182,1,1,374,2053,1679
48183,1,0,34,0,-34
48184,1,1,41,1414,1373
48185,1,1,278,1347,1069
48186,1,1,470,1411,941
48187,1,0,30,0,-30
48188,1,0,49,0,-49
48189,1,1,1490,1361,-129
48190,1,0,10,0,-10
48191,1,0,6,0,-6
48192,1,0,45,0,-45
48193,0,0,83,0,-83
48194,0,0,51,0,-51
48195,1,0,25,0,-25
48196,0,0,49,0,-49
48197,0,0,50,0,-50
48198,0,0,89,0,-89
48199,1,0,139,0,-139
48200,1,1,306,1277,971
48201,1,0,62,0,-62
48202,1,0,22,0,-22
48203,1,0,1,0,-1
48204,1,1,356,1454,1098
48205,0,0,5,0,-5
48206,1,1,267,1342,1075
48207,1,0,37,0,-37
48208,1,0,19,0,-19
48209,1,1,626,1733,1107
48210,0,0,42,0,-42
48211,1,1,288,1287,999
48212,1,0,2,0,-2
48213,1,0,20,0,-20
48214,1,1,716,1217,501
48215,1,0,40,0,-40
48216,1,0,10,0,-10
48217,1,1,431,1440,1009
48218,1,0,27,0,-27
48219,1,0,16,0,-16
48220,0,0,28,0,-28
48221,0,0,0,0,0
48222,0,0,106,0,-106
48223,0,0,79,0,-79
48224,0,0,30,0,-30
48225,1,0,76,0,-76
48226,1,1,747,1241,494
48227,1,1,369,2073,1704
48228,0,0,39,0,-39
48229,0,0,40,0,-40
48230,1,1,164,1485,1321
48231,1,1,61,1506,1445
48232,1,1,937,1210,273
48233,0,0,0,0,0
48234,1,0,44,0,-44
48235,1,1,1186,1249,63
48236,1,1,3621,1200,-2421
48237,1,1,97,2119,2022
48238,1,1,448,1290,842
48239,0,0,16,0,-16
48240,1,1,873,1978,1105
48241,0,0,64,0,-64
48242,0,0,59,0,-59
48243,0,0,18,0,-18
48244,1,1,746,1988,1242
48245,0,0,11,0,-11
48246,0,0,44,0,-44
48247,0,0,38,0,-38
48248,1,1,229,1358,1129
48249,1,0,79,0,-79
48250,1,0,3,0,-3
48251,1,0,107,0,-107
48252,1,1,763,1325,562
48253,1,1,1667,1643,-24
48254,1,0,58,0,-58
48255,1,1,1173,2019,846
48256,0,0,44,0,-44
48257,0,0,98,0,-98
48258,0,0,49,0,-49
48259,1,0,125,0,-125
48260,1,0,81,0,-81
48261,0,0,73,0,-73
48262,1,1,243,1537,1294
48263,0,0,49,0,-49
48264,1,0,25,0,-25
48265,1,0,0,0,0
48266,0,0,34,0,-34
48267,1,0,4,0,-4
48268,1,0,21,0,-21
48269,0,0,7,0,-7
48270,1,0,61,0,-61
48271,1,0,113,0,-113
48272,0,0,5,0,-5
48273,0,0,11,0,-11
48274,1,0,161,0,-161
48275,1,0,55,0,-55
48276,1,0,135,0,-135
48277,0,0,21,0,-21
48278,0,0,15,0,-15
48279,1,0,74,0,-74
48280,1,0,54,0,-54
48281,0,0,15,0,-15
48282,0,0,29,0,-29
48283,0,0,11,0,-11
48284,0,0,5,0,-5
48285,1,0,21,0,-21
48286,1,0,58,0,-58
48287,1,0,0,0,0
48288,0,0,89,0,-89
48289,0,0,0,0,0
48290,1,0,24,0,-24
48291,1,0,1,0,-1
48292,0,0,11,0,-11
48293,1,0,28,0,-28
48294,1,1,359,1908,1549
48295,0,0,2,0,-2
48296,0,0,18,0,-18
48297,1,1,203,1274,1071
48298,0,0,111,0,-111
48299,0,0,9,0,-9
48300,1,1,292,1390,1098
48301,1,1,712,1208,496
48302,1,1,383,1454,1071
48303,0,0,24,0,-24
48304,0,0,15,0,-15
48305,1,1,184,1568,1384
48306,0,0,17,0,-17
48307,1,1,123,1211,1088
48308,0,0,30,0,-30
48309,1,1,902,2275,1373
48310,0,0,1,0,-1
48311,0,0,21,0,-21
48312,1,0,19,0,-19
48313,1,0,23,0,-23
48314,1,1,844,1674,830
48315,1,0,23,0,-23
48316,0,0,130,0,-130
48317,1,1,1144,1344,200
48318,0,0,17,0,-17
48319,0,0,129,0,-129
48320,0,0,1,0,-1
48321,1,0,10,0,-10
48322,0,0,40,0,-40
48323,0,0,83,0,-83
48324,1,0,20,0,-20
48325,1,1,112,1254,1142
48326,0,0,51,0,-51
48327,0,0,25,0,-25
48328,0,0,11,0,-11
48329,1,0,24,0,-24
48330,1,1,847,1677,830
48331,1,0,35,0,-35
48332,1,0,45,0,-45
48333,1,1,57,1285,1228
48334,0,0,28,0,-28
48335,0,0,0,0,0
48336,0,0,94,0,-94
48337,0,0,13,0,-13
48338,0,0,29,0,-29
48339,0,0,127,0,-127
48340,0,0,4,0,-4
48341,1,1,287,1513,1226
48342,1,0,12,0,-12
48343,1,0,18,0,-18
48344,1,0,197,0,-197
48345,1,0,26,0,-26
48346,1,1,362,1387,1025
48347,1,1,91,1329,1238
48348,0,0,10,0,-10
48349,1,1,431,3475,3044
48350,1,0,5,0,-5
48351,1,0,11,0,-11
48352,0,0,7,0,-7
48353,0,0,7,0,-7
48354,1,1,96,1274,1178
48355,1,0,87,0,-87
48356,1,0,60,0,-60
48357,1,0,109,0,-109
48358,1,1,476,1601,1125
48359,1,1,103,1476,1373
48360,0,0,38,0,-38
48361,1,0,32,0,-32
48362,0,0,16,0,-16
48363,1,0,22,0,-22
48364,1,0,71,0,-71
48365,1,1,443,1262,819
48366,0,0,82,0,-82
48367,1,0,11,0,-11
48368,1,0,28,0,-28
48369,0,0,41,0,-41
48370,1,0,0,0,0
48371,0,0,57,0,-57
48372,1,1,1040,1369,329
48373,1,0,41,0,-41
48374,1,0,19,0,-19
48375,1,1,316,2024,1708
48376,1,1,126,1224,1098
48377,0,0,95,0,-95
48378,1,0,13,0,-13
48379,1,0,123,0,-123
48380,0,0,78,0,-78
48381,1,0,125,0,-125
48382,0,0,140,0,-140
48383,0,0,29,0,-29
48384,0,0,20,0,-20
48385,0,0,9,0,-9
48386,0,0,12,0,-12
48387,1,0,134,0,-134
48388,0,0,73,0,-73
48389,1,1,413,1456,1043
48390,0,0,10,0,-10
48391,0,0,9,0,-9
48392,1,0,20,0,-20
48393,0,0,145,0,-145
48394,1,0,27,0,-27
48395,1,0,105,0,-105
48396,1,1,195,1248,1053
48397,1,1,2410,1210,-1200
48398,1,0,134,0,-134
48399,1,0,42,0,-42
48400,1,0,20,0,-20
48401,0,0,28,0,-28
48402,1,1,420,1528,1108
48403,0,0,74,0,-74
48404,1,0,24,0,-24
48405,0,0,4,0,-4
48406,1,0,20,0,-20
48407,1,0,10,0,-10
48408,0,0,90,0,-90
48409,0,0,232,0,-232
48410,0,0,147,0,-147
48411,1,1,90,1383,1293
48412,1,0,66,0,-66
48413,1,0,2,0,-2
48414,1,0,82,0,-82
48415,1,1,203,1941,1738
48416,1,0,45,0,-45
48417,1,1,204,1822,1618
48418,0,0,10,0,-10
48419,1,0,160,0,-160
48420,0,0,19,0,-19
48421,1,1,711,1370,659
48422,1,0,11,0,-11
48423,1,1,2523,2057,-466
48424,1,0,1,0,-1
48425,1,0,46,0,-46
48426,0,0,138,0,-138
48427,0,0,3,0,-3
48428,1,1,1026,1281,255
48429,1,0,172,0,-172
48430,0,0,81,0,-81
48431,1,1,1070,1448,378
48432,1,1,90,2288,2198
48433,0,0,17,0,-17
48434,1,1,235,1642,1407
48435,1,0,151,0,-151
48436,0,0,92,0,-92
48437,1,0,3,0,-3
48438,0,0,2,0,-2
48439,1,0,28,0,-28
48440,0,0,189,0,-189
48441,1,1,1171,1517,346
48442,0,0,50,0,-50
48443,0,0,223,0,-223
48444,0,0,40,0,-40
48445,1,1,151,1496,1345
48446,1,0,10,0,-10
48447,0,0,95,0,-95
48448,1,1,337,1355,1018
48449,1,1,406,2136,1730
48450,0,0,46,0,-46
48451,1,1,463,1468,1005
48452,0,0,16,0,-16
48453,1,1,176,1833,1657
48454,1,1,753,1719,966
48455,0,0,37,0,-37
48456,0,0,19,0,-19
48457,1,0,0,0,0
48458,1,0,12,0,-12
48459,0,0,90,0,-90
48460,1,0,53,0,-53
48461,0,0,10,0,-10
48462,1,0,1,0,-1
48463,0,0,37,0,-37
48464,1,1,510,1825,1315
48465,0,0,12,0,-12
48466,1,0,142,0,-142
48467,0,0,2,0,-2
48468,1,1,1719,1273,-446
48469,0,0,4,0,-4
48470,0,0,18,0,-18
48471,1,1,872,1591,719
48472,1,1,822,1295,473
48473,1,1,1172,1334,162
48474,1,1,448,1361,913
48475,0,0,62,0,-62
48476,1,0,19,0,-19
48477,1,0,82,0,-82
48478,0,0,11,0,-11
48479,0,0,82,0,-82
48480,1,1,1369,1281,-88
48481,1,0,3,0,-3
48482,0,0,131,0,-131
48483,1,0,8,0,-8
48484,0,0,48,0,-48
48485,1,1,152,1433,1281
48486,0,0,4,0,-4
48487,1,0,46,0,-46
48488,0,0,27,0,-27
48489,0,0,19,0,-19
48490,1,0,171,0,-171
48491,1,1,775,2333,1558
48492,1,0,19,0,-19
48493,0,0,33,0,-33
48494,0,0,27,0,-27
48495,1,1,109,1367,1258
48496,0,0,1,0,-1
48497,1,1,901,1356,455
48498,1,0,323,0,-323
48499,1,1,529,1265,736
48500,1,0,31,0,-31
48501,0,0,30,0,-30
48502,0,0,154,0,-154
48503,1,0,187,0,-187
48504,1,1,313,2081,1768
48505,0,0,77,0,-77
48506,1,1,159,1679,1520
48507,1,0,5,0,-5
48508,0,0,29,0,-29
48509,1,0,47,0,-47
48510,1,0,27,0,-27
48511,1,1,648,1798,1150
48512,0,0,62,0,-62
48513,1,1,1567,1246,-321
48514,0,0,2,0,-2
48515,0,0,64,0,-64
48516,0,0,31,0,-31
48517,1,0,112,0,-112
48518,0,0,59,0,-59
48519,0,0,48,0,-48
48520,1,1,15,1724,1709
48521,1,0,59,0,-59
48522,1,0,112,0,-112
48523,1,1,68,1260,1192
48524,0,0,8,0,-8
48525,1,0,15,0,-15
48526,1,1,52,1821,1769
48527,0,0,111,0,-111
48528,1,1,421,1261,840
48529,1,0,10,0,-10
48530,1,1,1567,1241,-326
48531,1,0,87,0,-87
48532,0,0,3,0,-3
48533,0,0,139,0,-139
48534,1,1,545,1507,962
48535,1,1,169,1226,1057
48536,1,0,11,0,-11
48537,0,0,141,0,-141
48538,0,0,124,0,-124
48539,1,0,70,0,-70
48540,0,0,19,0,-19
48541,0,0,161,0,-161
48542,1,0,74,0,-74
48543,1,0,17,0,-17
48544,0,0,40,0,-40
48545,1,1,149,1380,1231
48546,0,0,80,0,-80
48547,1,0,140,0,-140
48548,1,0,9,0,-9
48549,0,0,0,0,0
48550,0,0,30,0,-30
48551,1,1,320,1630,1310
48552,1,0,90,0,-90
48553,1,1,677,1409,732
48554,1,0,40,0,-40
48555,1,1,875,1289,414
48556,0,0,69,0,-69
48557,1,1,156,2215,2059
48558,1,0,60,0,-60
48559,0,0,48,0,-48
48560,1,0,9,0,-9
48561,1,1,322,1264,942
48562,1,1,945,1433,488
48563,0,0,44,0,-44
48564,0,0,36,0,-36
48565,1,0,194,0,-194
48566,1,1,263,1467,1204
48567,1,0,16,0,-16
48568,1,0,24,0,-24
48569,0,0,1,0,-1
48570,0,0,62,0,-62
48571,1,0,179,0,-179
48572,0,0,124,0,-124
48573,1,0,8,0,-8
48574,1,1,1082,1228,146
48575,1,1,485,1466,981
48576,1,1,2646,1248,-1398
48577,0,0,44,0,-44
48578,1,0,34,0,-34
48579,1,1,353,4376,4023
48580,1,0,52,0,-52
48581,1,1,379,1230,851
48582,0,0,3,0,-3
48583,1,1,330,1246,916
48584,1,1,1255,1623,368
48585,0,0,101,0,-101
48586,1,1,24,1440,1416
48587,0,0,47,0,-47
48588,1,1,1661,1344,-317
48589,0,0,80,0,-80
48590,1,1,98,1241,1143
48591,1,1,182,1341,1159
48592,0,0,52,0,-52
48593,0,0,9,0,-9
48594,0,0,2,0,-2
48595,1,0,28,0,-28
48596,0,0,19,0,-19
48597,0,0,13,0,-13
48598,1,1,1797,1490,-307
48599,1,0,28,0,-28
48600,1,1,215,1507,1292
48601,0,0,38,0,-38
48602,1,1,293,1450,1157
48603,0,0,74,0,-74
48604,0,0,39,0,-39
48605,1,1,1074,1273,199
48606,1,1,622,1580,958
48607,0,0,1,0,-1
48608,1,0,1,0,-1
48609,0,0,14,0,-14
48610,0,0,59,0,-59
48611,1,0,4,0,-4
48612,1,0,3,0,-3
48613,0,0,0,0,0
48614,0,0,120,0,-120
48615,1,1,143,1304,1161
48616,0,0,151,0,-151
48617,1,1,304,1228,924
48618,1,1,202,1202,1000
48619,0,0,9,0,-9
48620,1,1,390,1631,1241
48621,0,0,83,0,-83
48622,0,0,41,0,-41
48623,0,0,39,0,-39
48624,1,1,165,1335,1170
48625,1,1,732,1226,494
48626,1,1,153,1228,1075
48627,0,0,256,0,-256
48628,0,0,18,0,-18
48629,0,0,93,0,-93
48630,1,0,86,0,-86
48631,0,0,11,0,-11
48632,0,0,22,0,-22
48633,1,0,0,0,0
48634,1,0,111,0,-111
48635,1,0,100,0,-100
48636,1,0,5,0,-5
48637,1,0,20,0,-20
48638,1,1,116,1681,1565
48639,0,0,6,0,-6
48640,0,0,36,0,-36
48641,1,1,133,1237,1104
48642,1,0,16,0,-16
48643,0,0,35,0,-35
48644,1,0,19,0,-19
48645,1,0,35,0,-35
48646,0,0,14,0,-14
48647,1,0,15,0,-15
48648,0,0,9,0,-9
48649,0,0,25,0,-25
48650,1,1,830,2550,1720
48651,1,1,309,1627,1318
48652,1,1,268,1291,1023
48653,0,0,65,0,-65
48654,0,0,4,0,-4
48655,1,1,86,1255,1169
48656,1,1,907,1767,860
48657,0,0,65,0,-65
48658,0,0,48,0,-48
48659,0,0,27,0,-27
48660,0,0,8,0,-8
48661,1,0,11,0,-11
48662,0,0,3,0,-3
48663,1,0,17,0,-17
48664,1,0,8,0,-8
48665,1,0,27,0,-27
48666,1,0,29,0,-29
48667,1,1,179,1341,1162
48668,1,1,318,3569,3251
48669,1,0,58,0,-58
48670,0,0,4,0,-4
48671,0,0,116,0,-116
48672,0,0,8,0,-8
48673,1,0,3,0,-3
48674,0,0,64,0,-64
48675,1,0,20,0,-20
48676,0,0,73,0,-73
48677,1,1,871,1224,353
48678,1,0,119,0,-119
48679,1,1,521,1220,699
48680,1,1,34,1507,1473
48681,0,0,3,0,-3
48682,0,0,69,0,-69
48683,1,1,83,1288,1205
48684,0,0,152,0,-152
48685,1,1,2482,1544,-938
48686,1,1,964,1209,245
48687,0,0,253,0,-253
48688,0,0,58,0,-58
48689,0,0,52,0,-52
48690,1,1,163,1692,1529
48691,1,0,15,0,-15
48692,1,1,225,1607,1382
48693,0,0,102,0,-102
48694,1,1,349,1383,1034
48695,0,0,11,0,-11
48696,1,1,80,1510,1430
48697,0,0,38,0,-38
48698,1,1,1462,1528,66
48699,1,1,1202,1239,37
48700,0,0,2,0,-2
48701,1,1,910,1373,463
48702,0,0,30,0,-30
48703,0,0,16,0,-16
48704,1,1,1849,1886,37
48705,1,0,31,0,-31
48706,1,0,216,0,-216
48707,0,0,76,0,-76
48708,0,0,33,0,-33
48709,1,1,1301,1820,519
48710,0,0,89,0,-89
48711,0,0,15,0,-15
48712,1,0,49,0,-49
48713,0,0,32,0,-32
48714,1,0,250,0,-250
48715,0,0,0,0,0
48716,1,1,2470,1406,-1064
48717,1,1,412,1328,916
48718,1,0,19,0,-19
48719,1,1,446,1387,941
48720,0,0,206,0,-206
48721,1,0,31,0,-31
48722,0,0,11,0,-11
48723,1,0,19,0,-19
48724,0,0,24,0,-24
48725,1,1,142,1515,1373
48726,1,1,498,1466,968
48727,0,0,182,0,-182
48728,1,0,98,0,-98
48729,1,1,293,1383,1090
48730,1,0,27,0,-27
48731,1,1,656,1215,559
48732,0,0,25,0,-25
48733,0,0,95,0,-95
48734,1,0,5,0,-5
48735,1,1,700,2147,1447
48736,1,0,50,0,-50
48737,0,0,1,0,-1
48738,0,0,22,0,-22
48739,1,0,67,0,-67
48740,1,1,220,4519,4299
48741,0,0,84,0,-84
48742,1,1,1026,1703,677
48743,0,0,17,0,-17
48744,1,0,11,0,-11
48745,1,1,871,1220,349
48746,1,1,424,2131,1707
48747,1,1,25,1863,1838
48748,1,0,63,0,-63
48749,0,0,23,0,-23
48750,1,0,2,0,-2
48751,1,1,30,2531,2501
48752,0,0,59,0,-59
48753,0,0,30,0,-30
48754,1,0,23,0,-23
48755,0,0,2,0,-2
48756,1,1,151,2136,1985
48757,0,0,12,0,-12
48758,0,0,145,0,-145
48759,1,0,14,0,-14
48760,0,0,41,0,-41
48761,1,0,29,0,-29
48762,1,0,32,0,-32
48763,0,0,7,0,-7
48764,1,0,78,0,-78
48765,0,0,6,0,-6
48766,1,1,1111,1234,123
48767,0,0,65,0,-65
48768,1,1,1314,1897,583
48769,1,0,27,0,-27
48770,1,0,63,0,-63
48771,1,1,752,1215,463
48772,1,1,91,1482,1391
48773,1,0,28,0,-28
48774,1,1,547,2017,1470
48775,1,1,1712,1477,-235
48776,1,0,81,0,-81
48777,1,0,0,0,0
48778,1,0,40,0,-40
48779,1,0,76,0,-76
48780,0,0,37,0,-37
48781,1,1,635,1229,594
48782,1,1,161,1214,1053
48783,0,0,61,0,-61
48784,1,1,87,1327,1240
48785,0,0,78,0,-78
48786,1,1,491,1403,912
48787,1,0,37,0,-37
48788,0,0,12,0,-12
48789,1,0,27,0,-27
48790,1,0,52,0,-52
48791,0,0,141,0,-141
48792,1,1,206,1220,1014
48793,1,0,2,0,-2
48794,0,0,31,0,-31
48795,0,0,25,0,-25
48796,0,0,111,0,-111
48797,1,1,356,1404,1048
48798,0,0,19,0,-19
48799,1,0,18,0,-18
48800,0,0,9,0,-9
48801,0,0,6,0,-6
48802,1,0,34,0,-34
48803,0,0,41,0,-41
48804,1,0,150,0,-150
48805,1,0,46,0,-46
48806,0,0,28,0,-28
48807,1,1,815,1390,575
48808,0,0,3,0,-3
48809,1,1,1152,1285,133
48810,0,0,38,0,-38
48811,1,0,203,0,-203
48812,0,0,42,0,-42
48813,1,0,92,0,-92
48814,1,0,448,0,-448
48815,0,0,16,0,-16
48816,1,1,258,1667,1409
48817,0,0,12,0,-12
48818,1,0,5,0,-5
48819,0,0,219,0,-219
48820,0,0,10,0,-10
48821,1,1,1314,1611,297
48822,0,0,132,0,-132
48823,0,0,35,0,-35
48824,1,0,69,0,-69
48825,1,0,59,0,-59
48826,0,0,17,0,-17
48827,0,0,2,0,-2
48828,0,0,2,0,-2
48829,0,0,34,0,-34
48830,1,0,25,0,-25
48831,1,0,62,0,-62
48832,0,0,73,0,-73
48833,1,0,31,0,-31
48834,1,1,437,2406,1969
48835,0,0,23,0,-23
48836,0,0,42,0,-42
48837,1,1,1480,1700,220
48838,0,0,46,0,-46
48839,1,0,41,0,-41
48840,1,1,604,1476,872
48841,0,0,23,0,-23
48842,0,0,15,0,-15
48843,0,0,40,0,-40
48844,0,0,20,0,-20
48845,0,0,7,0,-7
48846,1,1,259,2021,1762
48847,1,1,2200,2755,555
48848,1,1,323,1235,912
48849,1,0,51,0,-51
48850,1,1,151,1243,1092
48851,0,0,38,0,-38
48852,1,0,57,0,-57
48853,1,0,27,0,-27
48854,1,1,708,1530,822
48855,1,1,289,1210,921
48856,1,1,238,1475,1237
48857,1,1,131,1205,1074
48858,1,0,45,0,-45
48859,1,0,3,0,-3
48860,0,0,87,0,-87
48861,1,0,46,0,-46
48862,1,0,152,0,-152
48863,1,0,271,0,-271
48864,0,0,225,0,-225
48865,1,1,1991,1334,-657
48866,0,0,46,0,-46
48867,1,0,70,0,-70
48868,1,1,1246,1489,243
48869,0,0,43,0,-43
48870,0,0,21,0,-21
48871,0,0,17,0,-17
48872,0,0,35,0,-35
48873,1,0,11,0,-11
48874,0,0,40,0,-40
48875,1,1,46,1265,1219
48876,0,0,20,0,-20
48877,1,0,54,0,-54
48878,1,0,3,0,-3
48879,1,1,558,1535,977
48880,0,0,29,0,-29
48881,1,1,323,1381,1058
48882,0,0,22,0,-22
48883,0,0,155,0,-155
48884,1,0,96,0,-96
48885,1,1,127,2116,1989
48886,1,1,74,1408,1334
48887,1,1,63,1259,1196
48888,0,0,16,0,-16
48889,0,0,29,0,-29
48890,0,0,83,0,-83
48891,1,1,145,1241,1096
48892,1,0,53,0,-53
48893,1,1,312,1352,1040
48894,0,0,5,0,-5
48895,1,0,32,0,-32
48896,1,0,46,0,-46
48897,0,0,94,0,-94
48898,0,0,7,0,-7
48899,0,0,3,0,-3
48900,0,0,10,0,-10
48901,1,1,196,1246,1050
48902,1,1,76,1260,1184
48903,1,1,451,1888,1437
48904,0,0,1,0,-1
48905,0,0,100,0,-100
48906,0,0,55,0,-55
48907,1,0,7,0,-7
48908,0,0,42,0,-42
48909,0,0,256,0,-256
48910,0,0,78,0,-78
48911,1,0,37,0,-37
48912,1,0,4,0,-4
48913,0,0,67,0,-67
48914,1,1,1184,1373,189
48915,1,0,91,0,-91
48916,1,0,11,0,-11
48917,0,0,5,0,-5
48918,0,0,97,0,-97
48919,0,0,51,0,-51
48920,1,0,82,0,-82
48921,1,0,12,0,-12
48922,1,0,7,0,-7
48923,0,0,80,0,-80
48924,1,1,1382,1276,-106
48925,0,0,10,0,-10
48926,0,0,40,0,-40
48927,1,0,50,0,-50
48928,0,0,0,0,0
48929,1,1,481,1241,760
48930,0,0,26,0,-26
48931,0,0,29,0,-29
48932,1,0,12,0,-12
48933,1,0,113,0,-113
48934,1,0,32,0,-32
48935,1,0,102,0,-102
48936,1,0,53,0,-53
48937,0,0,5,0,-5
48938,1,1,166,1535,1369
48939,0,0,13,0,-13
48940,1,0,18,0,-18
48941,1,0,32,0,-32
48942,1,0,146,0,-146
48943,1,1,197,1299,1102
48944,0,0,34,0,-34
48945,1,0,102,0,-102
48946,1,1,410,1351,941
48947,0,0,101,0,-101
48948,1,0,5,0,-5
48949,0,0,25,0,-25
48950,1,0,30,0,-30
48951,1,1,206,1323,1117
48952,0,0,91,0,-91
48953,1,0,1,0,-1
48954,1,0,0,0,0
48955,1,0,17,0,-17
48956,0,0,0,0,0
48957,0,0,13,0,-13
48958,0,0,7,0,-7
48959,1,1,111,1203,1092
48960,1,0,1,0,-1
48961,1,1,488,1343,855
48962,1,1,168,2281,2113
48963,1,0,1,0,-1
48964,0,0,27,0,-27
48965,0,0,36,0,-36
48966,0,0,21,0,-21
48967,1,1,146,1650,1504
48968,1,1,1282,1223,-59
48969,1,1,145,1397,1252
48970,1,1,1711,1387,-324
48971,0,0,9,0,-9
48972,0,0,36,0,-36
48973,0,0,21,0,-21
48974,1,1,1295,1421,126
48975,1,1,917,1323,406
48976,1,1,308,1953,1645
48977,0,0,17,0,-17
48978,1,1,226,1590,1364
48979,1,0,70,0,-70
48980,0,0,16,0,-16
48981,1,1,284,1351,1067
48982,0,0,87,0,-87
48983,1,0,48,0,-48
48984,1,0,153,0,-153
48985,1,0,17,0,-17
48986,1,1,167,1502,1335
48987,0,0,52,0,-52
48988,0,0,197,0,-197
48989,1,1,1937,1363,-574
48990,0,0,21,0,-21
48991,0,0,11,0,-11
48992,1,0,52,0,-52
48993,1,0,4,0,-4
48994,1,1,119,1346,1227
48995,0,0,0,0,0
48996,0,0,44,0,-44
48997,1,1,75,1440,1365
48998,1,1,1639,1713,74
48999,1,1,206,2222,2016
49000,1,0,36,0,-36
49001,0,0,18,0,-18
49002,1,0,111,0,-111
49003,1,0,18,0,-18
49004,0,0,4,0,-4
49005,0,0,31,0,-31
49006,0,0,10,0,-10
49007,1,1,564,1492,928
49008,1,1,486,2134,1648
49009,1,0,29,0,-29
49010,1,0,33,0,-33
49011,0,0,37,0,-37
49012,1,1,47,1230,1183
49013,0,0,5,0,-5
49014,0,0,44,0,-44
49015,1,0,98,0,-98
49016,1,1,589,1260,671
49017,0,0,32,0,-32
49018,1,1,111,1681,1570
49019,1,0,46,0,-46
49020,1,0,95,0,-95
49021,0,0,77,0,-77
49022,1,1,45,1296,1251
49023,0,0,62,0,-62
49024,0,0,16,0,-16
49025,0,0,48,0,-48
49026,1,0,16,0,-16
49027,0,0,121,0,-121
49028,1,0,110,0,-110
49029,1,1,1594,1203,-391
49030,0,0,82,0,-82
49031,1,0,162,0,-162
49032,1,1,146,1234,1088
49033,1,1,178,1211,1033
49034,1,0,94,0,-94
49035,1,1,931,1319,388
49036,0,0,4,0,-4
49037,1,1,237,3113,2876
49038,1,1,319,1347,1028
49039,1,0,98,0,-98
49040,1,1,20,1897,1877
49041,0,0,62,0,-62
49042,1,0,5,0,-5
49043,0,0,6,0,-6
49044,0,0,12,0,-12
49045,0,0,108,0,-108
49046,1,1,1063,1255,192
49047,1,1,199,2276,2077
49048,1,0,74,0,-74
49049,0,0,7,0,-7
49050,1,1,757,1238,481
49051,0,0,63,0,-63
49052,0,0,49,0,-49
49053,0,0,17,0,-17
49054,1,0,56,0,-56
49055,1,1,857,1734,877
49056,1,0,19,0,-19
49057,1,1,831,1302,471
49058,0,0,126,0,-126
49059,0,0,14,0,-14
49060,0,0,54,0,-54
49061,1,1,342,1346,1004
49062,0,0,51,0,-51
49063,1,0,4,0,-4
49064,1,1,774,1633,859
49065,1,1,59,1925,1866
49066,1,1,238,2211,1973
49067,0,0,34,0,-34
49068,1,0,40,0,-40
49069,0,0,31,0,-31
49070,0,0,129,0,-129
49071,1,0,168,0,-168
49072,1,1,166,1598,1432
49073,1,0,30,0,-30
49074,0,0,61,0,-61
49075,1,0,234,0,-234
49076,1,1,348,1736,1388
49077,0,0,59,0,-59
49078,0,0,38,0,-38
49079,1,1,835,1357,522
49080,1,0,132,0,-132
49081,1,1,1700,1454,-246
49082,1,0,13,0,-13
49083,0,0,0,0,0
49084,0,0,2,0,-2
49085,1,1,464,8558,8094
49086,1,1,857,3842,2985
49087,0,0,21,0,-21
49088,0,0,16,0,-16
49089,0,0,23,0,-23
49090,1,1,115,1511,1396
49091,0,0,71,0,-71
49092,1,0,0,0,0
49093,0,0,6,0,-6
49094,1,1,546,1571,1025
49095,0,0,51,0,-51
49096,0,0,14,0,-14
49097,1,1,423,1523,1100
49098,1,0,57,0,-57
49099,0,0,10,0,-10
49100,0,0,18,0,-18
49101,0,0,44,0,-44
49102,1,0,0,0,0
49103,1,1,99,2235,2136
49104,0,0,8,0,-8
49105,0,0,205,0,-205
49106,1,0,1,0,-1
49107,1,0,10,0,-10
49108,0,0,9,0,-9
49109,1,1,240,2097,1857
49110,1,1,537,1295,758
49111,1,0,36,0,-36
49112,0,0,71,0,-71
49113,0,0,179,0,-179
49114,0,0,287,0,-287
49115,0,0,40,0,-40
49116,0,0,2,0,-2
49117,0,0,29,0,-29
49118,1,0,19,0,-19
49119,0,0,168,0,-168
49120,1,1,886,1228,342
49121,1,1,637,1256,619
49122,1,0,13,0,-13
49123,1,0,11,0,-11
49124,0,0,8,0,-8
49125,0,0,260,0,-260
49126,0,0,61,0,-61
49127,0,0,40,0,-40
49128,1,0,37,0,-37
49129,1,1,156,1365,1209
49130,0,0,41,0,-41
49131,1,0,4,0,-4
49132,1,0,55,0,-55
49133,1,1,207,1587,1380
49134,1,1,94,1455,1361
49135,1,1,224,1599,1375
49136,0,0,50,0,-50
49137,1,1,330,1210,880
49138,0,0,81,0,-81
49139,0,0,109,0,-109
49140,1,1,494,1489,995
49141,0,0,4,0,-4
49142,0,0,83,0,-83
49143,1,0,95,0,-95
49144,1,0,63,0,-63
49145,1,1,159,2161,2002
49146,1,1,1636,1271,-365
49147,0,0,53,0,-53
49148,1,1,167,1486,1319
49149,0,0,54,0,-54
49150,0,0,14,0,-14
49151,1,1,879,1402,523
49152,0,0,2,0,-2
49153,1,0,6,0,-6
49154,1,1,473,1235,762
49155,0,0,29,0,-29
49156,1,1,64,1708,1644
49157,0,0,70,0,-70
49158,0,0,4,0,-4
49159,1,1,1244,2308,1064
49160,0,0,75,0,-75
49161,1,1,225,1315,1090
49162,0,0,8,0,-8
49163,1,0,1,0,-1
49164,0,0,16,0,-16
49165,0,0,35,0,-35
49166,1,0,5,0,-5
49167,1,0,1,0,-1
49168,1,0,2,0,-2
49169,1,1,560,1332,772
49170,0,0,1,0,-1
49171,1,0,118,0,-118
49172,1,1,419,1260,841
49173,1,1,4358,1502,-2856
49174,1,1,526,2437,1911
49175,1,0,41,0,-41
49176,1,1,107,1370,1263
49177,1,0,63,0,-63
49178,1,1,395,1246,851
49179,1,0,4,0,-4
49180,1,0,13,0,-13
49181,0,0,92,0,-92
49182,1,0,109,0,-109
49183,1,0,12,0,-12
49184,1,1,403,2088,1685
49185,1,0,174,0,-174
49186,0,0,16,0,-16
49187,0,0,59,0,-59
49188,1,0,13,0,-13
49189,0,0,21,0,-21
49190,0,0,82,0,-82
49191,0,0,4,0,-4
49192,0,0,66,0,-66
49193,1,1,1033,1920,887
49194,0,0,26,0,-26
49195,0,0,35,0,-35
49196,1,1,1033,1797,764
49197,1,0,56,0,-56
49198,1,1,929,1253,324
49199,0,0,15,0,-15
49200,0,0,48,0,-48
49201,0,0,47,0,-47
49202,0,0,74,0,-74
49203,1,0,31,0,-31
49204,0,0,2,0,-2
49205,1,1,766,1915,1149
49206,0,0,31,0,-31
49207,0,0,13,0,-13
49208,0,0,235,0,-235
49209,1,0,44,0,-44
49210,1,0,79,0,-79
49211,0,0,35,0,-35
49212,1,1,21,1837,1816
49213,1,0,64,0,-64
49214,0,0,7,0,-7
49215,0,0,104,0,-104
49216,1,1,938,1657,719
49217,1,1,500,1294,794
49218,0,0,21,0,-21
49219,1,0,36,0,-36
49220,0,0,65,0,-65
49221,0,0,82,0,-82
49222,0,0,48,0,-48
49223,1,0,20,0,-20
49224,1,1,1321,1256,-65
49225,1,0,18,0,-18
49226,0,0,51,0,-51
49227,1,1,85,1795,1710
49228,0,0,80,0,-80
49229,1,1,492,1502,1010
49230,0,0,4,0,-4
49231,1,0,29,0,-29
49232,0,0,23,0,-23
49233,1,1,406,1597,1191
49234,0,0,17,0,-17
49235,0,0,9,0,-9
49236,1,1,753,1601,848
49237,0,0,17,0,-17
49238,0,0,3,0,-3
49239,0,0,23,0,-23
49240,0,0,225,0,-225
49241,1,0,29,0,-29
49242,1,0,41,0,-41
49243,1,0,10,0,-10
49244,0,0,31,0,-31
49245,1,0,65,0,-65
49246,1,0,135,0,-135
49247,1,0,60,0,-60
49248,1,1,269,1758,1489
49249,0,0,50,0,-50
49250,1,1,147,1553,1406
49251,1,1,574,1296,722
49252,0,0,17,0,-17
49253,0,0,219,0,-219
49254,1,0,87,0,-87
49255,0,0,83,0,-83
49256,0,0,31,0,-31
49257,1,1,911,1400,489
49258,1,0,27,0,-27
49259,1,0,18,0,-18
49260,1,1,866,1360,494
49261,1,0,9,0,-9
49262,1,0,144,0,-144
49263,1,0,20,0,-20
49264,1,1,313,2247,1934
49265,0,0,26,0,-26
49266,1,1,1487,1206,-281
49267,0,0,10,0,-10
49268,0,0,2,0,-2
49269,0,0,30,0,-30
49270,1,0,9,0,-9
49271,1,1,253,1348,1095
49272,0,0,9,0,-9
49273,1,1,928,1512,584
49274,0,0,35,0,-35
49275,0,0,47,0,-47
49276,1,0,45,0,-45
49277,0,0,32,0,-32
49278,1,1,924,3669,2745
49279,0,0,65,0,-65
49280,1,1,485,1293,808
49281,0,0,86,0,-86
49282,1,0,18,0,-18
49283,1,0,126,0,-126
49284,0,0,69,0,-69
49285,1,1,176,1311,1135
49286,0,0,18,0,-18
49287,1,0,13,0,-13
49288,0,0,62,0,-62
49289,0,0,21,0,-21
49290,1,1,265,1507,1242
49291,0,0,16,0,-16
49292,1,0,75,0,-75
49293,1,1,2750,1254,-1496
49294,1,1,1155,1340,185
49295,0,0,87,0,-87
49296,1,0,134,0,-134
49297,0,0,165,0,-165
49298,0,0,67,0,-67
49299,1,1,271,2643,2372
49300,1,1,400,1599,1199
49301,1,1,647,1509,862
49302,1,0,27,0,-27
49303,1,0,0,0,0
49304,1,0,3,0,-3
49305,1,0,2,0,-2
49306,0,0,81,0,-81
49307,1,1,565,1428,863
49308,0,0,116,0,-116
49309,1,0,44,0,-44
49310,0,0,14,0,-14
49311,1,0,45,0,-45
49312,0,0,184,0,-184
49313,0,0,101,0,-101
49314,1,1,71,2565,2494
49315,0,0,33,0,-33
49316,1,1,209,2012,1803
49317,1,0,63,0,-63
49318,1,0,0,0,0
49319,0,0,51,0,-51
49320,1,0,234,0,-234
49321,1,0,23,0,-23
49322,1,0,3,0,-3
49323,0,0,41,0,-41
49324,1,1,264,1835,1571
49325,1,0,29,0,-29
49326,1,1,953,1212,259
49327,0,0,117,0,-117
49328,0,0,17,0,-17
49329,0,0,68,0,-68
49330,1,0,13,0,-13
49331,1,1,1582,1709,127
49332,0,0,14,0,-14
49333,1,1,690,2053,1363
49334,1,1,350,1581,1231
49335,0,0,12,0,-12
49336,0,0,28,0,-28
49337,0,0,6,0,-6
49338,0,0,52,0,-52
49339,0,0,187,0,-187
49340,1,1,424,1295,871
49341,1,0,66,0,-66
49342,1,1,266,1403,1137
49343,1,0,89,0,-89
49344,0,0,28,0,-28
49345,0,0,10,0,-10
49346,0,0,73,0,-73
49347,0,0,10,0,-10
49348,1,0,33,0,-33
49349,0,0,7,0,-7
49350,1,1,182,1315,1133
49351,1,1,879,1474,595
49352,1,0,49,0,-49
49353,1,0,16,0,-16
49354,1,0,25,0,-25
49355,1,0,202,0,-202
49356,1,1,214,1706,1492
49357,1,1,1355,1331,-24
49358,0,0,90,0,-90
49359,0,0,24,0,-24
49360,1,0,183,0,-183
49361,1,0,23,0,-23
49362,1,0,119,0,-119
49363,1,0,45,0,-45
49364,1,1,798,1737,939
49365,1,1,266,1290,1024
49366,1,1,435,1394,959
49367,1,1,1058,1818,760
49368,0,0,20,0,-20
49369,0,0,11,0,-11
49370,0,0,20,0,-20
49371,0,0,24,0,-24
49372,1,1,439,1610,1171
49373,1,0,90,0,-90
49374,1,1,501,1275,774
49375,0,0,64,0,-64
49376,1,0,0,0,0
49377,0,0,49,0,-49
49378,0,0,23,0,-23
49379,0,0,9,0,-9
49380,1,1,775,1474,699
49381,1,1,712,3523,2811
49382,1,0,269,0,-269
49383,0,0,78,0,-78
49384,1,0,123,0,-123
49385,1,0,106,0,-106
49386,1,1,282,1587,1305
49387,0,0,36,0,-36
49388,1,1,2119,1319,-800
49389,0,0,1,0,-1
49390,1,1,134,1219,1085
49391,0,0,86,0,-86
49392,1,1,114,1571,1457
49393,1,1,472,1685,1213
49394,1,1,996,1434,438
49395,0,0,39,0,-39
49396,0,0,181,0,-181
49397,1,0,126,0,-126
49398,1,0,17,0,-17
49399,1,1,154,1418,1264
49400,1,1,61,1509,1448
49401,1,1,1233,2218,985
49402,0,0,39,0,-39
49403,0,0,31,0,-31
49404,1,1,688,1404,716
49405,1,1,185,1371,1186
49406,0,0,43,0,-43
49407,0,0,52,0,-52
49408,1,0,25,0,-25
49409,1,1,1556,1484,-72
49410,0,0,53,0,-53
49411,0,0,24,0,-24
49412,1,1,308,1522,1214
49413,1,1,278,1464,1186
49414,1,1,472,1452,980
49415,1,1,1122,1523,401
49416,1,0,3,0,-3
49417,1,0,14,0,-14
49418,0,0,22,0,-22
49419,1,0,55,0,-55
49420,0,0,68,0,-68
49421,0,0,12,0,-12
49422,1,0,37,0,-37
49423,0,0,82,0,-82
49424,0,0,40,0,-40
49425,1,1,1338,4742,3404
49426,1,1,328,1498,1170
49427,0,0,55,0,-55
49428,0,0,36,0,-36
49429,1,0,1,0,-1
49430,0,0,6,0,-6
49431,0,0,12,0,-12
49432,0,0,24,0,-24
49433,1,0,19,0,-19
49434,1,1,1111,1255,144
49435,1,1,237,1413,1176
49436,0,0,14,0,-14
49437,1,1,167,1497,1330
49438,1,1,965,1532,567
49439,0,0,4,0,-4
49440,0,0,34,0,-34
49441,1,0,108,0,-108
49442,1,1,268,3240,2972
49443,1,0,35,0,-35
49444,1,0,233,0,-233
49445,1,0,195,0,-195
49446,1,0,1,0,-1
49447,0,0,117,0,-117
49448,0,0,25,0,-25
49449,1,1,454,1222,768
49450,0,0,56,0,-56
49451,0,0,4,0,-4
49452,1,0,18,0,-18
49453,0,0,106,0,-106
49454,1,0,77,0,-77
49455,0,0,18,0,-18
49456,1,1,1312,1410,98
49457,1,1,899,1425,526
49458,1,0,13,0,-13
49459,1,1,271,1511,1240
49460,0,0,60,0,-60
49461,1,0,2,0,-2
49462,0,0,125,0,-125
49463,1,1,222,1237,1015
49464,1,1,385,1705,1320
49465,1,1,773,2560,1787
49466,1,0,68,0,-68
49467,1,1,406,1346,940
49468,1,1,80,1338,1258
49469,1,0,55,0,-55
49470,1,0,119,0,-119
49471,0,0,51,0,-51
49472,1,1,1275,1306,31
49473,1,1,1274,1207,-67
49474,0,0,14,0,-14
49475,1,1,980,1382,402
49476,0,0,54,0,-54
49477,1,1,352,1400,1048
49478,0,0,51,0,-51
49479,1,0,17,0,-17
49480,0,0,185,0,-185
49481,1,0,17,0,-17
49482,0,0,103,0,-103
49483,1,0,13,0,-13
49484,0,0,32,0,-32
49485,1,1,22,1289,1267
49486,0,0,24,0,-24
49487,1,0,44,0,-44
49488,1,1,1723,3871,2148
49489,1,1,586,1786,1200
49490,0,0,87,0,-87
49491,1,0,37,0,-37
49492,1,1,717,1284,567
49493,1,0,102,0,-102
49494,1,0,6,0,-6
49495,1,0,18,0,-18
49496,1,1,537,1755,1218
49497,1,1,1080,1404,324
49498,0,0,15,0,-15
49499,1,1,743,1892,1149
49500,0,0,50,0,-50
49501,1,1,923,1308,385
49502,1,0,118,0,-118
49503,0,0,85,0,-85
49504,1,1,60,1339,1279
49505,1,0,21,0,-21
49506,0,0,14,0,-14
49507,0,0,0,0,0
49508,0,0,37,0,-37
49509,0,0,56,0,-56
49510,1,0,56,0,-56
49511,1,0,131,0,-131
49512,1,0,10,0,-10
49513,1,0,24,0,-24
49514,1,1,550,4252,3702
49515,1,0,1,0,-1
49516,0,0,25,0,-25
49517,1,1,214,1616,1402
49518,1,1,271,1238,967
49519,0,0,32,0,-32
49520,1,1,446,1423,977
49521,1,1,1033,1696,663
49522,1,0,18,0,-18
49523,0,0,62,0,-62
49524,1,0,3,0,-3
49525,1,1,610,1504,894
49526,0,0,53,0,-53
49527,1,1,999,1238,239
49528,0,0,19,0,-19
49529,0,0,61,0,-61
49530,0,0,48,0,-48
49531,1,1,413,1218,805
49532,0,0,30,0,-30
49533,1,1,1021,1246,225
49534,0,0,39,0,-39
49535,1,0,34,0,-34
49536,1,1,220,1332,1112
49537,1,0,12,0,-12
49538,1,0,12,0,-12
49539,1,1,217,1326,1109
49540,1,0,47,0,-47
49541,1,0,124,0,-124
49542,1,0,18,0,-18
49543,0,0,48,0,-48
49544,0,0,18,0,-18
49545,1,0,75,0,-75
49546,1,0,10,0,-10
49547,0,0,23,0,-23
49548,0,0,52,0,-52
49549,0,0,105,0,-105
49550,0,0,71,0,-71
49551,1,0,20,0,-20
49552,0,0,22,0,-22
49553,0,0,31,0,-31
49554,1,1,363,1361,998
49555,1,1,514,1266,752
49556,0,0,65,0,-65
49557,1,1,800,2467,1667
49558,0,0,107,0,-107
49559,1,0,57,0,-57
49560,1,0,15,0,-15
49561,1,1,221,1217,996
49562,1,0,51,0,-51
49563,0,0,83,0,-83
49564,0,0,88,0,-88
49565,0,0,77,0,-77
49566,1,0,152,0,-152
49567,0,0,38,0,-38
49568,0,0,0,0,0
49569,0,0,26,0,-26
49570,1,1,359,1311,952
49571,1,0,11,0,-11
49572,1,0,15,0,-15
49573,0,0,24,0,-24
49574,1,0,150,0,-150
49575,0,0,96,0,-96
49576,0,0,136,0,-136
49577,0,0,23,0,-23
49578,0,0,40,0,-40
49579,1,0,4,0,-4
49580,0,0,20,0,-20
49581,1,1,1312,1263,-49
49582,1,1,161,1490,1329
49583,1,1,120,1229,1109
49584,0,0,83,0,-83
49585,1,1,43,1743,1700
49586,1,0,28,0,-28
49587,1,1,420,1419,999
49588,0,0,7,0,-7
49589,1,1,125,1231,1106
49590,1,1,82,2436,2354
49591,0,0,22,0,-22
49592,1,1,261,1254,993
49593,1,0,58,0,-58
49594,0,0,8,0,-8
49595,1,1,687,1462,775
49596,0,0,6,0,-6
49597,1,1,598,1939,1341
49598,0,0,5,0,-5
49599,1,0,15,0,-15
49600,0,0,0,0,0
49601,1,0,41,0,-41
49602,1,1,1396,1332,-64
49603,1,1,83,1311,1228
49604,0,0,42,0,-42
49605,0,0,115,0,-115
49606,0,0,85,0,-85
49607,0,0,8,0,-8
49608,0,0,8,0,-8
49609,1,1,580,1358,778
49610,1,0,8,0,-8
49611,0,0,4,0,-4
49612,1,0,21,0,-21
49613,1,0,6,0,-6
49614,1,1,596,1374,778
49615,0,0,7,0,-7
49616,0,0,93,0,-93
49617,1,0,22,0,-22
49618,0,0,15,0,-15
49619,1,0,0,0,0
49620,0,0,23,0,-23
49621,1,1,588,1390,802
49622,0,0,64,0,-64
49623,1,0,20,0,-20
49624,1,0,2,0,-2
49625,0,0,34,0,-34
49626,0,0,5,0,-5
49627,0,0,41,0,-41
49628,1,0,23,0,-23
49629,0,0,306,0,-306
49630,1,1,121,1353,1232
49631,0,0,46,0,-46
49632,0,0,13,0,-13
49633,0,0,53,0,-53
49634,1,1,101,1252,1151
49635,1,1,355,1333,978
49636,0,0,36,0,-36
49637,0,0,17,0,-17
49638,1,0,0,0,0
49639,1,0,27,0,-27
49640,1,0,63,0,-63
49641,0,0,16,0,-16
49642,1,1,107,1361,1254
49643,1,0,104,0,-104
49644,1,1,162,1564,1402
49645,1,1,556,1918,1362
49646,1,0,54,0,-54
49647,1,0,90,0,-90
49648,1,1,353,1292,939
49649,0,0,45,0,-45
49650,0,0,9,0,-9
49651,1,0,82,0,-82
49652,1,1,514,1339,825
49653,1,0,202,0,-202
49654,0,0,12,0,-12
49655,1,1,153,1378,1225
49656,1,0,14,0,-14
49657,1,1,250,1434,1184
49658,1,0,13,0,-13
49659,0,0,50,0,-50
49660,1,0,61,0,-61
49661,1,0,104,0,-104
49662,1,0,27,0,-27
49663,0,0,13,0,-13
49664,0,0,0,0,0
49665,0,0,32,0,-32
49666,1,0,7,0,-7
49667,1,0,147,0,-147
49668,1,1,121,1737,1616
49669,1,0,59,0,-59
49670,1,1,97,1542,1445
49671,0,0,68,0,-68
49672,0,0,27,0,-27
49673,1,0,43,0,-43
49674,1,0,9,0,-9
49675,1,0,21,0,-21
49676,1,1,286,1375,1089
49677,0,0,4,0,-4
49678,0,0,60,0,-60
49679,0,0,115,0,-115
49680,0,0,64,0,-64
49681,1,1,287,1689,1402
49682,0,0,98,0,-98
49683,1,1,1053,2166,1113
49684,1,0,27,0,-27
49685,0,0,10,0,-10
49686,0,0,42,0,-42
49687,0,0,80,0,-80
49688,1,0,163,0,-163
49689,0,0,6,0,-6
49690,0,0,40,0,-40
49691,0,0,47,0,-47
49692,0,0,25,0,-25
49693,0,0,6,0,-6
49694,0,0,15,0,-15
49695,1,0,5,0,-5
49696,1,0,84,0,-84
49697,0,0,29,0,-29
49698,0,0,0,0,0
49699,1,0,12,0,-12
49700,0,0,7,0,-7
49701,1,0,63,0,-63
49702,1,0,8,0,-8
49703,1,1,656,1291,635
49704,0,0,45,0,-45
49705,1,0,141,0,-141
49706,0,0,68,0,-68
49707,1,0,3,0,-3
49708,0,0,97,0,-97
49709,0,0,12,0,-12
49710,1,0,32,0,-32
49711,1,1,548,2923,2375
49712,0,0,131,0,-131
49713,1,1,799,1486,687
49714,1,0,31,0,-31
49715,1,1,282,1348,1066
49716,1,1,438,1288,850
49717,1,1,383,1901,1518
49718,1,1,623,1364,741
49719,1,0,1,0,-1
49720,0,0,19,0,-19
49721,1,0,437,0,-437
49722,1,1,170,3692,3522
49723,0,0,10,0,-10
49724,0,0,8,0,-8
49725,1,1,197,1282,1085
49726,1,0,4,0,-4
49727,1,1,176,2251,2075
49728,0,0,92,0,-92
49729,1,1,75,1455,1380
49730,1,1,527,1248,721
49731,0,0,25,0,-25
49732,1,1,491,2148,1657
49733,1,1,238,1364,1126
49734,0,0,21,0,-21
49735,0,0,2,0,-2
49736,1,1,254,1300,1046
49737,0,0,16,0,-16
49738,1,0,38,0,-38
49739,0,0,62,0,-62
49740,1,0,60,0,-60
49741,1,0,16,0,-16
49742,0,0,32,0,-32
49743,1,0,50,0,-50
49744,1,0,9,0,-9
49745,1,1,377,1303,926
49746,1,0,17,0,-17
49747,1,0,46,0,-46
49748,0,0,20,0,-20
49749,1,1,993,1327,334
49750,1,0,77,0,-77
49751,1,0,19,0,-19
49752,0,0,3,0,-3
49753,0,0,24,0,-24
49754,0,0,25,0,-25
49755,1,1,711,2332,1621
49756,1,0,0,0,0
49757,1,1,832,1264,432
49758,1,0,21,0,-21
49759,1,1,423,2020,1597
49760,1,0,22,0,-22
49761,1,1,979,1403,424
49762,1,0,42,0,-42
49763,0,0,7,0,-7
49764,0,0,62,0,-62
49765,1,1,447,1829,1382
49766,0,0,49,0,-49
49767,1,0,23,0,-23
49768,1,1,157,1236,1079
49769,0,0,9,0,-9
49770,1,0,3,0,-3
49771,1,0,76,0,-76
49772,0,0,7,0,-7
49773,0,0,47,0,-47
49774,0,0,2,0,-2
49775,1,0,3,0,-3
49776,1,1,202,1439,1237
49777,0,0,13,0,-13
49778,0,0,11,0,-11
49779,1,1,1169,2185,1016
49780,1,0,79,0,-79
49781,1,1,2241,1272,-969
49782,0,0,61,0,-61
49783,0,0,3,0,-3
49784,1,0,9,0,-9
49785,0,0,3,0,-3
49786,1,1,54,1715,1661
49787,0,0,19,0,-19
49788,0,0,66,0,-66
49789,1,0,63,0,-63
49790,1,1,315,1564,1249
49791,0,0,14,0,-14
49792,1,1,121,1891,1770
49793,0,0,38,0,-38
49794,1,0,88,0,-88
49795,1,1,179,1373,1194
49796,0,0,51,0,-51
49797,0,0,107,0,-107
49798,1,0,39,0,-39
49799,0,0,6,0,-6
49800,1,1,133,1225,1092
49801,0,0,79,0,-79
49802,1,1,487,2743,2256
49803,1,0,11,0,-11
49804,1,1,99,2552,2453
49805,0,0,12,0,-12
49806,1,1,265,1716,1451
49807,1,1,427,1224,797
49808,1,1,83,1524,1441
49809,1,1,770,1578,808
49810,0,0,101,0,-101
49811,1,1,264,1229,965
49812,1,1,291,1239,948
49813,0,0,26,0,-26
49814,1,0,32,0,-32
49815,1,0,4,0,-4
49816,1,1,1221,1656,435
49817,0,0,10,0,-10
49818,0,0,124,0,-124
49819,1,0,14,0,-14
49820,1,0,27,0,-27
49821,1,1,643,1452,809
49822,0,0,58,0,-58
49823,0,0,83,0,-83
49824,1,1,193,1576,1383
49825,1,0,13,0,-13
49826,0,0,32,0,-32
49827,0,0,0,0,0
49828,1,0,222,0,-222
49829,0,0,1,0,-1
49830,1,1,53,2583,2530
49831,0,0,64,0,-64
49832,1,1,1148,1282,134
49833,1,0,3,0,-3
49834,0,0,53,0,-53
49835,1,0,43,0,-43
49836,0,0,20,0,-20
49837,0,0,26,0,-26
49838,1,0,47,0,-47
49839,0,0,35,0,-35
49840,0,0,34,0,-34
49841,0,0,12,0,-12
49842,1,1,445,1350,905
49843,1,0,11,0,-11
49844,0,0,10,0,-10
49845,1,1,586,1215,629
49846,1,0,10,0,-10
49847,1,0,3,0,-3
49848,1,1,95,1888,1793
49849,0,0,1,0,-1
49850,0,0,2,0,-2
49851,0,0,0,0,0
49852,1,0,50,0,-50
49853,1,1,1879,1293,-586
49854,1,0,14,0,-14
49855,0,0,7,0,-7
49856,0,0,11,0,-11
49857,1,0,163,0,-163
49858,1,0,48,0,-48
49859,1,1,289,1233,944
49860,0,0,59,0,-59
49861,0,0,15,0,-15
49862,1,0,60,0,-60
49863,1,0,27,0,-27
49864,0,0,18,0,-18
49865,0,0,2,0,-2
49866,1,1,383,1235,852
49867,0,0,0,0,0
49868,0,0,23,0,-23
49869,0,0,16,0,-16
49870,1,1,429,1486,1057
49871,1,1,919,1817,898
49872,1,1,397,1299,902
49873,0,0,44,0,-44
49874,0,0,95,0,-95
49875,1,1,48,1331,1283
49876,0,0,26,0,-26
49877,1,0,2,0,-2
49878,0,0,16,0,-16
49879,0,0,95,0,-95
49880,0,0,61,0,-61
49881,0,0,21,0,-21
49882,1,0,5,0,-5
49883,1,0,5,0,-5
49884,1,0,72,0,-72
49885,0,0,139,0,-139
49886,1,0,74,0,-74
49887,0,0,63,0,-63
49888,1,1,817,1659,842
49889,1,0,46,0,-46
49890,1,1,1547,1734,187
49891,0,0,35,0,-35
49892,1,1,1183,2015,832
49893,1,1,333,1768,1435
49894,1,0,94,0,-94
49895,1,0,50,0,-50
49896,1,0,53,0,-53
49897,1,1,221,1245,1024
49898,1,0,30,0,-30
49899,1,0,42,0,-42
49900,1,0,131,0,-131
49901,1,1,289,1347,1058
49902,1,1,531,1478,947
49903,0,0,84,0,-84
49904,1,1,234,1416,1182
49905,1,0,6,0,-6
49906,0,0,97,0,-97
49907,1,0,21,0,-21
49908,0,0,53,0,-53
49909,0,0,45,0,-45
49910,0,0,153,0,-153
49911,1,0,82,0,-82
49912,1,1,210,1218,1008
49913,0,0,70,0,-70
49914,0,0,246,0,-246
49915,0,0,8,0,-8
49916,0,0,18,0,-18
49917,1,0,82,0,-82
49918,1,1,581,3457,2876
49919,1,1,296,1321,1025
49920,1,0,59,0,-59
49921,0,0,33,0,-33
49922,0,0,102,0,-102
49923,1,1,738,1279,541
49924,1,1,854,1922,1068
49925,0,0,14,0,-14
49926,1,0,30,0,-30
49927,1,1,436,1624,1188
49928,0,0,77,0,-77
49929,0,0,12,0,-12
49930,1,1,204,1211,1007
49931,0,0,110,0,-110
49932,1,1,269,1991,1722
49933,0,0,66,0,-66
49934,1,0,36,0,-36
49935,1,0,100,0,-100
49936,1,1,1273,1213,-60
49937,1,1,337,1547,1210
49938,1,0,65,0,-65
49939,1,1,159,1212,1053
49940,1,0,86,0,-86
49941,1,1,424,1254,830
49942,1,1,132,1347,1215
49943,1,1,1069,1221,152
49944,0,0,33,0,-33
49945,1,0,22,0,-22
49946,1,1,213,1565,1352
49947,1,0,41,0,-41
49948,0,0,13,0,-13
49949,1,0,93,0,-93
49950,1,0,8,0,-8
49951,1,0,102,0,-102
49952,1,1,105,1297,1192
49953,1,1,43,1846,1803
49954,1,1,32,1233,1201
49955,0,0,85,0,-85
49956,0,0,5,0,-5
49957,1,0,38,0,-38
49958,0,0,7,0,-7
49959,0,0,69,0,-69
49960,0,0,26,0,-26
49961,1,1,131,1497,1366
49962,1,0,39,0,-39
49963,1,0,35,0,-35
49964,1,1,1482,1201,-281
49965,1,1,1236,1304,68
49966,1,1,868,1217,349
49967,0,0,62,0,-62
49968,1,1,598,1751,1153
49969,1,0,133,0,-133
49970,1,1,182,1877,1695
49971,0,0,106,0,-106
49972,1,1,145,2174,2029
49973,0,0,20,0,-20
49974,1,1,547,1253,706
49975,0,0,63,0,-63
49976,1,1,929,1350,421
49977,1,0,23,0,-23
49978,1,1,239,1317,1078
49979,1,1,272,3638,3366
49980,0,0,77,0,-77
49981,1,0,29,0,-29
49982,1,1,589,1238,649
49983,1,0,16,0,-16
49984,0,0,1,0,-1
49985,1,0,40,0,-40
49986,1,0,4,0,-4
49987,1,1,255,1373,1118
49988,0,0,29,0,-29
49989,1,1,848,3600,2752
49990,1,0,35,0,-35
49991,1,1,309,1470,1161
49992,0,0,32,0,-32
49993,1,1,785,2765,1980
49994,0,0,19,0,-19
49995,1,1,1122,1237,115
49996,1,1,1181,1242,61
49997,1,1,83,1879,1796
49998,1,0,90,0,-90
49999,1,0,119,0,-119
50000,0,0,47,0,-47
50001,1,1,151,1441,1290
50002,1,1,109,1721,1612
50003,0,0,35,0,-35
50004,1,1,226,2360,2134
50005,1,0,39,0,-39
50006,1,1,66,1340,1274
50007,1,0,10,0,-10
50008,0,0,63,0,-63
50009,0,0,57,0,-57
50010,0,0,20,0,-20
50011,1,1,474,1395,921
50012,1,1,719,1872,1153
50013,0,0,119,0,-119
50014,1,0,7,0,-7
50015,0,0,206,0,-206
50016,1,1,296,2101,1805
50017,0,0,55,0,-55
50018,1,1,585,1738,1153
50019,1,0,13,0,-13
50020,1,0,1,0,-1
50021,0,0,20,0,-20
50022,1,1,888,1305,417
50023,0,0,109,0,-109
50024,0,0,83,0,-83
50025,1,1,501,2411,1910
50026,0,0,4,0,-4
50027,0,0,48,0,-48
50028,0,0,3,0,-3
50029,0,0,27,0,-27
50030,1,1,1214,1450,236
50031,1,1,343,1456,1113
50032,1,1,3591,1254,-2337
50033,0,0,70,0,-70
50034,1,0,54,0,-54
50035,1,0,132,0,-132
50036,1,1,379,1967,1588
50037,1,1,1824,1477,-347
50038,1,1,694,2382,1688
50039,1,1,525,2429,1904
50040,1,1,151,1222,1071
50041,0,0,17,0,-17
50042,1,1,362,1829,1467
50043,1,1,476,1352,876
50044,1,0,31,0,-31
50045,1,1,957,1724,767
50046,1,1,231,1382,1151
50047,1,0,31,0,-31
50048,0,0,0,0,0
50049,1,1,162,1269,1107
50050,1,1,1982,1239,-743
50051,1,0,115,0,-115
50052,1,0,24,0,-24
50053,0,0,47,0,-47
50054,1,1,271,1309,1038
50055,0,0,128,0,-128
50056,0,0,9,0,-9
50057,1,1,56,1819,1763
50058,0,0,7,0,-7
50059,1,1,395,1359,964
50060,1,1,311,1361,1050
50061,0,0,4,0,-4
50062,0,0,47,0,-47
50063,0,0,3,0,-3
50064,1,1,917,1449,532
50065,1,1,73,1356,1283
50066,1,0,76,0,-76
50067,1,0,57,0,-57
50068,1,1,362,1424,1062
50069,0,0,45,0,-45
50070,1,1,364,1587,1223
50071,0,0,18,0,-18
50072,1,1,1106,1225,119
50073,1,1,579,1465,886
50074,1,1,851,2557,1706
50075,1,1,1511,1258,-253
50076,1,1,327,1774,1447
50077,0,0,88,0,-88
50078,0,0,2,0,-2
50079,1,1,680,1317,637
50080,1,1,189,1460,1271
50081,1,0,30,0,-30
50082,1,1,283,1638,1355
50083,0,0,101,0,-101
50084,0,0,76,0,-76
50085,0,0,3,0,-3
50086,1,0,2,0,-2
50087,1,0,34,0,-34
50088,1,0,96,0,-96
50089,0,0,158,0,-158
50090,0,0,16,0,-16
50091,1,0,1,0,-1
50092,0,0,80,0,-80
50093,0,0,27,0,-27
50094,0,0,9,0,-9
50095,1,0,144,0,-144
50096,0,0,131,0,-131
50097,1,1,542,1314,772
50098,1,1,371,1656,1285
50099,0,0,14,0,-14
50100,1,0,23,0,-23
50101,1,0,274,0,-274
50102,0,0,68,0,-68
50103,1,0,56,0,-56
50104,0,0,24,0,-24
50105,1,0,6,0,-6
50106,1,1,458,1285,827
50107,1,1,706,1563,857
50108,1,0,79,0,-79
50109,1,0,5,0,-5
50110,1,0,25,0,-25
50111,0,0,67,0,-67
50112,0,0,18,0,-18
50113,0,0,127,0,-127
50114,0,0,54,0,-54
50115,1,1,110,1449,1339
50116,1,0,2,0,-2
50117,1,1,80,1588,1508
50118,1,0,59,0,-59
50119,1,1,137,3052,2915
50120,0,0,48,0,-48
50121,1,1,188,1675,1487
50122,1,0,28,0,-28
50123,0,0,85,0,-85
50124,1,0,8,0,-8
50125,1,0,45,0,-45
50126,1,1,761,1587,826
50127,0,0,26,0,-26
50128,1,1,226,1716,1490
50129,0,0,72,0,-72
50130,1,0,67,0,-67
50131,1,0,113,0,-113
50132,1,0,11,0,-11
50133,1,1,757,1754,997
50134,1,0,21,0,-21
50135,0,0,70,0,-70
50136,0,0,42,0,-42
50137,0,0,13,0,-13
50138,0,0,30,0,-30
50139,0,0,42,0,-42
50140,1,0,70,0,-70
50141,1,1,718,1738,1020
50142,0,0,69,0,-69
50143,0,0,28,0,-28
50144,1,1,319,1264,945
50145,1,1,158,1617,1459
50146,1,0,192,0,-192
50147,1,1,914,1283,369
50148,1,0,22,0,-22
50149,0,0,7,0,-7
50150,1,1,2342,1202,-1140
50151,1,0,3,0,-3
50152,1,1,280,1202,922
50153,1,1,854,1364,510
50154,1,0,10,0,-10
50155,1,0,11,0,-11
50156,0,0,61,0,-61
50157,1,1,230,1231,1001
50158,1,1,451,1212,761
50159,0,0,32,0,-32
50160,1,1,955,1274,319
50161,1,0,106,0,-106
50162,1,0,41,0,-41
50163,1,1,345,1951,1606
50164,1,0,104,0,-104
50165,0,0,98,0,-98
50166,1,1,91,1441,1350
50167,1,0,68,0,-68
50168,1,1,174,1501,1327
50169,1,1,148,1621,1473
50170,1,1,298,1424,1126
50171,1,0,55,0,-55
50172,1,1,1381,1285,-96
50173,0,0,7,0,-7
50174,1,0,4,0,-4
50175,1,1,166,1934,1768
50176,0,0,147,0,-147
50177,1,0,83,0,-83
50178,0,0,82,0,-82
50179,1,0,27,0,-27
50180,1,0,60,0,-60
50181,0,0,32,0,-32
50182,0,0,31,0,-31
50183,0,0,21,0,-21
50184,0,0,34,0,-34
50185,0,0,14,0,-14
50186,1,0,26,0,-26
50187,1,1,389,1999,1610
50188,0,0,113,0,-113
50189,0,0,89,0,-89
50190,1,1,455,1216,761
50191,0,0,75,0,-75
50192,0,0,6,0,-6
50193,1,0,82,0,-82
50194,1,1,218,1327,1109
50195,1,1,138,1892,1754
50196,0,0,23,0,-23
50197,1,1,871,1597,726
50198,1,1,898,2310,1412
50199,1,0,49,0,-49
50200,0,0,79,0,-79
50201,1,1,66,2151,2085
50202,1,0,35,0,-35
50203,1,0,1,0,-1
50204,0,0,38,0,-38
50205,1,1,193,1320,1127
50206,0,0,8,0,-8
50207,0,0,51,0,-51
50208,0,0,36,0,-36
50209,1,0,14,0,-14
50210,1,0,8,0,-8
50211,1,1,68,1252,1184
50212,0,0,23,0,-23
50213,0,0,18,0,-18
50214,1,0,93,0,-93
50215,1,0,18,0,-18
50216,1,1,440,1250,810
50217,1,0,85,0,-85
50218,1,0,160,0,-160
50219,1,0,11,0,-11
50220,0,0,27,0,-27
50221,0,0,26,0,-26
50222,1,1,117,1467,1350
50223,0,0,13,0,-13
50224,1,0,96,0,-96
50225,0,0,12,0,-12
50226,1,0,27,0,-27
50227,0,0,40,0,-40
50228,1,0,42,0,-42
50229,1,1,199,1210,1011
50230,1,0,28,0,-28
50231,0,0,63,0,-63
50232,1,0,33,0,-33
50233,0,0,106,0,-106
50234,0,0,2,0,-2
50235,0,0,82,0,-82
50236,1,0,29,0,-29
50237,1,1,86,1742,1656
50238,1,0,28,0,-28
50239,0,0,7,0,-7
50240,0,0,23,0,-23
50241,0,0,100,0,-100
50242,1,1,709,1509,800
50243,1,1,365,1309,944
50244,1,1,499,1734,1235
50245,1,0,40,0,-40
50246,0,0,71,0,-71
50247,1,1,278,1707,1429
50248,0,0,35,0,-35
50249,0,0,56,0,-56
50250,1,0,18,0,-18
50251,1,0,0,0,0
50252,1,0,24,0,-24
50253,1,0,6,0,-6
50254,0,0,98,0,-98
50255,1,0,58,0,-58
50256,1,1,101,1254,1153
50257,1,1,745,1224,479
50258,1,1,2632,1274,-1358
50259,1,1,154,1499,1345
50260,1,1,902,1509,607
50261,1,0,14,0,-14
50262,1,1,640,1638,998
50263,1,0,9,0,-9
50264,0,0,195,0,-195
50265,0,0,22,0,-22
50266,1,1,101,1508,1407
50267,0,0,74,0,-74
50268,1,1,453,1293,840
50269,1,1,636,1591,955
50270,1,1,692,1200,508
50271,1,0,106,0,-106
50272,0,0,56,0,-56
50273,0,0,72,0,-72
50274,0,0,230,0,-230
50275,1,0,75,0,-75
50276,1,0,26,0,-26
50277,1,1,576,1239,663
50278,1,1,1183,1586,403
50279,1,0,86,0,-86
50280,0,0,133,0,-133
50281,1,1,376,1470,1094
50282,0,0,3,0,-3
50283,1,0,23,0,-23
50284,1,1,235,1673,1438
50285,1,1,673,1540,867
50286,1,1,183,1456,1273
50287,1,0,6,0,-6
50288,1,1,1806,1931,125
50289,0,0,15,0,-15
50290,0,0,36,0,-36
50291,1,1,990,1433,443
50292,0,0,17,0,-17
50293,0,0,184,0,-184
50294,1,0,0,0,0
50295,0,0,84,0,-84
50296,1,0,12,0,-12
50297,0,0,30,0,-30
50298,1,0,4,0,-4
50299,0,0,21,0,-21
50300,0,0,103,0,-103
50301,1,1,344,1301,957
50302,1,0,12,0,-12
50303,1,0,23,0,-23
50304,1,0,170,0,-170
50305,0,0,3,0,-3
50306,1,0,19,0,-19
50307,0,0,35,0,-35
50308,0,0,22,0,-22
50309,1,1,939,1216,277
50310,1,1,294,1627,1333
50311,0,0,12,0,-12
50312,1,0,161,0,-161
50313,1,0,60,0,-60
50314,1,1,988,1245,257
50315,1,0,84,0,-84
50316,1,0,175,0,-175
50317,1,0,9,0,-9
50318,1,1,914,2852,1938
50319,1,1,668,3100,2432
50320,1,1,746,1378,632
50321,1,0,4,0,-4
50322,1,0,65,0,-65
50323,1,0,53,0,-53
50324,1,0,141,0,-141
50325,0,0,22,0,-22
50326,1,0,115,0,-115
50327,0,0,120,0,-120
50328,1,1,162,1205,1043
50329,1,1,1083,1381,298
50330,1,0,65,0,-65
50331,1,0,20,0,-20
50332,0,0,28,0,-28
50333,1,1,965,1319,354
50334,1,0,47,0,-47
50335,1,0,51,0,-51
50336,0,0,119,0,-119
50337,0,0,60,0,-60
50338,0,0,65,0,-65
50339,1,1,112,2308,2196
50340,1,1,53,1710,1657
50341,0,0,9,0,-9
50342,1,0,27,0,-27
50343,0,0,123,0,-123
50344,0,0,65,0,-65
50345,1,0,0,0,0
50346,0,0,33,0,-33
50347,0,0,141,0,-141
50348,1,0,88,0,-88
50349,1,0,9,0,-9
50350,0,0,5,0,-5
50351,0,0,26,0,-26
50352,1,0,30,0,-30
50353,1,1,726,1243,517
50354,1,1,369,1272,903
50355,0,0,31,0,-31
50356,0,0,6,0,-6
50357,1,0,12,0,-12
50358,1,1,249,1439,1190
50359,0,0,75,0,-75
50360,1,0,55,0,-55
50361,1,1,357,1977,1620
50362,0,0,3,0,-3
50363,1,0,39,0,-39
50364,1,1,974,1254,280
50365,1,1,1365,1297,-68
50366,0,0,11,0,-11
50367,0,0,32,0,-32
50368,1,0,65,0,-65
50369,1,1,519,1332,813
50370,1,0,0,0,0
50371,1,1,207,1531,1324
50372,1,0,58,0,-58
50373,1,1,51,1464,1413
50374,0,0,7,0,-7
50375,0,0,3,0,-3
50376,0,0,11,0,-11
50377,1,1,703,1548,845
50378,0,0,54,0,-54
50379,1,1,326,1973,1647
50380,1,0,7,0,-7
50381,0,0,146,0,-146
50382,0,0,3,0,-3
50383,0,0,158,0,-158
50384,1,1,146,1330,1184
50385,0,0,1,0,-1
50386,1,0,272,0,-272
50387,1,0,10,0,-10
50388,1,0,15,0,-15
50389,0,0,31,0,-31
50390,1,1,606,1541,935
50391,0,0,20,0,-20
50392,1,1,329,1262,933
50393,1,1,704,1677,973
50394,1,1,552,1344,792
50395,1,0,39,0,-39
50396,1,0,127,0,-127
50397,1,1,197,1215,1018
50398,0,0,60,0,-60
50399,1,1,413,1974,1561
50400,1,0,32,0,-32
50401,0,0,51,0,-51
50402,0,0,38,0,-38
50403,0,0,37,0,-37
50404,1,1,182,1600,1418
50405,0,0,8,0,-8
50406,1,1,2427,1211,-1216
50407,1,0,50,0,-50
50408,0,0,60,0,-60
50409,1,1,1463,1238,-225
50410,0,0,61,0,-61
50411,0,0,7,0,-7
50412,1,1,119,1701,1582
50413,1,0,72,0,-72
50414,1,1,363,1256,893
50415,1,0,47,0,-47
50416,0,0,148,0,-148
50417,1,1,33,1350,1317
50418,1,1,258,1390,1132
50419,0,0,9,0,-9
50420,1,1,572,2141,1569
50421,1,0,102,0,-102
50422,1,1,249,1285,1036
50423,0,0,70,0,-70
50424,1,1,772,1706,934
50425,0,0,38,0,-38
50426,1,1,60,1611,1551
50427,0,0,24,0,-24
50428,1,1,507,1526,1019
50429,1,0,32,0,-32
50430,1,1,1071,2453,1382
50431,0,0,20,0,-20
50432,1,1,649,1601,952
50433,1,0,52,0,-52
50434,1,1,323,1279,956
50435,0,0,64,0,-64
50436,1,0,8,0,-8
50437,1,0,14,0,-14
50438,0,0,123,0,-123
50439,1,1,101,1761,1660
50440,0,0,17,0,-17
50441,0,0,18,0,-18
50442,1,0,27,0,-27
50443,1,0,34,0,-34
50444,0,0,26,0,-26
50445,0,0,106,0,-106
50446,0,0,89,0,-89
50447,0,0,64,0,-64
50448,0,0,22,0,-22
50449,1,1,311,2502,2191
50450,1,1,1044,1223,179
50451,1,1,622,1324,702
50452,0,0,29,0,-29
50453,1,0,48,0,-48
50454,1,0,52,0,-52
50455,0,0,51,0,-51
50456,0,0,75,0,-75
50457,1,1,204,1452,1248
50458,1,0,92,0,-92
50459,0,0,81,0,-81
50460,0,0,69,0,-69
50461,0,0,60,0,-60
50462,0,0,42,0,-42
50463,1,0,48,0,-48
50464,1,0,30,0,-30
50465,1,0,219,0,-219
50466,1,0,55,0,-55
50467,1,1,289,1250,961
50468,0,0,8,0,-8
50469,1,1,629,1657,1028
50470,1,1,951,1555,604
50471,1,0,6,0,-6
50472,0,0,34,0,-34
50473,1,1,467,1249,782
50474,1,1,471,2202,1731
50475,1,1,989,1300,311
50476,1,1,1290,2009,719
50477,1,1,343,1279,936
50478,1,0,79,0,-79
50479,0,0,16,0,-16
50480,0,0,57,0,-57
50481,0,0,11,0,-11
50482,0,0,94,0,-94
50483,1,1,352,2223,1871
50484,1,0,22,0,-22
50485,0,0,80,0,-80
50486,0,0,18,0,-18
50487,0,0,80,0,-80
50488,1,1,557,1351,794
50489,1,0,2,0,-2
50490,0,0,12,0,-12
50491,1,1,482,1431,949
50492,1,1,202,1519,1317
50493,0,0,142,0,-142
50494,1,0,30,0,-30
50495,0,0,35,0,-35
50496,1,1,1011,1252,241
50497,1,1,423,1362,939
50498,0,0,10,0,-10
50499,1,0,3,0,-3
50500,0,0,64,0,-64
50501,1,1,87,1394,1307
50502,1,1,299,1223,924
50503,0,0,6,0,-6
50504,1,0,6,0,-6
50505,1,1,704,2272,1568
50506,0,0,19,0,-19
50507,1,1,670,2580,1910
50508,0,0,48,0,-48
50509,1,1,137,1234,1097
50510,1,0,46,0,-46
50511,1,1,1966,1547,-419
50512,1,1,1939,1815,-124
